Zipcode,Population,Median Age,Household Income,Per Capita Income,Number of Males,Number of Females
8518,5217,41.5,74286,33963,2539,2678
8520,27468,37.4,90293,37175,14319,13149
8525,4782,47.1,118656,59848,2325,2457
8527,54867,42.2,88588,37021,26774,28093
8528,245,48.5,58676,49117,120,125
8530,7568,43.8,87396,46371,4078,3490
8533,6789,41,85301,30981,3584,3205
8534,13312,44.1,144250,66609,6584,6728
8535,5657,43.5,147853,59097,2879,2778
8536,19944,34,90089,46406,9520,10424
8540,47316,37.5,125439,61810,22724,24592
8542,4756,26.3,71393,37662,2510,2246
8550,19357,43.4,169661,70463,9365,9992
8551,5212,43.4,121154,54299,2749,2463
8553,543,51.6,90972,57618,276,267
8554,4023,39.6,71750,30004,1829,2194
8555,812,40.3,78083,30321,410,402
8558,6495,44.2,154236,68556,3044,3451
8559,5226,48.4,108871,56242,2572,2654
8560,3249,47,113333,59497,1768,1481
8561,0,-666666666,-666666666,-666666666,0,0
8562,5713,34.9,65036,26970,2746,2967
8608,921,37.6,14861,13521,320,601
8609,14884,33,27073,15337,8446,6438
8610,29222,38.5,61016,28416,14102,15120
8611,26477,32.3,38672,16727,14404,12073
8618,38057,32.5,41757,21134,17631,20426
8619,23175,42.3,72330,34252,11021,12154
8620,12638,43.2,88438,33407,6115,6523
8628,9579,42.7,80449,39103,5040,4539
8629,12450,32.6,54956,21054,5746,6704
8638,23466,38,58371,24937,11388,12078
8640,7381,35.1,68108,13835,6002,1379
8641,4134,22.7,49980,16262,2433,1701
8648,32300,37.2,86451,38044,15246,17054
8690,18766,46.5,96192,40979,8738,10028
8691,15431,41.6,109293,51883,7189,8242
8701,92586,23.2,40240,14769,46211,46375
8720,1031,28.1,104310,43403,416,615
8721,20789,41.4,78847,33094,10340,10449
8722,11105,35,80386,30816,5391,5714
8723,31769,43.1,66233,33114,15294,16475
8724,42866,43.7,69797,33568,20158,22708
8730,4782,46.8,111875,52622,2369,2413
8731,19868,42.6,64357,30511,10016,9852
8732,1553,49.8,74375,39906,687,866
8733,2787,33,60556,24717,1357,1430
8734,7907,43.3,86357,36882,3954,3953
8735,3283,61.7,63200,44956,1492,1791
8736,12372,48.2,94250,55065,5902,6470
8738,964,63.5,123750,92818,449,515
8740,1961,41.8,62857,29916,923,1038
8741,2591,40.3,86146,34881,1236,1355
8742,24377,43.8,77700,39316,11214,13163
8750,3596,52.1,103875,65829,1707,1889
8751,4248,49.8,32733,24775,1985,2263
8752,1897,62.7,59028,41314,941,956
8753,63891,40.3,76202,34756,31739,32152
8755,25737,45.7,68109,36202,12032,13705
8757,33041,64.3,36595,25393,14016,19025
8758,7512,53.6,70546,33778,3871,3641
8759,33033,69,35984,28401,14165,18868
8801,8662,35.9,114050,45052,5107,3555
8802,3603,43.3,110884,49471,1828,1775
8804,2679,42.2,103190,45405,1330,1349
8805,12340,35.7,67040,31531,6574,5766
8807,38241,41.4,112474,46495,18138,20103
8808,52,40.3,54167,29587,28,24
8809,6471,41,95201,38696,2953,3518
8810,9163,37.9,108283,40927,4253,4910
8812,14330,40.1,94562,41983,7062,7268
8816,46550,42.2,96067,41839,22485,24065
8817,44646,35.5,85152,33677,22680,21966
8820,39878,41,112073,46672,19200,20678
8821,289,43.5,113250,44576,133,156
8822,30430,43.7,101922,47722,14462,15968
8823,9096,35.7,93903,45929,4742,4354
8824,12175,40,117863,43935,6111,6064
8825,4528,43.9,94079,39574,2143,2385
8826,5771,45.9,97452,45198,2924,2847
8827,4185,48.8,98400,42877,2008,2177
8828,2360,40,78958,34618,1098,1262
8829,3694,40.5,95282,42726,1886,1808
8830,18559,39.3,83581,33236,9245,9314
8831,46818,50.7,67676,42007,22136,24682
8832,2580,30.2,43900,21547,1238,1342
8833,9039,47.2,135259,75622,4412,4627
8835,10400,41.3,62583,29298,5261,5139
8836,3767,46.3,135547,63833,1846,1921
8837,16030,38.2,74589,35025,7868,8162
8840,16535,41.7,102196,46958,8076,8459
8844,38907,39.8,112923,46019,18366,20541
8846,13703,41.6,80833,33458,6334,7369
8848,8371,46.3,102852,44983,4294,4077
8850,8274,42.6,97120,41082,3987,4287
8852,17233,38.1,102950,42303,8396,8837
8853,5542,42.9,122500,49686,2810,2732
8854,56874,33.2,91164,32262,28039,28835
8857,40271,40.5,92725,38319,19548,20723
8858,170,66.8,79444,70244,108,62
8859,21594,38.9,79835,35353,10475,11119
8861,53415,33,45601,19501,26124,27291
8863,12342,38.8,74836,31089,5802,6540
8865,29824,40.9,55599,27067,14089,15735
8867,5436,45.5,114174,49652,2735,2701
8869,7058,37.8,76250,35079,3269,3789
8872,20041,37.7,72956,32666,9865,10176
8873,51048,40,85148,37985,24428,26620
8876,22268,39.8,89242,41896,11126,11142
8879,22974,40.9,72508,34654,11122,11852
8880,4584,35.9,71607,31046,2281,2303
8882,16079,38.6,66327,27054,8359,7720
8884,8309,41.9,76681,33593,4096,4213
8886,7071,40.9,109970,42475,3450,3621
8887,1079,43.5,64205,39043,459,620
8889,9934,44.7,124712,60270,4760,5174
8890,0,-666666666,-666666666,-666666666,0,0
8901,55476,23.1,39901,14614,27882,27594
8902,41774,36.3,81531,35200,20844,20930
8904,14136,33.3,73789,39800,6905,7231
10001,21966,34.7,81671,82166,10732,11234
10002,82191,39.8,33218,26227,39802,42389
10003,57310,32.3,92540,74189,27442,29868
10004,2807,33.1,129313,108786,1469,1338
10005,6822,28.6,124670,102849,3463,3359
10006,2507,31.3,119274,101271,1137,1370
10007,6525,34,216037,157713,3661,2864
10009,62810,36.3,59929,43893,28842,33968
10010,30670,35.1,97955,79491,14327,16343
10011,52167,39.7,104238,110631,26039,26128
10012,26145,34.1,86594,72914,13691,12454
10013,26065,36.4,83725,90699,12862,13203
10014,30597,36.7,108483,106068,15172,15425
10016,51196,32.8,105324,87986,23097,28099
10017,16129,37.2,100652,101239,7469,8660
10018,7021,30.9,104635,75598,3650,3371
10019,38394,38.8,84424,84966,18818,19576
10020,0,-666666666,-666666666,-666666666,0,0
10021,40862,42.7,107907,120077,17521,23341
10022,29618,45.3,109019,129778,13007,16611
10023,61315,41.3,103534,99496,28947,32368
10024,59164,41.8,109956,97633,27166,31998
10025,97390,38.2,68516,55843,43572,53818
10026,37871,33.6,43107,28674,17885,19986
10027,62617,30.7,37872,27349,28142,34475
10028,44295,40.3,104638,107679,19674,24621
10029,77454,33.5,31888,25270,36560,40894
10030,28472,34,31925,23992,13569,14903
10031,59092,33,37655,23322,28360,30732
10032,59374,34.5,34568,19005,29080,30294
10033,58710,35.9,41556,23403,29934,28776
10034,41510,36.5,41171,22909,21088,20422
10035,33488,34.2,24533,19541,16147,17341
10036,23132,38.2,66599,68213,13452,9680
10037,17377,37.6,37341,25535,7015,10362
10038,20082,32.4,66074,58768,9312,10770
10039,26577,33.3,33595,19675,12415,14162
10040,44825,37,42721,23593,20300,24525
10044,12346,40.2,83066,43053,5966,6380
10065,32797,38.9,115519,119546,14184,18613
10069,5118,38.1,170630,123349,2634,2484
10075,24849,40.9,102941,106575,10280,14569
10103,0,-666666666,-666666666,-666666666,0,0
10110,2,-666666666,-666666666,,1,1
10111,0,-666666666,-666666666,-666666666,0,0
10112,0,-666666666,-666666666,-666666666,0,0
10115,0,-666666666,-666666666,-666666666,0,0
10119,0,-666666666,-666666666,-666666666,0,0
10128,60121,38.8,96296,89300,25724,34397
10152,0,-666666666,-666666666,-666666666,0,0
10153,0,-666666666,-666666666,-666666666,0,0
10154,0,-666666666,-666666666,-666666666,0,0
10162,1327,39.7,168667,106304,726,601
10165,0,-666666666,-666666666,-666666666,0,0
10167,0,-666666666,-666666666,-666666666,0,0
10168,0,-666666666,-666666666,-666666666,0,0
10169,0,-666666666,-666666666,-666666666,0,0
10170,0,-666666666,-666666666,-666666666,0,0
10171,0,-666666666,-666666666,-666666666,0,0
10172,0,-666666666,-666666666,-666666666,0,0
10173,0,-666666666,-666666666,-666666666,0,0
10174,0,-666666666,-666666666,-666666666,0,0
10177,0,-666666666,-666666666,-666666666,0,0
10199,0,-666666666,-666666666,-666666666,0,0
10271,0,-666666666,-666666666,-666666666,0,0
10278,0,-666666666,-666666666,-666666666,0,0
10279,0,-666666666,-666666666,-666666666,0,0
10280,8685,37.9,129574,82005,4233,4452
10282,6217,33.9,230952,121627,3489,2728
10301,38885,34.7,56848,27952,19500,19385
10302,16811,34,56841,24198,8145,8666
10303,24537,31.1,51537,22077,11419,13118
10304,43084,34.8,53168,27103,20075,23009
10305,42006,39.9,70758,30172,20242,21764
10306,55902,41.4,75807,34834,26875,29027
10307,14829,37.4,86457,36028,7315,7514
10308,28939,42.6,88075,38275,13864,15075
10309,32646,38.5,86297,35719,16473,16173
10310,25227,34.1,61925,27923,12487,12740
10311,0,-666666666,-666666666,-666666666,0,0
10312,60081,41.2,85324,36128,30010,30071
10314,87276,41,77242,32807,41432,45844
10451,47069,31.2,26754,14629,21045,26024
10452,74931,30.4,25979,13019,35135,39796
10453,79793,30.7,25470,12616,37659,42134
10454,38089,29.3,20232,11561,18151,19938
10455,38576,28.7,22609,12231,17958,20618
10456,87723,30.3,23452,12486,41312,46411
10457,70282,29,24949,12952,32833,37449
10458,74859,29.2,24618,14488,35375,39484
10459,47977,28.6,24461,12436,22748,25229
10460,56084,30,22307,12828,26378,29706
10461,51730,38.2,52347,26630,25227,26503
10462,77369,35.3,45864,21836,36156,41213
10463,70420,38.8,54258,30875,32184,38236
10464,4248,48.7,70078,39454,1816,2432
10465,44862,40.1,65450,29953,21577,23285
10466,70609,35.9,44012,19925,31429,39180
10467,98754,32.4,36048,18137,46656,52098
10468,71822,32,33776,15537,33969,37853
10469,71843,36.2,57776,22960,32606,39237
10470,14850,36.2,58600,28734,7403,7447
10471,22030,43.6,71798,43630,10432,11598
10472,68898,30.4,30288,14652,33278,35620
10473,58660,36.1,35866,19561,25617,33043
10474,12519,29.1,25676,11410,6209,6310
10475,43231,46.5,43629,25870,19528,23703
10501,1217,39.9,143529,62287,596,621
10502,5346,46,135139,59920,2513,2833
10503,158,59.1,135192,59994,53,105
10504,7960,40.5,182292,97947,3904,4056
10505,638,40.6,167885,55017,282,356
10506,5448,44.1,180823,92213,2639,2809
10507,6801,39.9,70557,45812,2836,3965
10509,20209,41.1,90437,41563,10134,10075
10510,10166,44.4,144414,75075,4595,5571
10511,2260,44.5,89107,51594,1140,1120
10512,24778,42.5,87802,39376,12248,12530
10514,13256,39.9,202414,91961,6660,6596
10516,5223,43.2,81442,44447,2716,2507
10517,622,31.4,90200,31859,294,328
10518,1390,46,192045,74505,652,738
10519,166,49.5,124208,52513,55,111
10520,13113,46.3,102807,55099,6170,6943
10522,10948,41.5,105000,47914,5321,5627
10523,8029,34.6,81667,31742,4171,3858
10524,4488,47.7,114760,51545,2288,2200
10526,1571,41.5,101750,72202,690,881
10527,1145,43.7,194872,60919,597,548
10528,12692,39.3,99888,57104,6198,6494
10530,11891,48.9,92923,59748,5362,6529
10532,5074,44,110484,42864,2465,2609
10533,7662,43.9,131522,82337,3513,4149
10535,796,37.5,90500,35797,344,452
10536,10719,44.4,153750,69441,5509,5210
10537,2242,37.3,81259,32716,1099,1143
10538,16673,42.1,160964,94794,8078,8595
10541,26643,42,106890,40222,13453,13190
10543,20157,40.9,87316,53168,9715,10442
10545,126,63.6,-666666666,9276,126,0
10546,1092,41.5,116726,71264,538,554
10547,7421,39.6,81820,35618,3624,3797
10548,3089,49,93000,43271,1572,1517
10549,15798,38.2,81839,53118,8090,7708
10550,36804,34.3,39954,21310,16531,20273
10552,20815,40.9,64001,38778,9498,11317
10553,9895,40.7,58514,26137,4280,5615
10560,4786,51,127604,69264,2297,2489
10562,31502,39,74896,35764,16374,15128
10566,23702,39.7,58226,30011,11915,11787
10567,20241,42.6,105199,45174,9675,10566
10570,12735,39.2,123778,58914,6318,6417
10573,38429,38.3,66629,37421,19271,19158
10576,4948,49.2,154643,88349,2159,2789
10577,5823,20.3,228487,60184,2386,3437
10578,534,52.5,130260,46810,238,296
10579,8969,42.9,102188,43600,4491,4478
10580,17241,41.6,153640,96768,8109,9132
10583,39601,42.7,168571,89234,19445,20156
10588,2389,42,71686,38745,1050,1339
10589,9158,53.5,98462,60592,4137,5021
10590,6926,44.2,126012,62068,3483,3443
10591,22890,39.3,80814,46546,11127,11763
10594,5020,38.6,114286,41069,2639,2381
10595,8407,39.1,107708,38723,4728,3679
10596,1270,37.7,52051,24923,673,597
10597,1233,42.3,189737,91911,577,656
10598,29234,44.4,106576,46099,13813,15421
10601,10623,38.6,67754,49184,4938,5685
10603,18142,36.5,91903,42062,8145,9997
10604,11863,40.5,83842,49657,6256,5607
10605,18337,41.7,108047,56927,8995,9342
10606,16632,37.6,68368,35483,8449,8183
10607,7098,41,132857,53241,3745,3353
10701,61167,34.5,43767,23782,29147,32020
10703,20390,38,57116,25535,9984,10406
10704,30516,40.6,67091,32964,14460,16056
10705,39924,33.1,47358,22065,18583,21341
10706,8555,46.4,125960,66392,4352,4203
10707,10479,38.8,94897,49415,4900,5579
10708,21809,43.8,95815,67064,10091,11718
10709,9303,43.1,92098,49535,4636,4667
10710,26432,44.2,76526,37514,12317,14115
10801,41093,35.1,54504,27655,19998,21095
10803,12439,39.7,140000,73808,6033,6406
10804,15096,43.5,157950,76886,7108,7988
10805,18138,40.1,55639,32634,9057,9081
10901,22875,43.8,85147,46989,11266,11609
10910,26,-666666666,-666666666,,0,26
10911,0,-666666666,-666666666,-666666666,0,0
10913,5175,41.8,122857,46193,2572,2603
10914,224,10.9,123667,34202,61,163
10915,158,46.9,-666666666,17350,76,82
10916,4446,40.9,103583,37392,2321,2125
10917,1808,46.1,72216,41007,891,917
10918,12043,40,87114,36372,6006,6037
10919,1346,45,107500,38793,691,655
10920,8744,42.5,94526,42691,4166,4578
10921,3926,45.6,70975,32810,1888,2038
10922,1355,42.1,87566,36562,782,573
10923,8797,36.6,88047,31107,4271,4526
10924,13141,41.3,84661,36792,6292,6849
10925,4446,40.4,66888,41951,2342,2104
10926,3354,36.5,75906,38796,1639,1715
10927,11952,32.5,55556,25685,5736,6216
10928,4033,41.4,66493,34152,1966,2067
10930,9050,38.9,125356,41797,4607,4443
10931,950,42.5,78750,32285,511,439
10932,106,56.1,-666666666,39743,30,76
10933,819,30.3,95685,30479,373,446
10940,47833,36,61146,26514,23795,24038
10941,13959,38,66111,28235,6702,7257
10950,47611,23.9,74681,25160,23476,24135
10952,40193,21.2,53344,18879,20700,19493
10953,162,65.2,80714,44556,61,101
10954,23550,43.1,91302,40726,11672,11878
10956,30909,44.4,119764,46934,15549,15360
10958,3030,42.1,105845,32499,1685,1345
10960,15476,38.4,78750,45312,7752,7724
10962,6166,46.1,109786,36470,3128,3038
10963,4260,40.1,74583,18898,3019,1241
10964,1791,48.3,94750,41856,911,880
10965,14794,41.2,94271,41517,7073,7721
10968,2302,54,91343,67623,867,1435
10969,1674,43.3,79643,36621,913,761
10970,9670,41.8,74397,37268,4069,5601
10973,2789,41.6,83636,32251,1457,1332
10974,3149,39.5,87241,38384,1587,1562
10975,238,55.9,58077,46391,106,132
10976,2134,42.1,40675,24210,739,1395
10977,60293,28.1,60549,20124,29998,30295
10979,174,45.3,68352,31561,129,45
10980,13440,43.8,94709,39217,6451,6989
10983,5537,44.8,126875,50010,2591,2946
10984,3317,42.5,112016,39093,1664,1653
10985,13,-666666666,-666666666,,6,7
10986,2103,37.7,106932,48634,1051,1052
10987,3364,43.7,100369,55896,1646,1718
10988,819,35.5,70547,25936,415,404
10989,9868,48.1,100982,41499,4663,5205
10990,20139,43.7,84110,42206,10327,9812
10992,9839,44.3,91083,35287,4752,5087
10993,4678,36.8,67750,25767,2217,2461
10994,7206,41.2,129519,48340,3305,3901
10996,7013,20.9,98555,20447,5095,1918
10998,2759,43.7,101121,38182,1360,1399
11001,27001,41.3,101634,40753,12998,14003
11003,43739,36.5,85672,27888,20296,23443
11004,14500,40.9,81709,35334,6728,7772
11005,2055,81.1,64300,76670,744,1311
11010,24394,41.7,87644,34542,11586,12808
11020,6370,44.8,128309,58937,3109,3261
11021,17467,46.1,93258,60692,7972,9495
11023,9870,41.3,106729,47246,4989,4881
11024,7555,40.6,97383,45650,4038,3517
11030,17372,44.8,172266,88800,8351,9021
11040,40231,44.5,101434,39729,19666,20565
11042,544,82.1,-666666666,16851,197,347
11050,30666,41.5,105828,59576,15259,15407
11096,8276,32.4,48538,20403,4004,4272
11101,25537,34,47142,30040,12661,12876
11102,34529,32.3,49924,28108,17565,16964
11103,37745,34.9,55129,31345,19142,18603
11104,25729,37.3,56059,31953,12012,13717
11105,36190,35.3,57525,33537,18099,18091
11106,36869,36.5,48720,30809,18293,18576
11109,3524,31.6,125871,90065,1936,1588
11201,54668,35.2,95369,68814,26994,27674
11203,79572,38.3,48400,22227,35351,44221
11204,80963,33.6,45472,20161,40426,40537
11205,43002,29.3,44688,26114,20758,22244
11206,81525,28.5,28559,15618,39562,41963
11207,92491,30.7,32945,15951,41316,51175
11208,93107,30.5,35079,14870,43320,49787
11209,72623,39,58261,35712,33867,38756
11210,65302,34.9,55429,25079,30511,34791
11211,93271,29.7,46848,27752,46187,47084
11212,84520,31.9,28348,16535,34878,49642
11213,62059,32.8,34794,18522,28108,33951
11214,83156,40,43398,22683,40527,42629
11215,68891,34.5,95654,56340,33426,35465
11216,53783,34.8,43996,27218,25270,28513
11217,38787,34.9,81862,51846,18261,20526
11218,74758,32.7,52445,24081,36514,38244
11219,96971,28.1,34316,14567,48925,48046
11220,103089,32.4,37580,16263,53376,49713
11221,81321,31.6,39178,18774,37745,43576
11222,34186,33.7,63739,39515,16478,17708
11223,74606,38.7,41328,22514,35957,38649
11224,42535,47.3,27481,20666,18866,23669
11225,59182,33.8,42922,22519,26387,32795
11226,98325,33.8,40734,20721,44409,53916
11228,43929,40.2,61893,29885,21810,22119
11229,81030,40.8,51725,26575,38425,42605
11230,84219,34.7,42170,23051,40774,43445
11231,34137,35.3,78174,48757,16120,18017
11232,28824,31.6,43595,19172,16126,12698
11233,68599,33.4,34492,19859,30379,38220
11234,94259,38.4,68431,29482,44198,50061
11235,74630,44.5,41639,28133,34695,39935
11236,97217,37.1,61061,24394,43496,53721
11237,55478,29.1,40372,17134,28461,27017
11238,51895,34.5,65315,40055,24285,27610
11239,12879,43.4,26275,18494,4756,8123
11351,0,-666666666,-666666666,-666666666,0,0
11354,56258,43.2,46566,23925,27046,29212
11355,83221,40.9,41884,20505,39595,43626
11356,23037,37.2,58465,25815,11482,11555
11357,40872,43.9,71978,34218,19078,21794
11358,38317,41.9,65722,30403,18753,19564
11359,0,-666666666,-666666666,-666666666,0,0
11360,19865,48.2,76183,42810,9559,10306
11361,30597,40.3,75335,32438,14510,16087
11362,17865,45,82332,38441,8626,9239
11363,7354,43.1,90799,44661,3828,3526
11364,34751,42.9,72909,33820,16762,17989
11365,41924,41.7,55492,26786,19458,22466
11366,13499,41.4,71350,30027,6591,6908
11367,41022,34.9,56608,26475,19884,21138
11368,107962,31.5,45964,16191,58332,49630
11369,40761,33.5,53617,20000,20863,19898
11370,37244,34.9,52500,17873,22374,14870
11371,0,-666666666,-666666666,-666666666,0,0
11372,63320,38.2,48683,24955,31734,31586
11373,99159,36.2,47667,21084,50558,48601
11374,42297,40.6,52532,34268,20358,21939
11375,69757,42.1,72000,44278,32444,37313
11377,86316,35.8,49886,24058,43070,43246
11378,32268,38.9,57474,28290,15626,16642
11379,35822,43.4,69843,33111,17248,18574
11385,99379,35,50799,23272,49011,50368
11411,18722,44.3,83099,32156,8610,10112
11412,37176,39.1,70672,25315,16560,20616
11413,40385,39,78667,28502,18168,22217
11414,28094,45.1,66790,34143,12911,15183
11415,19145,36.9,63549,35653,8974,10171
11416,25950,33.4,56724,20726,12967,12983
11417,31004,35.8,62086,24299,14987,16017
11418,36828,34.1,60691,22641,18104,18724
11419,49193,36.4,56735,19296,24234,24959
11420,48449,36.5,59832,22841,23009,25440
11421,42588,34.2,60897,23016,20985,21603
11422,33280,35,84824,29440,14712,18568
11423,31625,39.8,60892,26690,14939,16686
11424,0,-666666666,-666666666,-666666666,0,0
11425,0,-666666666,-666666666,-666666666,0,0
11426,19575,39.8,82301,31501,9524,10051
11427,24877,39.9,70108,28716,11691,13186
11428,20307,39.4,69330,24002,9877,10430
11429,28311,39.9,68890,24113,13544,14767
11430,140,42.2,-666666666,8092,120,20
11432,61687,36,50450,21897,29649,32038
11433,32821,32.4,42887,19142,14485,18336
11434,62809,36.4,59229,24121,27959,34850
11435,53542,35.5,53041,23252,26654,26888
11436,17636,36.6,62114,23264,8564,9072
11451,0,-666666666,-666666666,-666666666,0,0
11501,18991,41.9,79013,38353,9356,9635
11507,6998,45.8,90833,42388,3382,3616
11509,2022,54.5,109375,82173,1003,1019
11510,32553,40,98798,36706,15799,16754
11514,5273,40.7,84651,33656,2569,2704
11516,7477,34.3,85985,34619,3793,3684
11518,10243,44.9,92866,42671,5099,5144
11520,43472,38.2,67723,28368,20669,22803
11530,28019,42.7,135370,62403,13256,14763
11542,27585,39.4,67914,35789,13941,13644
11545,13005,44.9,146083,75955,6501,6504
11547,718,42.5,97212,37577,254,464
11548,2338,21.2,98375,22515,972,1366
11549,2429,20.5,-666666666,3857,885,1544
11550,56773,32.6,53669,22040,27432,29341
11552,22565,41.3,98798,36788,11157,11408
11553,26231,34.1,75008,21964,12395,13836
11554,37687,43.1,92311,35976,18674,19013
11556,0,-666666666,-666666666,-666666666,0,0
11557,7538,46.4,115516,54248,3776,3762
11558,8688,44.1,77056,34006,4201,4487
11559,8188,37.3,112862,49849,3992,4196
11560,6534,45.6,99278,65519,3233,3301
11561,37894,43.6,91984,47434,17995,19899
11563,23177,43.1,90896,37739,10876,12301
11565,8752,43.7,117500,46289,4143,4609
11566,33582,43.9,126532,50721,16463,17119
11568,4000,23.5,192500,68298,2012,1988
11569,1309,48.5,108664,74832,610,699
11570,27235,43.3,104503,52028,13026,14209
11572,28627,44.5,96563,41601,13847,14780
11575,16200,33.2,66922,22523,7614,8586
11576,12524,45.6,150161,83914,6186,6338
11577,12541,43,112552,53852,6050,6491
11579,5369,43.3,100250,49784,2712,2657
11580,41129,39.4,88771,32343,20092,21037
11581,21134,38.3,98113,36633,10600,10534
11590,45656,37.3,87894,33663,21891,23765
11596,10582,44,112596,48064,5204,5378
11598,13167,40,140917,55430,6644,6523
11691,61091,31.2,39409,18796,28055,33036
11692,17674,35.4,43354,21603,8238,9436
11693,11335,39.1,50570,25149,5227,6108
11694,21725,43.7,76944,36601,10672,11053
11697,4223,50.3,87636,41282,2105,2118
11701,27536,40,69733,28280,12715,14821
11702,14706,41.8,94558,45048,7234,7472
11703,15954,40.6,90872,35405,8105,7849
11704,40617,39.9,80377,31732,19286,21331
11705,7726,42.6,88958,41602,3654,4072
11706,65821,34.6,75775,27716,32721,33100
11709,6701,46,98362,42827,3058,3643
11710,35345,41.5,103686,40691,17469,17876
11713,9328,38.5,75183,34903,4117,5211
11714,23799,43.1,87327,36494,11201,12598
11715,4441,44.2,102841,42945,2039,2402
11716,11336,40.7,90362,34884,5513,5823
11717,57375,32.8,69405,20945,29190,28185
11718,3105,43.3,115909,53063,1620,1485
11719,3290,46.5,82875,38483,1472,1818
11720,29931,38.9,94658,33263,15321,14610
11721,6369,42.7,94929,47609,2771,3598
11722,38241,33.1,67023,21935,19235,19006
11724,2846,45.6,139971,72232,1522,1324
11725,28602,44.1,112024,42957,13941,14661
11726,20233,36.8,73164,26129,9764,10469
11727,29056,38.3,76333,34440,14140,14916
11729,27562,40.8,80279,33005,12858,14704
11730,13921,40.6,105000,40389,6360,7561
11731,29173,42.5,106154,42765,15023,14150
11732,3469,47.1,96989,56681,1518,1951
11733,17788,44.4,141233,58268,8966,8822
11735,32502,42.1,91196,36277,15619,16883
11738,18131,37,91875,32349,9700,8431
11739,1467,43.6,129620,55544,858,609
11740,9459,43.5,94474,45432,4480,4979
11741,27688,41.1,94527,36527,13179,14509
11742,13404,37.5,86346,35247,6798,6606
11743,43611,43.4,118222,56998,21389,22222
11746,67412,39.4,97796,40980,33548,33864
11747,20214,45.6,112699,58495,9593,10621
11749,3431,42.1,90699,31753,1655,1776
11751,14293,42.8,95515,43349,7141,7152
11752,9367,42.4,94574,34049,4714,4653
11753,11748,44.6,153438,71943,5703,6045
11754,19110,43.4,98226,40573,9554,9556
11755,12222,38.6,94167,35631,6118,6104
11756,42817,41,99588,36398,20806,22011
11757,45565,40.5,82383,32624,21938,23627
11758,55009,43.1,104986,42037,26837,28172
11762,22431,43.2,112198,41152,10753,11678
11763,29495,37.3,88772,31177,13940,15555
11764,12846,39,113630,44455,6137,6709
11765,654,49.7,165125,144524,325,329
11766,11887,45,104110,45892,5806,6081
11767,15341,40.5,109204,39017,7279,8062
11768,21735,45.9,120309,57907,10876,10859
11769,8592,45.1,92188,43475,4127,4465
11770,199,31.7,88750,35043,75,124
11771,8981,45.9,106120,72631,4254,4727
11772,45265,38.1,68230,29303,22334,22931
11776,25969,37.5,84733,34380,12643,13326
11777,9351,43.3,109696,50801,4490,4861
11778,12605,37.5,85893,32989,6161,6444
11779,39094,39.9,87081,33356,19686,19408
11780,14676,45.5,109091,49768,7029,7647
11782,15132,43.3,108594,45599,7060,8072
11783,21145,41.9,104523,40545,10294,10851
11784,26158,36.5,88104,29637,12745,13413
11786,6378,42.2,130800,45690,3207,3171
11787,36606,42.8,107477,43115,18070,18536
11788,16598,42.4,104888,41344,8290,8308
11789,7935,34.7,79764,33497,3926,4009
11790,18073,28.8,138036,42970,9154,8919
11791,25639,41.4,139565,61647,12525,13114
11792,9303,39.9,119137,43051,4629,4674
11793,32348,43.6,113277,43932,15751,16597
11794,3080,20.3,-666666666,4039,1640,1440
11795,25821,42.2,104923,39226,12392,13429
11796,3939,44.3,96071,36973,1889,2050
11797,8796,50.7,150920,77352,4294,4502
11798,14920,33,65000,22291,6736,8184
11801,39653,42.3,91718,37152,19349,20304
11803,28448,44.5,120955,48881,13681,14767
11804,4921,42.5,115370,42961,2514,2407
11901,29579,39.1,51350,24822,16108,13471
11930,1201,56.5,76326,55289,645,556
11931,51,51.7,-666666666,71402,18,33
11932,933,56.3,67083,61549,480,453
11933,6391,47.8,64593,39323,3179,3212
11934,7425,38.8,93929,34051,3617,3808
11935,3271,51.6,91298,45369,1575,1696
11937,15794,45.8,81057,47654,8233,7561
11939,1012,58.6,66583,43634,496,516
11940,5019,44.1,92200,42441,2552,2467
11941,1799,49.8,58487,43042,854,945
11942,4501,44.4,87044,42506,2233,2268
11944,4277,47.4,54394,37215,2043,2234
11946,13297,42.3,72023,34415,6862,6435
11947,114,61.5,24300,41232,28,86
11948,1164,49.1,113036,52530,535,629
11949,14241,39.1,104785,40449,7335,6906
11950,17712,35.1,68338,24206,8972,8740
11951,14048,35.5,65534,24396,6766,7282
11952,4659,48,86286,41164,2158,2501
11953,12302,43,69690,32896,5864,6438
11954,3471,51.3,68528,47893,1692,1779
11955,2789,52.3,63766,38413,1311,1478
11956,329,62.4,67188,49479,146,183
11957,714,59.4,82895,50624,365,349
11958,262,61.3,83000,107619,111,151
11959,766,61,96667,61205,343,423
11960,878,52.5,100923,52550,439,439
11961,11906,49.3,54312,33261,5652,6254
11962,469,49.2,106250,64088,261,208
11963,6602,50.7,85583,62783,3265,3337
11964,1846,50.9,76133,49400,867,979
11965,631,50.2,92100,51371,284,347
11967,26488,35.7,82557,27462,12880,13608
11968,11245,45.9,84715,57186,5594,5651
11970,505,54.5,108558,67227,166,339
11971,6317,53.3,90294,45709,3180,3137
11972,1112,40.4,94375,42116,579,533
11973,33,21,-666666666,894,7,26
11975,359,57.9,71250,53086,199,160
11976,1934,55.4,160536,87122,995,939
11977,2271,55.3,96648,52286,1069,1202
11978,3233,51.4,80066,50971,1481,1752
11980,4756,40.9,84972,30898,2703,2053
12007,97,39,80000,23297,65,32
12008,485,42.8,58375,29941,284,201
12009,7327,44.2,80750,39330,3568,3759
12010,28802,41.7,44256,25059,13873,14929
12015,2804,44.4,61164,27581,1359,1445
12017,310,39.2,67917,26488,134,176
12018,7608,44.2,80126,37799,3677,3931
12019,14841,43.5,90897,38870,7336,7505
12020,31403,39.8,68252,33396,15376,16027
12022,1002,41.8,68438,29380,471,531
12023,2071,48.2,56250,30223,1090,981
12024,102,42.4,-666666666,14257,28,74
12025,5464,43.2,56938,29044,2737,2727
12027,3816,44.9,95690,38167,1944,1872
12028,970,39.7,77143,28680,548,422
12029,1127,42.4,78365,29674,688,439
12031,139,48.8,52813,24386,75,64
12032,795,47.1,45938,26828,386,409
12033,7824,45,68382,33523,3812,4012
12035,727,34.8,39813,23294,370,357
12036,220,38.7,45982,17137,110,110
12037,4288,44.7,56354,32043,2084,2204
12040,97,50.5,65625,26267,39,58
12041,352,44.8,46944,24780,201,151
12042,236,58,68750,38982,132,104
12043,8390,35.7,49589,25345,4179,4211
12045,326,43.3,35905,21560,184,142
12046,907,37.6,75263,37045,492,415
12047,20102,42,47138,28117,9644,10458
12051,7081,34.6,49408,19453,5012,2069
12052,1451,48.3,68500,33673,729,722
12053,4223,45.8,86250,36725,2240,1983
12054,16810,41.7,94874,44765,8332,8478
12056,2446,45.5,91300,36012,1252,1194
12057,2189,38.8,53194,22957,1157,1032
12058,1276,49.7,49479,30970,673,603
12059,1555,46.9,83409,38794,732,823
12060,1503,45.9,79219,47993,720,783
12061,9537,41.5,84714,38950,4451,5086
12062,1481,47.9,65294,30825,750,731
12063,425,40.8,125109,56233,194,231
12064,336,52.3,37500,24293,197,139
12065,42069,40.8,80908,40666,20598,21471
12066,2212,39.1,63750,25620,1044,1168
12067,1574,35.8,68125,26478,858,716
12068,3068,39.8,47813,21828,1517,1551
12069,180,44.5,54737,30641,123,57
12070,1521,46.1,69643,29809,752,769
12071,209,48,56500,28123,120,89
12072,2797,39.8,53387,24964,1434,1363
12074,3109,45.8,72328,36640,1573,1536
12075,3034,48.7,67755,33717,1626,1408
12076,1518,49.7,57868,25965,738,780
12077,6580,43.9,82966,37839,3407,3173
12078,23696,40.8,37766,20975,11427,12269
12083,3736,49.5,49375,29713,1773,1963
12084,4429,33.7,71750,38962,1968,2461
12085,523,43.1,50673,25033,143,380
12086,1410,54.3,52036,32028,695,715
12087,804,40.3,51667,25181,393,411
12089,80,49.3,60431,29794,61,19
12090,6127,43.6,54716,24803,2871,3256
12092,904,60.1,41757,30979,401,503
12093,1798,43.1,56563,25417,996,802
12094,2285,40.5,54594,26035,1091,1194
12095,12515,39.8,43967,24633,6482,6033
12106,2309,43.8,70156,36506,1041,1268
12108,370,54.1,51563,27047,175,195
12110,21244,40.5,76408,34237,9965,11279
12115,237,51,81167,79222,120,117
12116,1923,50.5,51736,25979,926,997
12117,3519,48.1,55032,25845,1762,1757
12118,14204,40.2,61389,30319,6700,7504
12120,723,43.3,47083,30297,376,347
12121,2031,43.6,70365,26482,1095,936
12122,4498,43.8,50532,25814,2196,2302
12123,5502,43.4,65458,33450,2954,2548
12124,767,44.8,113958,44432,385,382
12125,1451,47.1,50726,27731,671,780
12130,1157,44.8,87643,27189,561,596
12131,117,60.2,37917,21079,67,50
12132,246,51.3,80833,76647,123,123
12134,3610,46.4,48547,25937,1783,1827
12136,652,56.6,88594,71421,363,289
12137,1813,46.4,63542,30254,879,934
12138,3199,45.9,65857,29135,1618,1581
12139,141,54.4,44063,29287,68,73
12140,1721,38.7,80083,30030,757,964
12143,5026,41.9,57371,28407,2442,2584
12144,20447,41.5,63449,33178,9942,10505
12147,565,43.1,60875,24955,295,270
12148,4322,44.2,107540,44237,2037,2285
12149,2478,38.1,49357,22702,1113,1365
12150,779,42.6,76151,30926,379,400
12151,594,51.7,73304,42465,284,310
12153,1005,42.7,82724,36994,486,519
12154,2838,44.3,67721,30950,1479,1359
12155,1938,41.2,45938,19355,905,1033
12156,933,40.5,64107,31616,434,499
12157,4631,46.4,60560,33601,2248,2383
12158,6531,39.2,79662,32192,3103,3428
12159,7973,46,87794,50463,3693,4280
12160,1095,42.3,56923,26913,551,544
12161,159,41.9,98125,33677,101,58
12164,353,51.2,57083,33468,171,182
12165,173,55.5,56111,49390,103,70
12166,1368,44.1,55341,23910,731,637
12167,2577,50.6,49605,24921,1139,1438
12168,1748,44.5,59688,28333,794,954
12169,270,54,45000,24476,145,125
12170,5311,37.7,70377,26885,2662,2649
12172,387,50.4,40500,23056,218,169
12173,1592,45.9,68137,29055,848,744
12174,272,42.9,63527,27274,148,124
12175,861,42.3,51094,20580,495,366
12176,391,43.2,73750,23887,250,141
12177,560,39.1,68750,39779,330,230
12180,53812,32.7,47640,25856,27085,26727
12182,14260,41.2,45251,25014,7060,7200
12183,2609,34.1,52292,24741,1320,1289
12184,6867,45.2,78247,41851,3504,3363
12185,2236,46.5,73684,31315,1086,1150
12186,6346,45.6,83846,42868,3315,3031
12187,413,40.1,67500,28335,163,250
12188,11249,38.5,66211,34539,5507,5742
12189,17860,35.3,47263,28734,8644,9216
12190,718,55.5,40208,27696,346,372
12192,2145,42.8,55167,28234,960,1185
12193,1784,47.2,72396,38902,958,826
12194,152,57.7,41875,32605,84,68
12195,170,64.9,44926,32895,74,96
12196,3392,46.4,92521,39635,1730,1662
12197,2662,48.4,50897,24907,1224,1438
12198,7994,38.3,82188,35319,3805,4189
12202,9024,33.3,29214,18949,3885,5139
12203,30505,32.9,54059,30143,14193,16312
12204,7102,33.8,49993,35081,3296,3806
12205,27097,43.6,65090,32677,13329,13768
12206,16885,28.4,26883,16571,8193,8692
12207,1879,35.2,11879,10994,1108,771
12208,21327,34.8,58825,32705,10042,11285
12209,10913,36.3,56972,26692,5055,5858
12210,9079,31.2,32813,26868,4976,4103
12211,12054,46.8,95554,45727,5964,6090
12222,5983,19.4,-666666666,2529,3103,2880
12302,27723,44.2,66021,30978,13449,14274
12303,30276,39.8,61267,30667,14491,15785
12304,21708,38.8,43743,24635,10030,11678
12305,5389,38,28156,20292,2873,2516
12306,25785,41.2,58869,28602,12373,13412
12307,7619,30.6,21875,12077,3778,3841
12308,14401,31.7,40598,22072,6847,7554
12309,29419,43.2,87374,41641,14431,14988
12401,34844,42.8,47225,26714,16559,18285
12404,3435,42.6,67639,34997,1756,1679
12405,502,63.9,46019,24821,296,206
12406,707,39.2,40750,39051,349,358
12407,179,49.8,28750,35678,67,112
12409,537,58.4,53750,46342,264,273
12410,672,48.4,60469,30867,368,304
12411,487,38.3,63618,23526,246,241
12412,372,57.5,52250,56913,215,157
12413,2802,48,43370,23230,1255,1547
12414,10706,41.9,49396,24642,5313,5393
12416,254,53.9,33295,26450,126,128
12417,757,38.9,50509,21560,318,439
12418,388,52.2,63958,36282,194,194
12419,548,44.7,48807,38941,220,328
12420,413,61.6,68929,35630,199,214
12421,489,50.6,58315,30148,294,195
12422,252,55.6,30208,13923,125,127
12423,1095,40.2,48813,21886,506,589
12424,257,53.8,34844,26595,123,134
12427,632,31.9,110292,17554,265,367
12428,6612,38.7,44718,22196,3373,3239
12429,273,38.7,114129,43122,191,82
12430,973,51.9,48333,25352,438,535
12431,1379,47.2,56842,29961,678,701
12432,387,43.7,66550,31765,191,196
12433,404,44.8,64063,52997,220,184
12434,551,57.3,32857,18945,245,306
12435,279,51.4,62727,25787,156,123
12436,478,52.9,87276,38829,243,235
12438,51,54.7,120417,62573,22,29
12439,222,55.5,39167,23216,94,128
12440,1999,45.6,64482,34812,935,1064
12441,33,49.4,116563,44027,19,14
12442,885,54.3,36164,33215,457,428
12443,3743,47.1,76814,40963,1882,1861
12444,401,58.8,28365,25123,176,225
12446,4723,43.5,51696,29914,2303,2420
12448,414,49.7,61310,41268,243,171
12449,3398,50.8,50236,30613,1693,1705
12450,204,58.7,22200,20052,53,151
12451,1878,38.5,60665,30968,1037,841
12452,294,44.5,70139,21548,148,146
12453,298,39.1,203625,45933,217,81
12454,227,46.6,73125,30234,126,101
12455,2128,55.6,47519,24545,1113,1015
12456,707,37.5,48993,17639,342,365
12457,873,54.9,53594,43244,445,428
12458,3730,41.6,52442,19659,2455,1275
12459,180,58,73933,50247,106,74
12460,306,32.3,52237,18912,142,164
12461,1976,47.1,61793,44215,1023,953
12463,1042,49.7,44938,28519,539,503
12464,935,58.1,49911,37118,501,434
12465,194,51.4,50833,66123,108,86
12466,2150,48.1,59873,35161,902,1248
12468,1052,51.5,41696,23930,559,493
12469,660,53.6,51324,30950,352,308
12470,743,43.5,24722,17575,253,490
12471,667,30.5,51840,15989,267,400
12472,1749,35.7,41224,22140,908,841
12473,1271,41.2,71702,30880,588,683
12474,1497,44.7,51750,23203,717,780
12475,316,50.9,48864,27934,170,146
12477,18860,43.5,60862,32721,9514,9346
12480,460,60.4,23125,30398,228,232
12481,1177,49,54362,37806,589,588
12482,743,45.7,29750,20136,471,272
12483,421,38.1,36964,16557,187,234
12484,3160,44.4,84241,35944,1414,1746
12485,712,42.9,41591,21893,325,387
12486,1410,42.6,72135,32360,773,637
12487,3230,42.8,67350,32986,1689,1541
12489,844,42.7,41306,13105,681,163
12490,67,58.4,-666666666,42743,47,20
12491,1766,53.2,61667,37254,890,876
12492,359,51.4,52212,29932,183,176
12493,198,40.3,87344,38998,68,130
12494,930,50.8,66875,29074,410,520
12495,248,40.3,50156,30398,144,104
12496,1687,55.8,50536,28404,839,848
12498,5158,53,65676,45253,2474,2684
12501,2593,34.2,64040,27342,1296,1297
12502,1074,54.8,64545,30762,578,496
12503,801,46.8,70000,33991,448,353
12504,1249,20,-666666666,4381,493,756
12507,197,21.4,66250,17419,104,93
12508,19917,39.8,62792,29936,10206,9711
12512,127,58.5,72381,77613,63,64
12513,541,57.5,60833,29589,328,213
12514,2835,46.9,91193,40946,1472,1363
12515,1242,44.8,61394,36130,638,604
12516,2109,49.1,66190,45193,1057,1052
12517,633,41.1,51806,23281,379,254
12518,6139,41,80692,37244,3143,2996
12520,3068,41.9,84808,45643,1401,1667
12521,1533,48,53850,28883,753,780
12522,4929,50,56859,29843,2499,2430
12523,1788,40.8,51923,30943,918,870
12524,15556,42.2,74513,35146,8020,7536
12525,2991,38.6,76535,33210,1563,1428
12526,3716,46.4,60430,31526,1684,2032
12527,143,35.4,143500,39642,70,73
12528,13119,42,63974,32619,6274,6845
12529,2561,49.7,78365,58016,1337,1224
12530,8,-666666666,-666666666,,4,4
12531,3502,45.4,90208,39567,1763,1739
12533,25942,40.6,100842,40563,12925,13017
12534,18098,43.5,46261,26691,9033,9065
12538,13708,41.9,70599,32474,6411,7297
12540,7704,41.8,99697,41467,3764,3940
12542,6222,39.8,62548,29206,2917,3305
12543,3027,36,61250,28375,1382,1645
12545,4655,46.8,61869,38776,2208,2447
12546,3009,44.3,61964,32206,1514,1495
12547,2694,43.7,64258,30235,1394,1300
12548,1380,43.7,52986,26035,699,681
12549,10517,38.7,81011,32871,4852,5665
12550,54565,34.9,56444,25881,26214,28351
12553,25228,40,71608,32332,12418,12810
12561,18261,31.6,66261,31935,8220,10041
12563,7694,39.2,92950,29227,3719,3975
12564,7485,43.2,76825,40490,3793,3692
12565,1478,42.3,43750,26341,847,631
12566,11185,41.1,80548,31811,5823,5362
12567,2701,48.5,63244,31979,1358,1343
12569,9521,40.8,76517,36415,4871,4650
12570,7693,42.3,93875,39723,3907,3786
12571,10332,44,69091,35753,5158,5174
12572,9046,51.8,72551,47953,4414,4632
12574,457,54.6,65000,35632,212,245
12575,1975,44.1,94958,34960,953,1022
12577,1298,43.1,92167,35915,613,685
12578,2713,44.1,92375,35343,1554,1159
12580,4489,44.6,77394,39132,2051,2438
12581,2159,46.2,67992,37757,1101,1058
12582,6245,40.6,97941,30242,4110,2135
12583,2443,39.5,53036,25051,1242,1201
12585,953,38.9,96829,38027,495,458
12586,12705,36.7,64308,28793,6502,6203
12589,18031,37.5,77500,25751,9785,8246
12590,34962,41.1,78573,34907,17860,17102
12592,1282,43.4,59000,31444,592,690
12594,4427,40.6,76190,27784,2255,2172
12601,42522,34.5,42411,23616,20194,22328
12603,43802,39.2,80250,33118,21019,22783
12604,774,20.2,-666666666,3679,174,600
12701,10792,37.7,27702,16957,5452,5340
12719,1263,47.8,59485,34096,677,586
12720,231,55,78538,45942,117,114
12721,5818,40.4,56964,28670,3080,2738
12722,150,50.9,22292,24219,84,66
12723,2196,43.2,58102,25249,1052,1144
12724,330,65.5,62170,29150,135,195
12725,189,45.5,49375,34007,96,93
12726,1175,41.8,58208,30606,534,641
12729,2155,39.1,55417,26030,1170,985
12732,619,53,39625,31552,312,307
12733,1447,33.1,43523,7687,998,449
12734,754,53.8,29779,33139,409,345
12736,161,48.5,38750,24759,61,100
12737,2169,40,56154,23769,1133,1036
12738,725,43,74261,38250,288,437
12740,1603,46.6,56411,26716,815,788
12741,360,45.8,64688,28271,180,180
12742,321,27.6,59271,15757,164,157
12743,376,32.7,49861,26397,223,153
12745,127,49,50500,26252,65,62
12746,1326,33.7,59681,25756,762,564
12747,1523,40.3,47470,20428,758,765
12748,1734,51.1,52375,39177,848,886
12749,189,71.5,37120,27510,72,117
12750,72,42.5,37857,36178,46,26
12751,1083,15.9,32083,14821,511,572
12752,139,52.8,52292,32222,87,52
12754,7728,40.9,36313,23582,4057,3671
12758,4303,42.7,50560,28364,2234,2069
12759,2033,30.1,37902,13996,1054,979
12760,657,45.9,42083,34821,283,374
12762,244,74,51932,43095,108,136
12763,726,45.9,60368,31516,292,434
12764,1688,48.7,52604,29466,857,831
12765,806,40.2,57188,29225,338,468
12766,477,51.1,56818,26690,258,219
12767,108,46,93056,29753,61,47
601,18450,36.6,12041,7380,8983,9467
602,41302,38.6,15663,8463,20272,21030
603,53683,38.9,15485,9176,26240,27443
606,6591,37.3,15019,6383,3192,3399
610,28963,39.2,16707,7892,14040,14923
612,68055,38.5,17848,10188,32275,35780
616,10183,40.9,15342,8767,5029,5154
617,24879,36.2,14982,7939,11894,12985
622,6165,42,14281,8751,2753,3412
623,44704,39.7,17389,9326,21549,23155
624,25340,34.2,14768,6761,12340,13000
627,34806,37.9,19527,9112,16822,17984
631,1747,43.9,11596,6561,860,887
637,24996,38.8,16430,8045,11908,13088
638,18742,37.2,13860,6526,9198,9544
641,30401,38.7,14924,7479,14820,15581
646,38303,37.5,28306,14374,18374,19929
647,5640,41.3,13925,7384,2762,2878
650,14969,36.2,16133,7038,7349,7620
652,3461,40.1,12809,9406,1623,1838
653,13461,36.6,12595,6465,6444,7017
656,21172,36.5,15054,7534,10242,10930
659,41932,37.9,19199,9428,20266,21666
660,17151,42.4,21107,10609,7983,9168
662,43535,38.4,15600,8124,21157,22378
664,16508,33.9,19342,7841,8220,8288
667,25797,39.6,14081,6763,12603,13194
669,28984,37.7,11790,6600,14321,14663
670,9689,37.7,15817,7016,4796,4893
674,43848,37.9,18048,9838,20827,23021
676,39916,35.8,14697,7700,19582,20334
677,15108,41.3,15875,8986,7317,7791
678,27229,37.5,14877,7274,13283,13946
680,56003,38.6,15115,8745,27185,28818
682,32509,35,15067,10869,15243,17266
683,33442,40.6,15587,9178,16308,17134
685,41947,39.7,14623,7192,20471,21476
687,32609,33.8,14797,7060,16240,16369
688,13340,40.1,14148,6757,6755,6585
690,6299,33.8,19474,9251,2963,3336
692,37618,35,18500,9273,17877,19741
693,60211,37.4,16406,9051,29119,31092
694,157,70.5,10750,7616,99,58
698,41179,39.2,15099,7491,19902,21277
703,29153,35.5,14673,7734,14127,15026
704,7867,34.2,12612,7229,3966,3901
705,25373,37.5,15892,8868,12307,13066
707,12070,39.1,18446,8134,5960,6110
714,19443,35.6,16350,8208,9142,10301
715,4315,41.1,14114,10149,2275,2040
716,32180,37.6,18878,11773,15545,16635
717,17972,32.9,12407,9120,7860,10112
718,26767,34.5,17123,9038,12791,13976
719,30793,35.7,16672,8819,15235,15558
720,23080,35.1,14903,6687,11626,11454
723,19017,39.4,14506,7851,9382,9635
725,90206,37.3,20926,11273,42670,47536
727,56972,38.2,29433,15088,26747,30225
728,42692,36.4,18637,9100,21175,21517
729,54768,35.2,22438,10534,26204,28564
730,37931,37,16259,9768,17904,20027
731,14525,40.9,15733,8126,7077,7448
735,13495,38.7,19615,9433,6374,7121
736,51576,37.7,21206,11711,25093,26483
738,34492,38.4,22140,10894,16338,18154
739,38673,37.1,24638,11703,18774,19899
740,1760,27.7,11026,6968,718,1042
741,5025,41.3,18397,8944,2112,2913
745,54681,37.3,23275,10634,26699,27982
751,23430,36,13565,7815,11205,12225
754,40330,37.3,17904,10004,19790,20540
757,23231,34.3,18033,9412,11226,12005
765,9206,41.9,17500,8414,4665,4541
766,25991,34.5,16517,7944,12759,13232
767,37442,37.7,17306,7960,18240,19202
769,40026,35.7,17710,8971,19460,20566
771,38504,36,18553,9367,18689,19815
772,21712,35.5,16432,7622,10417,11295
773,19918,38.4,18593,10408,9434,10484
775,1478,38.4,16188,8142,822,656
777,40892,34.9,18574,9471,19515,21377
778,46109,36,27475,13892,22000,24109
780,13418,38.1,21706,13433,6697,6721
782,18504,36.4,12527,7026,9270,9234
783,36466,35.4,16201,7906,17814,18652
784,43746,35.2,17540,9170,21573,22173
786,335,47,22656,12059,172,163
791,52760,38.5,20364,11115,25306,27454
794,30688,33,14986,7229,15113,15575
795,47580,35.4,17278,8381,22649,24931
901,6444,41.7,13620,21534,3487,2957
906,36,27.4,-666666666,19894,25,11
907,17696,47.6,32570,32394,8224,9472
909,5910,39.1,16891,11825,2847,3063
911,7595,48.3,26611,25328,3566,4029
912,6541,38.3,18960,12254,3018,3523
913,8255,28.6,6926,10551,3531,4724
915,31812,37,13150,7368,14594,17218
917,20557,44.7,16802,12357,9354,11203
918,16472,39.5,26573,22652,7046,9426
920,18540,43.3,25463,14953,8602,9938
921,38077,36.2,18417,11498,17016,21061
923,28618,37.1,15959,10701,13305,15313
924,58061,35,19510,10939,26194,31867
925,6877,32.7,12847,9886,3547,3330
926,107139,40,35308,21058,49782,57357
927,15340,45.6,34572,28433,6666,8674
934,245,26.5,82721,25719,154,91
936,1151,54.9,-666666666,13470,622,529
949,81758,36.2,25514,12223,38906,42852
950,0,-666666666,-666666666,-666666666,0,0
951,16,-666666666,-666666666,,9,7
952,9611,40.3,18768,9362,4642,4969
953,73236,34.8,28488,12741,35335,37901
956,77151,38.1,22212,10765,36955,40196
957,46252,37.1,23736,11453,21632,24620
959,48495,39.2,26264,14448,21846,26649
960,1496,32.8,-666666666,8586,1479,17
961,32691,41.3,29931,15555,16210,16481
962,21717,34.7,16128,8444,9959,11758
965,8988,36,16139,7683,4319,4669
966,16371,42,52463,34449,7589,8782
968,3532,56.4,41936,36866,1440,2092
969,42756,39.6,50811,26581,20066,22690
971,30410,40.7,23241,13223,14792,15618
976,63387,36.3,30372,15048,30072,33315
979,16248,46.4,37906,26361,7455,8793
982,16216,42.6,26148,13244,7396,8820
983,41590,36.8,27125,13949,18915,22675
985,36507,39.7,25509,12127,17087,19420
987,59324,36.3,31546,14072,27689,31635
1001,17245,43.7,58733,28457,8001,9244
1002,29266,22.9,54422,27691,14364,14902
1003,11032,19.9,-666666666,3531,5225,5807
1005,5356,42.2,68644,31686,2831,2525
1007,14673,41.3,71875,32222,7341,7332
1008,1144,47.1,71635,32457,583,561
1009,716,44,38644,26422,338,378
1010,3635,45.4,81196,36406,1697,1938
1011,1414,43.6,64891,26847,712,702
1012,577,51,58750,30189,307,270
1013,22113,35.5,41273,20889,10905,11208
1020,30571,43.4,51255,27207,15172,15399
1022,2794,37.4,58938,29618,1204,1590
1026,1057,47.9,52155,31585,526,531
1027,17605,43.2,59963,31327,8588,9017
1028,15816,45.5,80469,36171,7471,8345
1029,596,53.1,54330,33352,334,262
1030,11310,44.4,71228,31992,5615,5695
1031,1484,43.1,42404,28090,753,731
1032,570,49.1,61806,33395,264,306
1033,6182,44.9,73816,31069,2848,3334
1034,2174,46.2,77500,32908,1143,1031
1035,5254,45,73250,36471,2421,2833
1036,5129,48.4,81130,35699,2548,2581
1037,624,53.6,84444,42109,357,267
1038,2832,47.7,61603,36282,1309,1523
1039,1566,50.2,72188,36880,750,816
1040,40029,36,31628,19968,18583,21446
1050,2548,41.5,56184,26597,1185,1363
1053,1909,51,64896,25039,1011,898
1054,1759,50.3,73000,40416,883,876
1056,21247,44.4,61073,31117,10429,10818
1057,8707,45,64747,32046,4296,4411
1060,15026,34.2,52607,33655,6104,8922
1062,11007,43.8,65756,39088,5266,5741
1063,644,20.2,-666666666,2353,16,628
1066,0,-666666666,-666666666,-666666666,0,0
1068,1839,44.7,85556,32805,889,950
1069,8975,42.2,53417,26238,4372,4603
1070,579,54.5,63889,30544,292,287
1071,1401,44.5,75363,33090,737,664
1072,1464,47,66705,35493,735,729
1073,5878,41.2,80000,34196,2990,2888
1074,56,38.1,-666666666,38243,48,8
1075,17796,41.6,61431,30643,7014,10782
1077,9552,43.4,78476,35587,4715,4837
1079,495,46,34906,29734,223,272
1080,2012,43.2,40559,22950,971,1041
1081,1703,44.7,56726,30411,913,790
1082,10318,45.3,51717,28354,5035,5283
1083,3137,34.1,39521,22435,1498,1639
1084,209,55.5,51667,31790,97,112
1085,40721,39.1,59881,28943,19897,20824
1086,1219,19.6,-666666666,1963,520,699
1088,451,63,43234,32414,234,217
1089,28498,39.5,54126,27853,14044,14454
1092,1080,32.9,55370,34201,561,519
1093,282,52.5,83750,42234,146,136
1094,340,54.1,18241,25777,165,175
1095,14344,48.1,86667,38687,6849,7495
1096,2249,44.8,65365,33128,1059,1190
1097,83,22.7,42031,13883,21,62
1098,1081,52.9,69079,35343,511,570
1103,2556,33,14133,17095,1262,1294
1104,23083,34.7,32273,17307,10971,12112
1105,12360,26.6,18402,12137,6128,6232
1106,16018,45,103472,53449,7442,8576
1107,11271,29.5,21737,12440,5443,5828
1108,25755,31.7,34064,18347,12290,13465
1109,31429,26.4,33376,13938,14866,16563
1118,13722,40.5,62283,29528,6304,7418
1119,13962,35.1,46055,21261,6596,7366
1128,2468,46.8,78864,33573,1345,1123
1129,7505,38,61435,26752,3545,3960
1151,9134,30.6,30043,16169,4366,4768
1199,0,-666666666,-666666666,-666666666,0,0
1201,45887,43.8,42633,26738,21351,24536
1220,8586,43.6,40443,24753,4217,4369
1222,805,45.8,75598,40683,394,411
1223,2346,50.5,54904,37301,1108,1238
1224,322,23.7,90223,22426,166,156
1225,3059,46.6,49788,28804,1424,1635
1226,6981,47,51827,28082,3726,3255
1229,111,39.5,68125,24606,25,86
1230,8200,47.1,51467,35004,4053,4147
1235,3032,45.2,64420,28315,1620,1412
1236,1631,42.8,51964,29869,725,906
1237,2509,41.5,71932,36849,1382,1127
1238,6198,45.3,59477,33848,2976,3222
1240,4818,52.7,51464,37359,2175,2643
1242,155,57.3,55167,31279,84,71
1243,345,55.3,67411,35263,189,156
1244,150,60.3,29125,24298,73,77
1245,726,54,52500,37324,371,355
1247,16025,41.3,41103,22181,7846,8179
1253,742,48.5,67917,36261,359,383
1254,997,54.3,95125,50182,461,536
1255,930,48,55917,29539,480,450
1256,675,44.6,56500,28533,355,320
1257,2183,49.5,50543,33690,1088,1095
1258,304,60.2,56607,41482,126,178
1259,613,51.8,70074,43844,322,291
1260,240,46.1,74615,25668,167,73
1262,1257,49.7,41648,33165,557,700
1264,167,69.6,70625,51626,65,102
1266,1433,54.6,76953,44493,668,765
1267,7985,39.3,72352,33717,3586,4399
1270,806,49.2,68456,32940,407,399
1301,17806,42.9,48319,27354,8630,9176
1330,1540,48.5,72560,35226,721,819
1331,13383,41,50498,23736,6949,6434
1337,2609,49.2,58875,31366,1293,1316
1338,169,52.1,69886,39439,93,76
1339,1597,49.7,50536,29981,783,814
1340,1784,46.5,49886,29025,907,877
1341,1605,47.9,77500,37209,737,868
1342,1506,43.2,99675,46508,696,810
1343,76,57.4,81806,38675,37,39
1344,1526,39,57500,24274,757,769
1346,448,54,65000,33809,225,223
1347,93,38.5,31250,16610,20,73
1349,844,52.1,50714,27191,346,498
1350,117,41.5,36875,23709,55,62
1351,2253,45.5,70799,34353,1106,1147
1354,1532,47.8,74583,34215,745,787
1355,990,42.1,68929,28963,487,503
1360,3033,45.5,60608,32021,1645,1388
1364,7960,40.2,45758,21734,4067,3893
1366,1294,50.2,76094,33059,625,669
1367,590,43.3,47279,26501,300,290
1368,1161,43.7,60750,27999,576,585
1370,4113,47.9,53516,29074,1933,2180
1373,4441,46.4,64127,31811,2017,2424
1375,3692,26.9,47000,28057,1933,1759
1376,5513,41.9,39792,24108,2575,2938
1378,639,55.4,56094,33914,296,343
1379,957,50.3,48188,27732,482,475
1420,40358,34.7,45363,22620,20477,19881
1430,6119,42.4,83532,34454,3154,2965
1431,3114,44.8,82778,33228,1499,1615
1432,7061,43.3,57543,34502,3485,3576
1434,1702,39.6,77396,14154,1501,201
1436,3838,42.4,69076,27831,1534,2304
1438,359,51.9,62422,24617,103,256
1440,20388,40.7,49067,23297,10309,10079
1450,10842,43.6,117127,48248,5583,5259
1451,4964,46.8,136058,60872,2546,2418
1452,4398,44.6,86979,33730,2210,2188
1453,41002,41.2,58896,29382,19927,21075
1460,9038,44.1,105455,47502,4322,4716
1462,10549,44.2,76063,35866,5121,5428
1463,11645,43.1,81193,35689,5810,5835
1464,7435,39,65882,24469,4466,2969
1467,398,42.3,181810,57529,207,191
1468,3710,44,62096,28094,1952,1758
1469,7044,40.4,78985,34037,3458,3586
1473,7320,43.6,83840,34860,3756,3564
1474,1993,44.6,90521,37146,1064,929
1475,10386,44.3,58288,27204,5487,4899
1501,16089,44,73612,34644,7496,8593
1503,2886,45.5,95962,44297,1466,1420
1504,9035,40.6,74294,32488,4323,4712
1505,4366,44.7,97938,53378,2258,2108
1506,3382,43.5,61800,29391,1679,1703
1507,13034,42.2,93963,35678,6649,6385
1510,13634,41.3,64723,31765,6530,7104
1515,2253,42.7,66042,30172,1074,1179
1516,8575,39.8,82831,36503,4610,3965
1518,2689,42.6,61719,33795,1226,1463
1519,6514,39.1,102300,44302,3427,3087
1520,14354,42.3,96780,41173,7141,7213
1521,2442,43.6,67684,32734,1312,1130
1522,3145,41.3,93238,38120,1486,1659
1523,7680,39.2,78283,28387,4395,3285
1524,6940,39.3,68899,29142,3234,3706
1525,145,32.7,44857,33626,87,58
1527,13264,43,71832,32329,6367,6897
1529,3197,38.2,82083,29546,1583,1614
1531,1053,40.9,82569,30961,498,555
1532,14529,41.5,108415,43878,7294,7235
1534,5299,39,85000,36653,2508,2791
1535,4706,42.1,54439,27452,2391,2315
1536,7042,40.3,76063,37846,3459,3583
1537,2458,40,72607,30326,1300,1158
1540,11148,40.3,68986,29658,5452,5696
1541,3424,43.8,120607,42921,1744,1680
1542,1782,45.4,74273,31085,854,928
1543,8075,40.3,86482,33229,4318,3757
1545,35575,39.2,92360,40098,17532,18043
1550,16741,37.5,42471,21579,7933,8808
1560,4531,32.8,81667,35305,2132,2399
1561,174,22.7,19637,15914,95,79
1562,11733,39.1,60197,28983,5757,5976
1564,7839,44.2,98872,40536,3743,4096
1566,6617,43.2,82750,37893,3214,3403
1568,7431,41.2,105208,42387,3565,3866
1569,13559,40.9,86164,35249,6663,6896
1570,16782,41.4,47885,26411,7842,8940
1571,11445,37.2,70590,28240,6002,5443
1581,18371,40.4,100905,45929,8909,9462
1583,7698,38.9,72107,30780,4743,2955
1585,4646,45.7,62667,31262,2326,2320
1588,10350,39.2,62649,29244,4972,5378
1590,8943,41.7,110658,42341,4345,4598
1602,23707,40,62832,31101,11191,12516
1603,19385,36.1,48183,22315,9496,9889
1604,34720,35.9,49797,27119,16674,18046
1605,27279,32.3,37705,21639,12489,14790
1606,19495,39.5,66912,32781,9148,10347
1607,8957,34.4,45152,24044,4376,4581
1608,3558,27.2,19418,11315,1563,1995
1609,21178,26.9,40660,23846,10101,11077
1610,23964,25.6,30532,14040,11734,12230
1611,2481,39.3,67179,33179,1274,1207
1612,4856,41.3,106708,35979,2536,2320
1701,31435,43.6,86994,39361,14932,16503
1702,38020,33.5,53944,29023,17779,20241
1718,343,38.9,132981,62059,160,183
1719,5048,43.7,101502,61461,2447,2601
1720,21804,41.9,109578,53152,11033,10771
1721,16792,44,93233,45834,7953,8839
1730,13649,43.9,108818,48886,6716,6933
1731,1717,17.7,75446,22388,854,863
1740,4967,43.1,146029,55369,2429,2538
1741,4918,48.2,160034,77585,2287,2631
1742,18586,45.9,135217,68920,9769,8817
1745,305,50.2,57250,40472,163,142
1746,13811,42.4,110323,46206,6839,6972
1747,5928,41.5,89408,38747,3086,2842
1748,15271,39.5,129578,56899,7549,7722
1749,19263,42.8,71971,35713,9489,9774
1752,38842,39.5,70304,35335,19363,19479
1754,10211,41.7,77622,39447,5029,5182
1756,5851,43,105389,41740,2911,2940
1757,28252,38.2,66547,32180,13942,14310
1760,33353,41.6,95328,50239,16513,16840
1770,4169,45.5,153444,73420,2089,2080
1772,9502,42.1,150129,63375,4582,4920
1773,4836,48.5,149539,75535,2322,2514
1775,6737,42.2,115714,47880,3257,3480
1776,17922,42.9,170924,72744,8923,8999
1778,13280,46.7,130022,68811,6363,6917
1801,38961,39.7,75138,35354,19100,19861
1803,24700,41.8,94272,41119,12193,12507
1810,33746,42.7,112681,52275,15866,17880
1821,30591,40.4,87996,35975,15017,15574
1824,24673,43.4,104538,44267,12005,12668
1826,29968,40.3,78169,32690,15091,14877
1827,3255,44.2,119022,48133,1541,1714
1830,25687,39,55255,29567,12761,12926
1832,22121,38.5,57833,29014,10531,11590
1833,8295,42.4,107775,43297,4087,4208
1834,6675,46.1,97463,40222,3373,3302
1835,13527,37.1,72228,31429,6317,7210
1840,4547,36.8,18261,14758,2144,2403
1841,47676,29.6,31214,15117,22854,24822
1843,24597,32.6,42891,21024,11655,12942
1844,47690,39.9,67556,30520,23305,24385
1845,28677,41,96002,46788,14346,14331
1850,15496,32,51538,22503,7401,8095
1851,29791,33.5,51630,22714,14535,15256
1852,33106,35.6,48951,26878,16622,16484
1854,29073,29.6,42947,19646,13876,15197
1860,6440,43.5,79423,36605,3107,3333
1862,10992,39,85497,30074,5497,5495
1863,9526,40.5,81160,37573,4641,4885
1864,15076,42.4,110852,45031,7498,7578
1867,24524,41.8,105524,47036,11785,12739
1876,28778,43.4,90897,39980,13818,14960
1879,11675,42.1,90987,40920,5835,5840
1880,25116,42.1,84556,40379,12296,12820
1886,22458,42.4,124464,49341,11088,11370
1887,22656,41.7,99508,37424,11153,11503
1890,21621,42.5,131000,64385,10113,11508
1901,2023,42.8,23467,20625,726,1297
1902,44827,32,37275,20391,21661,23166
1904,18803,40.6,80903,33409,9268,9535
1905,25090,32.4,42490,19934,12009,13081
1906,27051,44.9,76339,34350,12379,14672
1907,14086,44,92399,48336,6518,7568
1908,3432,49.7,66964,45464,1522,1910
1913,16429,41.3,78486,38659,8088,8341
1915,40026,39.8,70563,37554,18813,21213
1921,8040,45.6,125833,58734,3967,4073
1922,3025,44.4,109301,40983,1453,1572
1923,26810,43,79478,38281,13028,13782
1929,3546,45.4,74211,42259,1638,1908
1930,29043,47.1,61449,35928,13692,15351
1937,89,72.1,-666666666,29602,73,16
1938,13354,48.1,77087,43021,6699,6655
1940,12299,44.4,106239,46227,6088,6211
1944,5185,48.3,115650,70075,2621,2564
1945,19958,44.7,98399,58082,9429,10529
1949,9131,41.1,104245,39115,5639,3492
1950,17569,46.3,78638,46124,8129,9440
1951,3707,49.2,81106,42632,1890,1817
1952,8396,46.2,72131,35656,4128,4268
1960,51319,44.3,64430,34255,24352,26967
1966,7040,52.1,66402,41762,3250,3790
1969,5914,45.1,83237,38324,2783,3131
1970,41747,36.9,55698,31407,19372,22375
1982,7995,40,105865,44500,4017,3978
1983,6211,45.4,111696,56488,2968,3243
1984,4964,24.9,127606,46255,2269,2695
1985,4305,43,111652,53144,2312,1993
2019,16438,40.8,80179,36165,7874,8564
2021,21781,42.8,89900,46086,10414,11367
2025,7935,42,117829,61267,3959,3976
2026,24906,43,84704,43063,12256,12650
2030,5677,44.3,187829,89476,2989,2688
2032,3884,42.9,77955,39531,1999,1885
2035,16990,41.2,91601,42801,8238,8752
2038,32064,37.8,99194,41946,15854,16210
2043,22330,43.8,106854,60770,10730,11600
2045,10319,49,75551,41064,4841,5478
2047,111,89.3,-666666666,14649,56,55
2048,23293,37.4,93539,42207,11636,11657
2050,25647,43.5,91764,43165,12368,13279
2052,12136,43.4,133931,62076,6102,6034
2053,12866,42.1,106132,43335,6159,6707
2054,7950,41.5,91341,39651,3972,3978
2056,11274,42.5,134104,43630,6792,4482
2061,10560,44.3,113944,48205,5361,5199
2062,28698,41.2,75957,37213,14078,14620
2066,17730,45.4,100833,49657,8607,9123
2067,17591,43.2,125313,53259,8189,9402
2071,1770,40.3,97813,25115,1276,494
2072,27522,43.1,74262,33094,13197,14325
2081,19006,42.9,93416,44982,8686,10320
2090,14714,45,128984,62949,7250,7464
2093,11058,44.2,100574,45019,5739,5319
2108,4062,34.6,96921,83723,1986,2076
2109,4241,33.9,119196,90256,2102,2139
2110,1752,50.9,111250,136352,1026,726
2111,7771,34.3,43551,51511,4040,3731
2113,6843,28.6,66636,54464,3141,3702
2114,11994,31.2,80500,67701,5882,6112
2115,28928,21.8,27134,22112,14455,14473
2116,21793,33,87653,80314,10340,11453
2118,27873,33.6,54152,45343,15414,12459
2119,24767,33.3,27180,19183,11478,13289
2120,14221,23.4,35077,17704,6796,7425
2121,27093,30.2,28238,17224,12338,14755
2122,24546,32.9,50192,23904,11801,12745
2124,51382,34.6,48841,22891,24217,27165
2125,34172,30.2,45130,23350,17163,17009
2126,27984,37.7,45238,20804,12387,15597
2127,33825,30.8,68724,44737,15313,18512
2128,43575,34,48704,23468,23462,20113
2129,17454,34.6,86346,57847,8078,9376
2130,37541,33.6,75730,44110,17312,20229
2131,30960,38,66735,30984,14631,16329
2132,27628,42.9,83360,44546,13392,14236
2134,19009,26.8,37820,24946,9246,9763
2135,36932,29.2,48687,31475,16138,20794
2136,29271,36.2,58890,27408,14031,15240
2138,35554,29,75446,52592,16851,18703
2139,36015,30.3,71745,42235,17985,18030
2140,18164,35.3,71908,50856,8260,9904
2141,13126,31.7,64326,39241,6366,6760
2142,2838,29.3,100114,67525,1593,1245
2143,26056,31.9,68440,36705,12773,13283
2144,23854,30.7,78380,40831,11143,12711
2145,24659,33,55487,29355,12730,11929
2148,59819,35.7,53798,26648,28701,31118
2149,42076,35.7,49368,23401,20923,21153
2150,36222,31,47291,20617,18542,17680
2151,52534,37.9,51863,26092,26653,25881
2152,17763,43.4,64548,37720,8673,9090
2155,58832,35,73567,34309,28054,30778
2163,2100,25.7,43989,22511,950,1150
2169,55064,38.1,58669,32613,26583,28481
2170,19796,39.3,66917,31165,9355,10441
2171,17735,39.2,64812,36933,8692,9043
2176,27239,41.3,85704,42361,13114,14125
2180,21498,44.6,76127,38561,10226,11272
2184,36051,40.7,81844,36351,17155,18896
2186,27094,38.5,111071,46166,12934,14160
2188,14655,41.8,68366,35954,6803,7852
2189,14609,42.5,60059,31185,7043,7566
2190,16733,41.2,77329,37124,7980,8753
2191,8369,46,65365,34652,3912,4457
2199,1273,46.8,109716,141896,554,719
2203,0,-666666666,-666666666,-666666666,0,0
2210,1894,37,110333,94308,1022,872
2215,24213,21.6,35659,20651,10633,13580
2301,58982,35.5,44144,21477,28086,30896
2302,34929,35.7,61060,22728,17073,17856
2322,4400,45.3,73194,33005,2074,2326
2324,26573,36.2,87015,32991,13886,12687
2330,11493,43.3,72161,30918,5482,6011
2332,15126,45.5,118272,54596,7072,8054
2333,13894,42.9,85912,35360,6474,7420
2338,7546,44.4,67760,33177,3766,3780
2339,14027,40.7,99250,41219,6988,7039
2341,10250,41.3,92560,33337,5129,5121
2343,10667,44.9,62292,33682,5386,5281
2346,23247,41.2,77607,31719,11524,11723
2347,10798,43,87900,35711,5018,5780
2351,16009,38.7,78395,34567,7450,8559
2356,12625,38.8,100429,40982,6137,6488
2357,959,19.9,-666666666,5055,442,517
2359,17916,40.4,86887,36916,8606,9310
2360,56816,42.7,76565,35456,28203,28613
2364,12673,42.8,82661,37330,6039,6634
2366,149,35,-666666666,2396,149,0
2367,2834,44.9,93563,38629,1316,1518
2368,32952,40.6,62152,28092,15204,17748
2370,17546,40.3,66329,30051,8564,8982
2375,9833,40.3,86689,38628,4676,5157
2379,6928,42.4,80347,32725,3391,3537
2382,14567,39.1,72462,32541,7112,7455
2420,14073,46.8,147924,69777,6733,7340
2421,17813,44.8,136250,70103,8697,9116
2445,20844,35.5,102087,68108,9023,11821
2446,28924,33.5,78814,60512,12146,16778
2451,17299,39.5,81334,45644,8480,8819
2452,15025,30.2,78349,31988,7064,7961
2453,28997,32.1,67382,34152,14118,14879
2457,1343,20.4,-666666666,5860,637,706
2458,11602,40.6,95216,59071,5387,6215
2459,18339,43.3,133801,71128,8649,9690
2460,9046,41.2,102276,61686,4397,4649
2461,6808,43.4,122283,61088,3280,3528
2462,1412,53.4,83438,74279,591,821
2464,2947,39.3,81771,51744,1291,1656
2465,11673,43.1,139763,75857,5410,6263
2466,9105,34.7,105893,47551,4369,4736
2467,23092,23.4,115493,55288,10355,12737
2468,5267,50.4,201731,86528,2660,2607
2472,32622,38.4,87775,44700,15746,16876
2474,26646,40.2,87225,48199,12807,13839
2476,16662,43.7,95305,51709,8191,8471
2478,24864,40.4,110633,56884,11714,13150
2481,16215,37.1,180607,83035,7025,9190
2482,10946,41.4,135089,63889,4860,6086
2492,20131,42.9,137839,66190,9945,10186
2493,11538,44.2,192563,105217,5507,6031
2494,9109,43.4,104543,56326,4320,4789
2532,11455,44.3,59250,33808,5702,5753
2534,1247,53.3,96053,36703,699,548
2535,1283,45.1,67500,42716,605,678
2536,19470,48.3,61063,33741,9594,9876
2537,6288,42.6,79180,32964,2930,3358
2538,3245,35.6,48402,24790,1676,1569
2539,4135,49.5,66711,38588,2291,1844
2540,8554,56.5,59858,49489,3996,4558
2542,1155,22.9,45107,16979,613,542
2543,736,49.7,66250,50348,282,454
2553,210,29.3,53125,33253,73,137
2554,9843,39.9,85835,47658,4939,4904
2556,2852,59.2,77661,46442,1221,1631
2557,4563,44.7,69844,30190,2254,2309
2558,1489,49,49121,31100,570,919
2559,4056,53.6,59489,36281,1962,2094
2561,468,52.6,73750,32293,316,152
2562,3371,45.9,62778,33670,1557,1814
2563,9616,47.5,79578,38405,4559,5057
2564,381,41.5,59412,38888,208,173
2568,3995,41.4,48935,30955,2023,1972
2571,10497,46.7,56250,30679,5191,5306
2575,2628,44.4,70963,30136,1066,1562
2576,4888,41.8,79760,30900,2370,2518
2584,0,-666666666,-666666666,-666666666,0,0
2601,13552,42.3,39454,24219,6545,7007
2630,2113,56.4,61250,36804,1169,944
2631,9610,52.1,61397,35158,4543,5067
2632,11543,50.1,67422,33787,5320,6223
2633,3868,56.3,66516,46448,1909,1959
2635,3355,50.5,78583,43999,1623,1732
2637,84,47.6,-666666666,26569,51,33
2638,3355,59.3,58750,37471,1661,1694
2639,3138,45.8,46510,27757,1394,1744
2641,355,66.5,128576,55869,189,166
2642,4919,56.7,58056,36116,2352,2567
2643,17,-666666666,-666666666,,0,17
2644,4469,34.9,90540,28462,2161,2308
2645,9487,48.8,62835,30999,4239,5248
2646,1946,60.5,66771,43275,876,1070
2647,129,66.1,146705,58517,48,81
2648,6898,48.1,68260,41204,3454,3444
2649,14000,49.1,63657,34717,6487,7513
2650,1222,60.9,66932,48467,565,657
2651,26,-666666666,-666666666,,13,13
2652,1133,52.9,52639,37742,624,509
2653,5982,62.2,59938,42209,2683,3299
2655,3943,54.9,72546,56395,1731,2212
2657,2964,53.3,41140,45204,1640,1324
2659,837,59.4,51033,34619,366,471
2660,6018,52.2,49024,30437,2767,3251
2663,121,34.9,21912,24332,78,43
2664,9487,53.2,47873,31253,4340,5147
2666,598,61.5,61477,42750,292,306
2667,2891,61.6,51908,39902,1263,1628
2668,2755,47.5,80296,42993,1469,1286
2669,211,66,100109,41827,108,103
2670,1302,61.3,49871,38015,612,690
2671,844,57.8,45769,52292,366,478
2672,150,57.3,205324,46733,103,47
2673,8407,47,55204,32671,4084,4323
2675,6254,60.3,61365,41238,2953,3301
2702,4567,39.9,89833,31246,2306,2261
2703,43677,39.4,67039,30978,21521,22156
2713,114,60.8,38333,26096,45,69
2715,3195,39.4,86823,31251,1543,1652
2717,4356,42.8,81150,32987,2260,2096
2718,6774,40.5,80211,29144,3572,3202
2719,15952,45.9,60326,30381,7299,8653
2720,30811,40.2,41910,25090,14358,16453
2721,26141,36.3,30180,19321,12532,13609
2723,14298,37.3,28120,18980,6540,7758
2724,16769,40.4,27390,18827,7882,8887
2725,2717,50.3,67396,27714,1294,1423
2726,15524,43.6,74141,32263,7604,7920
2738,4915,48.4,80456,45269,2428,2487
2739,6086,44.8,78864,35941,2965,3121
2740,43308,37.4,34259,20649,20163,23145
2743,10321,42.7,66276,31463,5337,4984
2744,11722,36.6,31216,18190,5556,6166
2745,24830,39.7,47536,26093,11526,13304
2746,14835,32,25623,15948,6852,7983
2747,22092,36.8,71073,25441,11744,10348
2748,12591,47.7,64077,37929,6160,6431
2760,27081,38.2,78087,34793,13503,13578
2762,8429,40.2,77109,39346,4189,4240
2763,1638,40.7,125769,39837,861,777
2764,3926,43.2,79615,37724,1989,1937
2766,19209,39.5,81069,32414,9255,9954
2767,13450,40.9,80761,34853,6607,6843
2769,11664,43.3,82500,36959,6033,5631
2770,5275,44.5,88636,37301,2563,2712
2771,13932,43.6,70966,34580,6737,7195
2777,15943,45.3,71179,33070,7559,8384
2779,6452,40.1,90741,33189,3255,3197
2780,49151,40.7,49732,26055,23657,25494
2790,16154,46.2,78750,35011,7784,8370
2791,80,65.2,71042,58534,50,30
2802,919,37.2,48456,42134,534,385
2804,2587,47.1,71772,33192,1484,1103
2806,16298,44.8,103696,54414,7632,8666
2807,836,54.8,90491,52486,418,418
2808,2202,36,73382,30863,1169,1033
2809,22531,42.3,62358,31526,10871,11660
2812,1969,36.9,110233,35637,959,1010
2813,7821,44.9,69349,34602,3818,4003
2814,7477,44.5,82127,32640,3654,3823
2815,200,40.2,125000,47267,114,86
2816,32800,43,64581,29936,15862,16938
2817,6102,41.3,78438,36160,3074,3028
2818,18241,45.3,85429,54361,8579,9662
2822,6460,44.2,82189,36185,3332,3128
2825,5305,47.4,81923,36152,2741,2564
2826,637,48.3,33203,20529,251,386
2827,2067,47.7,93750,35893,1008,1059
2828,7403,48.2,75408,38147,3269,4134
2830,6356,43.7,66658,34376,3225,3131
2831,3129,44.5,82207,33365,1678,1451
2832,5263,43.9,57318,29245,2474,2789
2833,513,59.7,64554,44846,249,264
2835,5423,49.8,90484,54915,2669,2754
2836,103,30.8,68500,35931,46,57
2837,3490,51.4,85852,49693,1619,1871
2838,3615,37.9,47323,25803,1746,1869
2839,1617,42.1,73750,31063,726,891
2840,23306,38.7,60751,38498,10882,12424
2841,1066,26.1,-666666666,34581,915,151
2842,16116,41.8,69495,34094,7802,8314
2852,22567,42.8,77049,39199,10956,11611
2857,8919,45.6,76775,36536,4312,4607
2858,605,46.6,92500,56813,286,319
2859,6932,43.4,58828,28461,3385,3547
2860,43862,34.9,32614,19486,20790,23072
2861,27431,39.9,54184,25198,13727,13704
2863,19387,29.4,27993,14074,9860,9527
2864,33429,42.8,72416,35306,16383,17046
2865,16881,43,78429,40867,8149,8732
2871,17155,46,74494,44918,8619,8536
2872,184,52.9,-666666666,35756,85,99
2873,181,38.4,72273,45086,124,57
2874,6077,39,109375,44544,2977,3100
2875,428,47,80438,40517,245,183
2876,237,61.1,58438,41172,101,136
2878,15805,46.9,73085,37587,7669,8136
2879,20675,46.3,75692,42125,9714,10961
2881,7681,19.8,80844,17818,3498,4183
2882,13966,42.2,64852,41702,7065,6901
2885,10597,42.4,54295,30687,5133,5464
2886,28758,46,61682,35112,13544,15214
2888,19551,43.6,57659,31704,9363,10188
2889,28571,42,64006,30696,13869,14702
2891,21248,44.8,60394,34266,9897,11351
2892,4256,48.4,66033,40897,2045,2211
2893,29416,38.9,51397,27891,14536,14880
2894,563,43.1,83417,36384,203,360
2895,41113,36.5,36058,21088,19814,21299
2896,11782,48,77658,36485,5438,6344
2898,1231,47.6,92708,33828,644,587
2903,10613,27.3,26173,26146,5291,5322
2904,28793,40.2,41649,25191,13637,15156
2905,25285,30.3,41332,21109,12469,12816
2906,28920,29.9,65531,45404,14041,14879
2907,27448,29.5,28819,13987,13058,14390
2908,36842,29,42640,20203,17159,19683
2909,43752,29,32036,15386,21910,21842
2910,20135,39,55893,27052,9648,10487
2911,15811,40.8,51288,27389,7358,8453
2912,1850,19.9,-666666666,4599,966,884
2914,21978,39.8,40642,22148,10106,11872
2915,16381,45.7,51928,30710,7379,9002
2916,8700,42.9,63480,35834,4233,4467
2917,14051,34.6,72983,29501,6721,7330
2919,28910,44.6,56377,30008,13567,15343
2920,38679,42.8,53675,25788,19942,18737
2921,12207,41.3,98458,40551,5739,6468
3031,11283,44.4,110809,48600,5660,5623
3032,5027,41.9,98125,38501,2416,2611
3033,5023,41.9,105255,39540,2598,2425
3034,3961,45,93359,36573,2026,1935
3036,4789,43,105104,39816,2255,2534
3037,4248,42.4,89186,36186,2188,2060
3038,33417,39.2,64642,30354,16463,16954
3042,6460,40.9,74609,32453,3271,3189
3043,1547,47.5,83393,37480,757,790
3044,4290,43.1,82375,36421,2096,2194
3045,13742,42.6,69387,33628,6733,7009
3046,2774,43.2,99464,42354,1350,1424
3047,1496,43.7,68750,31066,775,721
3048,3513,43.6,62321,28864,1852,1661
3049,7700,46.4,113125,51368,4009,3691
3051,24541,40.7,88600,36109,12223,12318
3052,8299,38.4,103182,35674,4129,4170
3053,24013,39.9,92053,38683,12074,11939
3054,25538,42.8,88555,38711,12516,13022
3055,15067,40,64162,31909,7637,7430
3057,2534,43.7,92396,37197,1266,1268
3060,28959,35.3,44646,24748,13971,14988
3062,27338,41.5,82826,37959,13762,13576
3063,15936,36.6,78191,37852,7560,8376
3064,14533,40.6,64026,34045,7145,7388
3070,5291,40.8,99474,43563,2675,2616
3071,5112,37.5,81088,33886,2804,2308
3076,12960,40.7,91301,37663,6334,6626
3077,10218,39.5,61488,27774,4851,5367
3079,28820,42.8,76497,36598,14735,14085
3082,1515,44.3,82361,35671,705,810
3084,1605,44.5,55000,26644,711,894
3086,3812,43.7,74750,37125,1922,1890
3087,13777,41.9,113170,48701,6870,6907
3101,2940,36,27143,34163,1600,1340
3102,31806,34.3,50049,25866,15820,15986
3103,36432,35.2,49518,23041,18209,18223
3104,33145,37.6,60468,32130,16458,16687
3106,13470,40.3,81640,34478,6248,7222
3109,9711,40.8,79229,34852,4862,4849
3110,21339,42.7,122517,53755,10437,10902
3215,240,56.3,73472,42163,132,108
3216,2138,47.1,71466,30157,1052,1086
3217,1796,39.5,39390,22083,767,1029
3218,893,37.7,102917,31388,481,412
3220,7337,40.1,61174,24796,3447,3890
3221,2014,46.5,62872,31153,965,1049
3222,5684,45.3,50453,26465,2675,3009
3223,3384,44.3,50968,34424,1688,1696
3224,2290,48,86838,39908,1064,1226
3225,3700,41.8,62201,30081,1789,1911
3226,994,51.3,69861,38513,440,554
3227,1039,48.6,54444,28846,532,507
3229,5594,45.4,81250,41471,2816,2778
3230,1371,42.5,51094,23883,692,679
3231,313,55,68553,32447,125,188
3233,96,52.7,105341,25359,55,41
3234,4596,45.8,73723,33447,2338,2258
3235,8596,40.5,41828,21290,4212,4384
3237,2155,50.6,67969,32932,1082,1073
3238,89,28.9,49125,17911,43,46
3240,1318,46.6,46490,24265,682,636
3241,838,49.4,55833,26510,453,385
3242,4815,29.3,64913,26622,2339,2476
3243,1200,46.8,56667,25116,607,593
3244,7988,39.1,55683,27653,3767,4221
3245,1674,52,62679,40889,815,859
3246,16001,45.4,47757,28373,7546,8455
3249,7136,49.4,63527,37616,3670,3466
3251,1264,45.4,34792,21380,722,542
3253,6284,47,57067,36587,3070,3214
3254,4065,54.6,72110,55428,2108,1957
3255,1968,48.1,70455,34021,987,981
3256,2288,42.9,72872,26736,1052,1236
3257,4584,51.3,72159,35753,1987,2597
3258,2519,43.7,75326,33497,1374,1145
3259,303,55.8,59167,37583,174,129
3260,805,47.4,73229,32554,407,398
3261,4253,44.2,68398,35153,2295,1958
3262,1111,45,49583,29282,589,522
3263,4101,39.6,61326,24752,2080,2021
3264,7469,23.7,42599,20284,3754,3715
3266,2234,47.2,47130,29324,1144,1090
3268,1295,45.6,67100,28928,645,650
3269,2966,48.3,65000,32494,1410,1556
3273,279,54.8,63333,31386,143,136
3275,11447,38.6,60470,29040,5870,5577
3276,8394,41.9,58449,25690,4354,4040
3278,2991,44.7,70385,33808,1555,1436
3279,650,47.3,39261,23784,328,322
3280,1074,51.4,54500,29190,558,516
3281,8828,37.3,86674,33744,4386,4442
3282,900,49.3,44837,22299,471,429
3284,1140,39.3,70938,28451,626,514
3285,2473,46.3,59191,29732,1331,1142
3287,1286,46.2,75833,35054,614,672
3290,4747,41.4,81653,36454,2375,2372
3291,34,20.9,-666666666,28909,17,17
3293,87,53.7,65833,27762,40,47
3301,32665,40.5,51848,30840,16164,16501
3303,15665,40.7,56983,27860,7500,8165
3304,7573,45.3,104905,43243,3885,3688
3307,5321,43.2,69679,30136,2724,2597
3431,25563,35.8,51744,27090,11846,13717
3440,2639,44.2,64224,27225,1256,1383
3441,584,31.8,62188,28283,352,232
3442,1497,36.7,58750,27563,747,750
3443,918,43.2,67266,24708,421,497
3444,1674,47.6,64911,33640,814,860
3445,697,39.5,61875,28796,374,323
3446,6131,44.8,54213,28549,3123,3008
3447,2567,47.3,49783,31175,1273,1294
3448,662,50.8,45417,26556,347,315
3449,1791,49.9,78702,41737,881,910
3450,860,52.4,53947,35812,432,428
3451,4018,45.7,45406,23350,1959,2059
3452,5440,44.4,64500,28664,2527,2913
3455,1922,46.1,62540,30575,881,1041
3456,782,43,67841,28506,432,350
3457,695,52.1,66500,41751,322,373
3458,6678,49.3,66406,40329,3030,3648
3461,5950,26.3,61875,25058,2999,2951
3462,1840,42.5,86089,39435,965,875
3464,1053,45.4,65833,29149,501,552
3465,2313,36.9,49180,25887,1217,1096
3466,888,49.1,81827,37348,385,503
3467,1923,47.2,75234,31780,929,994
3470,4660,44.9,44091,22725,2369,2291
3561,5941,46.1,49214,28402,2862,3079
3570,9836,45.1,37856,21936,5279,4557
3574,2529,44.4,49455,27626,1217,1312
3575,106,50.5,14821,11202,45,61
3576,3277,50.1,42100,23551,1602,1675
3579,419,54.5,31625,25774,221,198
3580,1515,51.7,69688,36693,702,813
3581,3179,45.2,47861,28045,1557,1622
3582,2542,44,36722,19118,1318,1224
3583,864,49.8,50000,28028,420,444
3584,3657,46.9,39219,27336,1650,2007
3585,2593,46.3,48162,27003,1311,1282
3586,574,54.5,78370,41089,282,292
3588,1642,49.8,54950,29392,834,808
3590,977,46.7,28393,20288,531,446
3592,1300,56.3,35478,26630,667,633
3593,459,56.9,70694,38066,256,203
3595,838,40.1,54375,27547,437,401
3597,375,48.9,29167,16864,158,217
3598,3119,47.2,46309,24787,1646,1473
3601,553,40.9,53750,20916,292,261
3602,2759,42.8,64145,28415,1380,1379
3603,5324,47.2,45239,23362,2514,2810
3604,237,27,34231,34096,110,127
3605,1189,43,58942,26808,593,596
3607,293,52.4,41667,25210,152,141
3608,2304,45.2,52976,28421,1206,1098
3609,1179,36.1,54306,26992,588,591
3740,747,51.5,48409,24924,424,323
3741,4261,46,62642,28771,2249,2012
3743,13956,41.1,42613,22749,6851,7105
3745,1462,49.3,71875,32495,749,713
3746,152,46.5,74167,40038,64,88
3748,4580,45.9,79974,45180,2197,2383
3750,1099,41.4,111758,55427,575,524
3751,408,58.5,96250,46160,171,237
3752,728,49.9,51563,28060,334,394
3753,2966,45,96638,40964,1464,1502
3754,0,-666666666,-666666666,-666666666,0,0
3755,10311,22.7,91610,31861,4883,5428
3765,698,32.7,51250,23711,300,398
3766,9591,39.9,53112,33006,4404,5187
3768,1937,44.8,107692,60813,971,966
3770,528,33.8,91250,33356,240,288
3771,1016,49.1,58173,26411,435,581
3773,7750,45.7,53955,26841,3707,4043
3774,1735,46.1,49335,26309,935,800
3777,1454,39.8,73984,33157,706,748
3779,817,48,75833,35980,452,365
3780,343,51.3,55208,30147,199,144
3781,2002,45.1,105272,43530,1037,965
3782,3071,50.5,73971,41690,1631,1440
3784,3724,37.5,50643,33704,1968,1756
3785,2569,44.1,39033,21085,1333,1236
3801,22005,41.4,65355,39829,10896,11109
3809,3749,42.3,63202,30418,2003,1746
3810,1510,47,63462,31333,763,747
3811,6775,46.9,95536,42505,3052,3723
3812,616,58.1,35278,21317,285,331
3813,3693,43.5,51712,23245,1970,1723
3814,2471,45.3,46000,22378,1251,1220
3816,1420,48.4,60670,27599,663,757
3817,656,49.4,41336,47619,387,269
3818,3628,46.4,42033,25714,1879,1749
3819,4410,41.5,85208,31443,2301,2109
3820,30228,36.1,57401,30850,14839,15389
3823,2034,37.6,89444,37211,1102,932
3824,14949,20.8,71250,23342,6595,8354
3825,8552,41.5,81536,34571,4169,4383
3826,2670,46.1,86652,37839,1250,1420
3827,3221,45.9,89333,39869,1509,1712
3830,1708,55,40643,22151,784,924
3832,366,59.6,60000,41152,193,173
3833,21083,44,81413,38995,10035,11048
3835,6797,41.7,51382,28657,3590,3207
3836,1200,55.4,48036,27843,562,638
3837,1616,39,61150,23101,847,769
3838,981,46.9,54926,41056,513,468
3839,3796,36.5,55938,27082,1832,1964
3840,3815,43.7,83288,54229,1916,1899
3841,6110,47.6,93566,40868,3159,2951
3842,14788,48.6,67251,42125,7029,7759
3844,2321,44.9,114000,59683,1210,1111
3845,1248,41.9,49676,25644,634,614
3846,1029,51.1,73182,38903,505,524
3847,272,52.2,80524,41742,125,147
3848,6057,42.9,65579,37266,2811,3246
3849,1306,45.6,53523,31256,618,688
3850,230,60,69519,37250,110,120
3851,3946,44.1,61947,36320,2110,1836
3852,639,33.7,39583,16047,277,362
3853,732,41.1,64583,43081,362,370
3854,930,56.1,103269,82879,458,472
3855,2644,45,78472,34092,1429,1215
3856,1634,42.4,113125,50700,823,811
3857,8968,35.9,57625,32211,4478,4490
3858,4665,39.1,78819,34035,2133,2532
3860,3964,42.8,42967,25309,1970,1994
3861,4346,41.6,93527,40517,2063,2283
3862,4328,50.7,78596,61736,1979,2349
3864,1495,40.1,47700,19371,739,756
3865,7614,42.7,75224,31204,3651,3963
3867,19901,42.5,46704,28347,9422,10479
3868,6185,42.7,53598,25481,3034,3151
3869,2505,39.9,62798,31867,1256,1249
3870,5301,51.3,95000,52887,2604,2697
3871,17,-666666666,-666666666,,8,9
3872,3545,50.1,48900,29297,1687,1858
3873,5829,37.3,79623,36794,2929,2900
3874,9037,47.3,54167,30229,4778,4259
3875,1168,52,56744,34636,587,581
3878,11804,34.2,53241,24132,5769,6035
3882,1377,47.9,45156,22011,749,628
3883,61,49.7,128281,46248,32,29
3884,3998,45.2,93629,35366,2070,1928
3885,7086,44.5,108713,54916,3695,3391
3886,2059,51.5,39643,29754,1052,1007
3887,1988,42.1,48214,25218,1021,967
3890,350,47.7,16278,16887,152,198
3894,6252,54.8,65903,39365,2958,3294
3901,7341,37.2,63264,25309,3443,3898
3902,2049,53.4,76625,38803,1015,1034
3903,6234,44.6,78156,36223,3175,3059
3904,8285,45.1,63378,34349,3800,4485
3905,1254,55.2,54559,31531,532,722
3906,4596,40.1,68776,27518,2140,2456
3907,1143,58.8,57457,45585,583,560
3908,7247,39.2,79172,32027,3440,3807
3909,10094,48.7,67016,40753,4922,5172
3910,357,42.2,48667,18137,225,132
3911,117,53.1,9338,51424,68,49
4001,2470,46.7,57222,26397,1283,1187
4002,7390,46,61662,26846,3949,3441
4003,527,57.7,46467,25631,227,300
4005,23336,36,46125,25135,11209,12127
4006,63,52.7,68036,33186,24,39
4008,2761,40.5,70042,30561,1356,1405
4009,5227,46.6,41607,22880,2587,2640
4010,1336,47.6,45592,25609,710,626
4011,20319,43.3,54758,29789,9578,10741
4015,3809,44.9,46888,24756,1703,2106
4017,401,61.1,60179,44434,178,223
4019,0,-666666666,-666666666,-666666666,0,0
4020,1488,41.8,43864,20276,703,785
4021,5982,41.9,91622,50432,2756,3226
4022,1049,43.6,47500,22904,546,503
4024,594,44.8,61250,22640,298,296
4027,6049,39.4,56731,24082,2938,3111
4029,1559,51.6,46349,26238,756,803
4030,2306,42.4,46806,20601,1306,1000
4032,7971,44,67382,36275,3618,4353
4037,3843,43.7,43110,20649,1763,2080
4038,16540,38.1,75833,32516,8071,8469
4039,7417,37.7,66693,30662,4024,3393
4040,3068,50.1,53819,28859,1464,1604
4041,1694,43,48011,20304,870,824
4042,4316,44,67719,26107,2134,2182
4043,10912,49.4,75357,38671,5164,5748
4046,7575,45.9,68042,37590,3791,3784
4047,1616,48,42292,24213,779,837
4048,2959,31.6,59038,21582,1486,1473
4049,3654,42.1,57567,24049,1841,1813
4050,238,55.6,46250,27511,128,110
4051,1088,51.7,61964,27797,544,544
4055,3786,44.5,57831,26228,2103,1683
4056,195,46.9,33250,14716,90,105
4057,23,19.8,-666666666,5278,23,0
4061,3465,35.7,72548,25291,1755,1710
4062,17164,38.2,62984,29618,8750,8414
4063,340,62.1,40563,30552,166,174
4064,8319,48.1,46089,29407,4011,4308
4066,377,66.7,88125,49893,162,215
4068,1694,37.2,46250,19462,809,885
4069,1471,42.9,62000,27212,675,796
4071,4989,44.9,64797,34545,2615,2374
4072,18647,42.3,55524,28896,8820,9827
4073,16085,40,44639,23658,7454,8631
4074,18963,44.7,77034,39855,9209,9754
4076,2680,46,56969,23644,1334,1346
4079,3874,54.3,71615,39020,1794,2080
4083,4751,39.9,47933,22979,2216,2535
4084,7953,40.5,63657,27121,4133,3820
4085,1948,44.9,60938,27679,855,1093
4086,8750,45.3,61607,31939,4114,4636
4087,1934,36.4,62763,22604,1095,839
4088,1705,45.9,42904,21040,752,953
4090,9697,50.9,60460,31596,4903,4794
4091,996,42.7,54792,24901,473,523
4092,17578,39.2,44465,26520,8327,9251
4093,8056,43,58519,27738,3981,4075
4095,1200,47.1,39345,22205,590,610
4096,8402,45.1,74310,46186,4040,4362
4097,3598,41.1,77813,37144,1602,1996
4101,17339,32.2,31334,24560,8576,8763
4102,17540,35.6,46376,30130,8696,8844
4103,30354,41,54239,30544,14558,15796
4105,11260,47.3,95567,47439,5669,5591
4106,25257,40.1,52858,30061,11613,13644
4107,8993,48.4,98629,53526,4322,4671
4108,900,53.5,44091,34119,418,482
4109,94,33.5,71250,28385,59,35
4110,1297,48.5,110288,79959,631,666
4210,23040,40.5,45449,27064,11492,11548
4216,439,55.5,35341,17460,222,217
4217,2928,44.4,48828,26664,1473,1455
4219,1509,44.7,39608,20693,769,740
4220,3101,40.2,43594,22762,1609,1492
4221,1019,44.4,42895,20324,543,476
4222,3867,43.6,66681,31446,1911,1956
4224,3148,43.8,44575,20274,1549,1599
4226,154,50.8,35313,22859,53,101
4227,39,60.3,61250,25533,19,20
4228,75,41.6,-666666666,5812,50,25
4231,263,49.7,46750,27704,130,133
4234,229,10.9,14459,5396,79,150
4236,4346,42,67572,27004,2134,2212
4237,141,53.8,31250,23347,78,63
4238,1557,34.5,50350,23726,875,682
4239,4840,42.3,49849,24154,2441,2399
4240,36536,38.1,36035,20978,17616,18920
4250,4150,42.2,43480,22231,1961,2189
4252,4807,40.1,46382,23121,2438,2369
4253,2092,43.1,44938,23033,1086,1006
4254,3095,38.2,38697,18233,1496,1599
4255,877,39.7,55000,27972,489,388
4256,3024,41.3,47571,20743,1516,1508
4257,2667,47.5,26477,18485,1326,1341
4258,2603,39.2,60192,33287,1330,1273
4259,3132,42.8,61360,28132,1456,1676
4260,5556,41,58938,24963,2826,2730
4261,438,48,43750,23165,213,225
4263,2088,38.9,54940,23610,1054,1034
4265,996,41.2,75089,34229,563,433
4267,61,28.3,23594,10385,43,18
4268,4999,49.2,38629,21431,2266,2733
4270,6162,43.7,40481,20607,3029,3133
4271,0,-666666666,-666666666,-666666666,0,0
4274,5398,40.8,63770,30810,2618,2780
4275,465,52.7,55313,26627,251,214
4276,5818,43.3,31188,18807,2902,2916
4280,6784,39.7,52317,23690,3148,3636
4281,5162,44.5,31812,20614,2685,2477
4282,5729,43.4,57764,29277,2882,2847
4284,1004,54,59265,32519,484,520
4285,463,54.5,45000,22027,217,246
4286,149,57.6,80625,30019,72,77
4287,3185,40.1,61992,26909,1695,1490
4289,1881,41.5,46375,20766,1017,864
4290,1407,48.1,46985,22458,688,719
4292,1130,43.6,40469,18390,533,597
4294,4075,42.8,38706,21067,1890,2185
4330,26034,42.2,40786,23229,12640,13394
4342,1641,48.5,49306,28743,817,824
4343,79,51.6,-666666666,67849,30,49
4344,2831,39.6,46029,22355,1373,1458
4345,11565,42.9,50886,26121,5607,5958
4346,1772,49.6,44429,25232,812,960
4347,2380,50.8,52025,38830,1231,1149
4348,3084,48.2,50580,28475,1526,1558
4349,1125,49.7,53947,27652,571,554
4350,3607,41.9,57596,23606,1763,1844
4351,2571,47.8,66776,35541,1299,1272
4352,1617,47.4,52625,25691,793,824
4353,2368,45.1,63750,24233,1195,1173
4354,1592,42.8,53125,26605,849,743
4355,2578,45.2,71875,32024,1223,1355
4357,3393,43.4,59961,26571,1669,1724
4358,4236,41.4,44986,22554,2163,2073
4359,455,47.4,34591,19916,202,253
4360,622,46.8,42222,29450,292,330
4363,2567,41.4,49028,26906,1312,1255
4364,5988,44.6,61650,28853,2808,3180
4401,45024,37.6,40388,25164,21369,23655
4406,641,51.2,36121,19646,330,311
4408,175,44.6,60000,25824,81,94
4410,1138,39.5,40326,18773,564,574
4411,1460,46.7,43702,27419,686,774
4412,9428,40.8,48979,28946,4454,4974
4413,168,57.7,44625,34739,76,92
4414,1352,47.5,33839,19825,726,626
4415,232,40.4,37353,18086,116,116
4416,5494,40.9,46731,24133,2712,2782
4417,297,57.1,40750,16843,123,174
4418,1632,42,37955,19692,867,765
4419,2792,41.7,54972,23735,1416,1376
4421,1503,21.3,41563,21463,873,630
4422,1424,34.9,51538,17629,804,620
4424,797,47.5,38098,16206,422,375
4426,4583,48.7,43779,24350,2137,2446
4427,2799,40.9,41705,20022,1318,1481
4428,3306,43.1,47679,23112,1744,1562
4429,4833,45,63523,31605,2456,2377
4430,1718,47.9,34671,19988,763,955
4431,38,65.8,40804,29942,9,29
4434,1274,44.4,50777,22093,618,656
4435,993,45.7,45395,20522,489,504
4438,1275,41.6,38177,18854,558,717
4441,2104,44.5,40323,24504,1061,1043
4442,64,68.3,36319,23233,34,30
4443,2350,46.7,34131,19175,1148,1202
4444,8759,40.4,73524,32579,4418,4341
4448,1514,46,42958,18455,763,751
4449,1435,39.4,47250,22491,695,740
4450,1111,48,40172,26578,563,548
4451,199,63.5,29688,20289,112,87
4453,777,46.7,46429,20702,372,405
4454,57,49.1,23125,13368,28,29
4455,1262,41.6,54167,23139,675,587
4456,2864,39.5,52582,23535,1452,1412
4457,5804,42.7,31875,22602,2964,2840
4459,1008,49.7,27443,17043,545,463
4460,1373,47.3,47143,20526,742,631
4461,3054,46.2,48569,22172,1477,1577
4462,4831,51.3,37450,20681,2635,2196
4463,2631,47.9,29212,19398,1340,1291
4464,675,52.1,29643,18319,355,320
4468,9544,33.8,34881,20296,4666,4878
4469,2651,19.3,-666666666,3538,1467,1184
4471,507,55,28250,21369,279,228
4472,2108,50.4,55625,28624,1062,1046
4473,7801,24.9,37528,24864,4064,3737
4474,3736,47.3,63321,30460,1816,1920
4475,434,49.4,35625,17929,218,216
4476,1144,53.3,38750,26830,505,639
4478,363,51.4,33750,13975,216,147
4479,1416,50.5,27891,20019,699,717
4481,618,48.9,44141,24800,299,319
4485,319,43.6,45500,22474,167,152
4487,860,48.1,28702,15864,478,382
4488,1320,40,53856,22394,650,670
4489,282,35.5,85694,37041,139,143
4490,252,49.3,40625,18025,133,119
4491,94,58.5,20750,20385,49,45
4492,179,48.9,27273,18996,86,93
4493,1948,46.3,43795,20032,954,994
4495,420,49.7,34444,19868,218,202
4496,3770,41.1,55438,27595,1838,1932
4497,435,49.5,31875,16018,216,219
4530,10889,44.1,46367,26871,5046,5843
4535,663,46.5,55208,27258,327,336
4537,2090,41.7,53621,28125,1062,1028
4538,1973,54.8,45841,31978,937,1036
4539,1209,53.8,56786,31904,681,528
4541,157,46.2,88250,37032,64,93
4543,2050,50.3,43341,24878,894,1156
4544,590,64.3,57279,35294,313,277
4547,1114,55,48750,25963,536,578
4548,998,50.8,50446,29487,457,541
4551,868,47.5,53594,30366,420,448
4553,1847,45.6,49539,29907,882,965
4554,718,68,50682,35712,314,404
4555,1656,47.8,57188,31138,776,880
4556,1141,49.3,56313,25803,537,604
4558,298,61.6,21979,29001,124,174
4562,2153,53,67768,31878,1073,1080
4563,1423,38.9,46250,25812,731,692
4564,369,53.5,63207,26127,194,175
4568,481,61.6,58750,41582,233,248
4570,0,-666666666,-666666666,-666666666,0,0
4571,431,55.9,61667,40599,236,195
4572,5042,40.8,45360,20686,2463,2579
4573,487,50.5,49712,33596,242,245
4574,1546,49.2,44250,21903,832,714
4575,57,68.3,230208,83042,36,21
4576,598,64.7,47250,39744,295,303
4578,4434,43.6,46506,27151,2316,2118
4579,3065,45.3,61658,27480,1580,1485
4605,13138,46.4,48880,26677,6432,6706
4606,1175,48.9,44464,28885,582,593
4607,1170,43.9,46016,22269,626,544
4609,5255,46.6,57125,31275,2359,2896
4611,416,51.8,32500,23401,204,212
4612,639,36,39097,31882,320,319
4613,182,41.4,50000,23355,87,95
4614,2430,51.4,37763,33202,1027,1403
4616,870,58.3,48846,33608,453,417
4617,864,48.6,56563,30897,450,414
4619,3091,48,33144,21638,1414,1677
4622,1480,40.8,40104,20084,702,778
4623,1335,40,40469,19986,743,592
4624,147,65.8,36607,23648,52,95
4625,17,75.5,19583,27965,7,10
4626,498,38,45313,20105,272,226
4627,1581,50.3,39531,28894,807,774
4628,682,46.9,37250,18438,333,349
4629,249,64.1,30984,24507,61,188
4630,1313,41.2,43824,20720,646,667
4631,1421,56.3,31354,21626,675,746
4634,1938,44.6,43297,20541,972,966
4635,80,17.6,61500,17958,41,39
4637,123,65.4,31125,33564,56,67
4640,2066,47,41964,30053,1022,1044
4642,52,61.8,68750,41417,17,35
4643,970,48.5,41750,18077,452,518
4644,0,-666666666,-666666666,-666666666,0,0
4645,68,38.8,36250,30969,45,23
4646,86,44.5,52188,26656,30,56
4648,447,45.1,31875,20737,219,228
4649,1301,51.3,34444,19830,625,676
4650,162,62.6,37250,24578,76,86
4652,1974,52.3,32670,20490,929,1045
4653,439,51.8,38500,25477,187,252
4654,3329,38.4,38093,19340,1634,1695
4655,1121,46.1,42284,23143,668,453
4657,335,54.7,43750,24156,171,164
4658,1305,50.7,33458,19926,610,695
4660,1326,57,60967,39848,688,638
4662,420,60.9,51250,40168,203,217
4664,1112,48.1,46607,26071,566,546
4666,1230,48.9,37426,22531,618,612
4667,1635,37.5,34398,17981,784,851
4668,1695,35.7,28438,16550,870,825
4669,130,64.6,61250,50697,64,66
4671,524,52.7,44911,21619,286,238
4673,113,35,46071,23900,55,58
4674,630,40.2,40662,19867,331,299
4675,373,55.6,85313,35169,172,201
4676,956,48.3,36125,22505,497,459
4677,234,62.6,47500,32349,118,116
4679,1839,47,34722,27647,835,1004
4680,1098,43,37159,19159,534,564
4681,1276,49.1,37500,24337,679,597
4683,62,22.5,-666666666,16715,28,34
4684,1638,45,47212,28254,844,794
4685,311,39.3,51875,28404,151,160
4686,93,53.3,36964,25811,52,41
4691,473,49.1,53152,25304,243,230
4693,501,51.5,38042,25620,277,224
4694,2247,47.8,46419,24029,1073,1174
4730,10003,44.4,37729,19697,4839,5164
4732,1746,41.7,36250,19239,927,819
4733,261,53.9,40875,16201,160,101
4734,812,41.1,45885,21017,408,404
4735,623,47.3,34688,17918,335,288
4736,9718,44,39811,24369,4650,5068
4739,904,52.9,33631,22566,452,452
4740,1286,42,34769,20003,653,633
4741,0,-666666666,-666666666,-666666666,0,0
4742,3463,44.3,32225,20345,1705,1758
4743,4580,43.6,37182,23784,2237,2343
4745,1038,51.6,45536,23128,505,533
4746,483,50,34265,18397,221,262
4747,1538,47,39048,21438,800,738
4750,2536,37.5,34468,18610,1267,1269
4756,3523,50.9,36484,21245,1646,1877
4757,2749,42.3,50929,24431,1393,1356
4758,1510,41.7,38017,20949,763,747
4760,704,43.6,40192,19271,366,338
4761,447,53.2,39250,26898,213,234
4762,591,50.4,47321,22984,289,302
4763,676,48.2,34479,18893,321,355
4764,50,69.7,38125,20934,23,27
4765,1361,50.6,37313,24698,686,675
4766,417,37.8,48571,18184,193,224
4768,427,55.8,43125,26348,200,227
4769,9568,43.1,37134,22372,4677,4891
4772,741,53.1,36042,21988,362,379
4773,503,55.5,36369,20271,254,249
4774,703,57,25795,18513,363,340
4776,880,51.3,37500,20521,400,480
4777,451,44.1,32500,15127,243,208
4779,307,62.7,52375,26845,185,122
4780,826,36.2,43864,19603,446,380
4781,507,52,41719,22278,275,232
4783,340,55.3,37500,25306,155,185
4785,2883,50.9,26912,19515,1373,1510
4786,1950,45.8,42417,21626,913,1037
4787,656,46.2,42500,17114,320,336
4841,7273,46.9,37549,22601,3439,3834
4843,4855,55,55452,41662,2227,2628
4847,1560,42.7,54583,23291,763,797
4848,598,58.5,56184,41732,273,325
4849,3805,49.9,48274,28105,1869,1936
4851,42,43.3,50417,19290,24,18
4852,45,35.8,7000,13980,17,28
4853,392,47.4,65000,36927,177,215
4854,1663,50.4,62750,33346,824,839
4855,316,52.3,50469,20919,133,183
4856,3326,45.3,60556,33209,1465,1861
4858,1441,40.9,55104,27974,728,713
4859,323,63.2,45000,26983,159,164
4860,1989,52.5,53333,29660,943,1046
4861,2781,47.4,47601,23648,1408,1373
4862,3665,46.5,52155,25610,1874,1791
4863,1199,46.9,56563,30909,726,473
4864,4718,37.9,58763,23092,2662,2056
4901,26254,40.6,38182,23204,12523,13731
4910,1973,43.5,47879,23872,889,1084
4911,2092,41.1,34228,18376,1153,939
4912,1112,41.3,34896,17393,483,629
4915,8807,43.4,33925,20650,4163,4644
4917,2896,43.2,59766,31032,1531,1365
4918,286,56.9,31063,31029,124,162
4920,1727,48.6,29028,18116,865,862
4921,1441,43,32917,19834,688,753
4922,1203,47.5,30078,17946,611,592
4923,517,51.1,32847,17384,262,255
4924,2138,44.2,43018,21118,1069,1069
4925,82,45.4,44375,33733,38,44
4926,78,48.1,-666666666,,59,19
4927,3453,41.1,41146,19335,1758,1695
4928,2060,42.3,42917,22264,996,1064
4929,829,43.6,42692,21426,435,394
4930,4330,48,40110,21174,1973,2357
4932,1204,44.5,52813,24067,601,603
4933,65,25,-666666666,,32,33
4936,223,67.4,42500,28252,109,114
4937,6502,41.4,46603,23484,3261,3241
4938,9658,40.6,38231,20914,4588,5070
4939,1183,42.7,40375,18680,600,583
4940,28,-666666666,-666666666,,0,28
4941,1498,48.4,37396,20907,709,789
4942,1176,49,28594,19473,628,548
4943,1798,47.9,32552,21294,869,929
4944,56,-666666666,-666666666,,56,0
4945,1122,49.6,40300,20905,513,609
4947,1779,48.4,48333,27525,894,885
4949,763,46.5,39444,19805,366,397
4950,4804,45.7,37750,22259,2416,2388
4951,938,47.4,44000,23145,433,505
4952,1881,43.4,45694,22361,970,911
4953,3203,46.5,36175,22893,1472,1731
4955,1379,44.6,43259,21477,709,670
4956,631,50.7,36875,24218,316,315
4957,4190,47.8,44618,25306,2196,1994
4958,1837,49.4,32262,19180,856,981
4961,951,52.4,35474,20203,498,453
4962,155,24.2,20179,8835,81,74
4963,7279,46.3,56994,33885,3558,3721
4964,157,58.4,44625,34190,82,75
4965,2128,43.1,39012,18370,985,1143
4966,1861,46.4,44020,20976,954,907
4967,4213,39.8,42847,22705,1976,2237
4969,1139,42.4,49632,21488,617,522
4970,1602,51.3,43750,26118,866,736
4971,2040,41.7,43393,18545,1006,1034
4973,1645,41.3,42500,20962,903,742
4974,2630,44.7,32050,21631,1368,1262
4975,121,66.4,-666666666,22037,85,36
4976,9874,43.4,36512,22170,4692,5182
4978,868,42.4,54231,24113,384,484
4979,1128,47.3,39130,20509,557,571
4981,2105,48,51719,28649,1069,1036
4982,493,44.5,37813,18340,263,230
4983,1651,42.6,37694,21894,817,834
4984,613,44.2,43036,20878,305,308
4985,66,55.7,59583,33191,32,34
4986,1645,42.6,39612,20307,848,797
4987,897,45.5,37250,20554,427,470
4988,2373,31,38333,16852,1063,1310
4989,4177,45.6,48508,24464,2056,2121
4992,324,22.8,6901,9507,128,196
5001,9376,42.4,54327,31125,4538,4838
5031,109,60.8,58194,35275,71,38
5032,2935,44.8,57478,26727,1423,1512
5033,2729,40.3,43021,23173,1338,1391
5034,213,55.3,75625,48967,108,105
5035,496,52.2,48929,32943,259,237
5036,959,47.3,66875,32804,530,429
5037,628,45.9,70583,32053,289,339
5038,1351,46.8,53583,27626,632,719
5039,965,48.9,60750,33299,513,452
5040,565,35,55078,20079,276,289
5041,531,15.3,45833,12148,221,310
5042,511,42.7,46875,24899,263,248
5043,859,45.4,80417,35993,451,408
5045,1905,47.6,61875,33223,913,992
5046,1182,43.5,45685,24796,577,605
5048,2453,46,62438,32227,1343,1110
5050,128,44.3,14926,17453,64,64
5051,1662,48.1,47950,27824,759,903
5052,216,45.9,51224,33494,91,125
5053,331,56.1,70227,39193,126,205
5055,3396,41.1,95170,49101,1581,1815
5056,440,46.6,63250,34398,249,191
5058,289,36.9,55417,18693,167,122
5059,609,43.6,49740,31828,273,336
5060,4486,46.7,44869,26235,2261,2225
5061,1376,26.7,61645,23472,767,609
5062,628,44.7,58021,28867,309,319
5065,1217,41.6,56731,28363,579,638
5067,261,58.7,67679,31995,122,139
5068,3135,37.8,38894,23496,1587,1548
5069,546,50,62708,25281,256,290
5070,445,54.1,64583,43400,223,222
5071,262,53.8,143625,46945,115,147
5072,571,48.1,60000,35531,308,263
5075,1139,50.1,91563,41474,528,611
5076,435,36.7,47750,19358,226,209
5077,1115,43.9,58929,31504,541,574
5079,705,39.2,45216,23280,349,356
5081,548,38,35139,21395,253,295
5083,121,50.6,33750,19507,59,62
5084,44,56.3,46957,43948,10,34
5086,748,46,43920,23008,371,377
5089,4974,46.2,46097,27084,2518,2456
5091,3418,54.7,75000,45770,1474,1944
5101,4553,44.1,34270,21774,2165,2388
5141,85,71,13000,19569,22,63
5142,840,43.2,53750,28458,393,447
5143,4187,49.8,46708,30926,1982,2205
5146,651,48.9,41964,28088,342,309
5148,1080,46.3,57313,32852,537,543
5149,2028,50.5,40625,26331,1023,1005
5150,897,55,33992,26114,404,493
5151,1126,51.4,47333,25802,524,602
5152,457,47.4,55625,36608,242,215
5153,803,48.8,49167,23553,393,410
5154,764,31,67250,39142,346,418
5155,557,58.2,45643,32640,234,323
5156,9529,43.6,48872,25574,4946,4583
5158,1186,44.7,67031,29839,545,641
5161,562,56.6,52250,35875,296,266
5201,14360,41.4,38259,24721,7133,7227
5250,3557,47.8,55861,32316,1673,1884
5251,1392,54.1,73854,41107,641,751
5252,286,55.1,62250,36269,126,160
5253,668,44.3,54453,29055,370,298
5254,305,52.9,127875,51218,157,148
5255,4051,45.7,48311,35424,1897,2154
5257,2697,33.4,46250,24277,1267,1430
5260,458,28.5,64028,22143,237,221
5261,2835,45,56667,25144,1342,1493
5262,2676,50.4,61389,34664,1252,1424
5301,16819,44.1,49552,28510,8107,8712
5340,686,53.3,65769,48258,327,359
5341,478,54.5,58235,30718,249,229
5342,479,43.4,48304,27367,241,238
5343,837,45.1,48224,21547,392,445
5345,2236,48,58398,28220,1148,1088
5346,5002,43.4,56852,30546,2478,2524
5350,726,49.8,36750,25097,385,341
5352,887,49.8,57292,27588,452,435
5353,944,53.2,51300,39200,464,480
5354,2044,45.4,60787,30675,1003,1041
5355,617,48.1,38462,20705,332,285
5356,862,48.2,37721,35799,465,397
5358,206,48.5,52500,39521,101,105
5359,538,54.7,42857,35846,263,275
5360,240,40.2,39732,29524,130,110
5361,957,41,55625,25167,562,395
5362,130,47.7,92813,33892,52,78
5363,2715,47.3,62000,31714,1402,1313
5401,27908,27.5,36348,26259,13903,14005
5403,17998,40.4,65091,37385,8838,9160
5404,7071,31.7,43922,25139,3418,3653
5405,4259,19.5,-666666666,7053,1725,2534
5408,10309,44.9,63918,31094,5019,5290
5439,1697,20.3,-666666666,8089,650,1047
5440,1763,43.8,53446,27361,901,862
5441,1134,33.7,65815,23889,537,597
5442,315,41.8,58036,20189,142,173
5443,6467,45.5,59963,27723,3185,3282
5444,1637,41.3,68359,33744,793,844
5445,3776,46.2,110344,60961,1953,1823
5446,15736,36,70042,33014,7562,8174
5447,115,47.4,69063,27758,56,59
5448,1129,45.7,65263,34974,621,508
5450,4874,39.7,54004,24149,2640,2234
5452,20010,39.5,76074,34633,9740,10270
5454,4754,38.7,74911,31192,2297,2457
5455,1133,39.3,66071,27895,577,556
5456,1349,41.1,53250,27299,739,610
5457,1334,44,53793,26666,713,621
5458,2293,47.1,60239,35043,1170,1123
5459,2450,28.5,53125,21434,1134,1316
5461,4525,43.5,65481,32647,2227,2298
5462,1965,42.9,71719,33256,1017,948
5463,500,36.9,49375,25322,246,254
5464,2826,36.6,60272,27109,1388,1438
5465,5349,41.4,92059,40467,2678,2671
5468,13156,40,74372,29188,6670,6486
5471,745,47.2,34722,26660,360,385
5472,1577,46.9,69375,31051,820,757
5473,1501,46.9,75341,36043,757,744
5474,896,46.6,69792,39122,452,444
5476,3388,38.5,40638,19917,1635,1753
5477,4509,38.4,73640,35370,2186,2323
5478,13868,42.2,52295,28830,6509,7359
5481,0,-666666666,-666666666,-666666666,0,0
5482,7387,46.1,94196,51295,3638,3749
5483,1481,35.9,65039,24743,653,828
5485,16,66,70781,46056,8,8
5486,1532,47.9,64107,36080,718,814
5487,1537,37.7,57955,27096,781,756
5488,7990,38,52026,28278,4229,3761
5489,3129,44,89710,42718,1545,1584
5491,5917,42.5,55572,27592,2970,2947
5492,727,41,53315,23399,396,331
5494,1702,43.5,77243,36505,861,841
5495,9513,44.9,70877,39694,4561,4952
5602,11711,44.5,63056,33117,5558,6153
5640,256,51.1,52500,23354,101,155
5641,17298,42.6,49077,27985,8498,8800
5647,1096,46,39815,26612,582,514
5648,384,49.6,84063,38577,187,197
5649,971,31.9,66815,21151,546,425
5650,1080,40.1,61563,25564,579,501
5651,1609,41.3,56917,28564,720,889
5652,896,37.2,53333,22737,470,426
5653,486,35.7,40481,18775,241,245
5654,631,49.1,47902,29270,304,327
5655,2912,45.1,48523,25946,1466,1446
5656,3593,28.2,31875,15845,1799,1794
5657,47,56.2,63000,32147,24,23
5658,1505,41.6,43958,22443,772,733
5660,1673,47.5,77188,37956,832,841
5661,5716,43.7,55847,29313,3012,2704
5663,6968,30.8,64524,23316,3759,3209
5664,0,-666666666,-666666666,-666666666,0,0
5667,2343,42.4,52697,25059,1136,1207
5669,644,42.8,40583,20618,309,335
5672,4345,41,66867,38644,1933,2412
5673,2441,44.8,72946,36612,1246,1195
5674,1548,46.3,62750,37141,818,730
5675,1066,46.9,51724,27142,593,473
5676,4999,43.6,57021,31809,2365,2634
5677,2157,47.2,71250,40230,1058,1099
5678,80,30.3,-666666666,22694,52,28
5679,3350,41,48732,24145,1577,1773
5680,2078,42.8,48042,22872,1056,1022
5681,325,37.7,64167,29018,160,165
5682,1229,43.7,59750,28598,622,607
5701,20361,44.7,42981,25459,9567,10794
5730,282,57.5,87778,42139,131,151
5732,809,41,52639,24625,451,358
5733,5799,47.7,53504,26931,2850,2949
5734,1227,46.3,62500,31517,649,578
5735,4106,34.6,58277,26092,2197,1909
5736,788,48.4,56313,36613,428,360
5737,770,45.6,62083,38759,379,391
5738,1165,50,70781,32146,624,541
5739,1510,42,59107,27943,729,781
5740,0,-666666666,-666666666,-666666666,0,0
5742,643,35.4,42778,25312,341,302
5743,4291,41.9,46685,21873,2241,2050
5744,683,31.8,60474,20378,347,336
5747,319,41.2,49844,27955,164,155
5748,370,41.7,32386,19947,200,170
5751,850,48.1,65714,33948,421,429
5753,10545,32.5,56791,30167,5224,5321
5757,826,49,43846,24194,411,415
5758,842,50.2,55787,25864,409,433
5759,1671,55,56861,30592,852,819
5760,1037,44.5,55192,25876,484,553
5761,1087,44.6,50139,24414,522,565
5762,626,40.4,57303,24478,289,337
5763,2718,46.7,56902,34032,1450,1268
5764,3442,34.4,42285,21741,1601,1841
5765,1789,44.9,49034,27687,854,935
5766,588,42.6,53889,28634,301,287
5767,1000,51.3,49205,27941,492,508
5769,1160,45.9,47500,26112,549,611
5770,1181,48.4,66313,28175,598,583
5772,652,43.7,50096,33581,361,291
5773,2123,48,56799,27681,1029,1094
5774,1220,49.4,43167,22874,640,580
5775,606,40.9,34904,20352,287,319
5776,640,52.9,42083,35434,306,334
5777,3457,45.2,49563,24221,1792,1665
5778,770,42.2,51625,22282,372,398
5819,9754,43.2,45470,25866,4823,4931
5820,624,45.2,39500,21791,326,298
5821,1154,48.8,63472,25323,556,598
5822,1715,47.2,39318,22431,878,837
5824,1073,46.2,38438,22867,543,530
5825,277,38.9,45729,20413,150,127
5826,958,37.5,49911,20790,475,483
5827,298,41.4,38214,19251,148,150
5828,2011,51.2,52292,29717,924,1087
5829,1788,49.4,37844,21749,806,982
5830,1648,44,45000,24996,810,838
5832,789,47.3,54583,26584,443,346
5833,161,34.8,27917,17298,100,61
5836,1166,41.6,54928,26287,620,546
5837,389,48.1,39833,20195,224,165
5839,777,43.7,49650,22811,367,410
5841,384,57.7,46607,35835,184,200
5842,522,38.6,44063,17567,271,251
5843,2636,39,42143,22430,1326,1310
5845,1037,48.1,45139,23337,550,487
5846,1008,46.5,27625,18594,461,547
5847,845,37,48875,19841,480,365
5850,185,19.6,-666666666,15664,107,78
5851,6589,37.5,39434,18954,3214,3375
5853,755,44.2,50357,26519,394,361
5855,7321,43,39405,21912,3495,3826
5857,1596,49.4,45292,23226,791,805
5858,468,35,34271,18078,230,238
5859,2075,39,41393,19322,1078,997
5860,2596,41.8,43958,19929,1305,1291
5862,387,52.4,44250,28539,177,210
5866,559,50.6,41979,21550,296,263
5867,877,40.8,33542,16358,440,437
5868,279,43.8,38125,25689,169,110
5871,1569,39.4,46776,22083,794,775
5872,683,51.3,37614,23508,353,330
5873,583,45.1,56389,25812,294,289
5874,541,41.7,68846,28252,268,273
5875,496,45.1,46923,27077,282,214
5901,15,80.3,46250,19067,11,4
5902,180,50.5,51667,24541,72,108
5903,1088,46.1,40750,20258,563,525
5904,229,47.4,26406,15947,107,122
5905,753,52.1,36397,26074,374,379
5906,1264,45.4,38382,19979,701,563
5907,160,59.4,31705,23422,76,84
6001,18577,45.9,113838,64064,8772,9805
6002,20562,48.2,73104,41702,9543,11019
6010,60525,40.8,57632,30576,29846,30679
6013,9395,42.2,105250,43018,4941,4454
6016,6296,41.2,76599,34302,2961,3335
6018,2782,45.6,48100,24977,1317,1465
6019,10249,45.1,88281,44781,4770,5479
6020,0,-666666666,-666666666,-666666666,0,0
6021,300,46.9,67500,33899,160,140
6022,55,31.7,31950,53900,16,39
6023,1131,49.2,85987,37177,609,522
6024,650,48.6,51369,28454,337,313
6026,4896,43.9,71786,36072,2568,2328
6027,1553,45.1,87348,33743,771,782
6029,15593,40.1,84840,39064,7775,7818
6031,1268,51,84917,56955,630,638
6032,17790,43,93810,57271,8737,9053
6033,28469,43.5,103844,50911,13680,14789
6035,8111,46.2,87594,47301,4095,4016
6037,19048,44.6,87736,38831,9226,9822
6039,1766,52.6,58674,44390,743,1023
6040,35918,35.5,62674,31636,17450,18468
6042,22278,36.3,64761,34606,10677,11601
6043,4971,47,86890,45492,2526,2445
6051,30431,31.5,31626,16815,14398,16033
6052,7777,40.1,54602,28579,3536,4241
6053,34915,34.3,45325,22236,16332,18583
6057,6458,43,86354,38644,3286,3172
6058,1588,47.7,73375,40438,746,842
6059,0,-666666666,-666666666,-666666666,0,0
6060,2346,45.1,123793,84908,1148,1198
6061,221,42.9,18068,24588,127,94
6062,17767,42.4,60630,32531,8603,9164
6063,3233,45.5,88750,39472,1631,1602
6065,922,44.1,95385,32848,422,500
6066,29179,39.7,61038,35361,14219,14960
6067,19743,43.4,77560,42229,9485,10258
6068,1751,54.6,73354,47201,687,1064
6069,2440,57,73958,54815,1234,1206
6070,15043,43.9,119188,56097,7362,7681
6071,11599,42.3,99183,33570,6584,5015
6073,6082,44,124750,62367,2962,3120
6074,25756,42.6,90499,41398,12909,12847
6076,12846,40.9,63750,28780,6449,6397
6078,12524,39.9,92546,37959,7205,5319
6081,1370,40.4,54408,38325,579,791
6082,44699,41.1,67191,29557,23166,21533
6084,15059,42,103696,43690,7601,7458
6085,7169,42.2,81983,40959,3590,3579
6088,4985,45,68228,30833,2239,2746
6089,3097,39.4,109167,57889,1579,1518
6090,1045,44.2,128272,51127,527,518
6091,157,57,85625,38520,78,79
6092,4081,45.6,153092,64034,2044,2037
6093,3207,45.5,94167,40113,1649,1558
6095,29130,42.5,79487,35825,13922,15208
6096,12531,42.4,66583,35933,6148,6383
6098,12643,44.4,60298,29985,6247,6396
6103,1295,31.3,92321,64278,712,583
6105,20855,33.4,30657,24673,10224,10631
6106,38225,29.8,26752,15210,18863,19362
6107,18818,44.4,107972,54286,8831,9987
6108,24349,36.2,43098,21766,11741,12608
6109,26590,44.4,77740,39587,12456,14134
6110,12360,38.9,56337,29391,5679,6681
6111,30606,43.8,77368,36462,14093,16513
6112,23298,28.2,30199,14651,10572,12726
6114,28151,30.2,31253,15333,13426,14725
6117,17868,39.6,114194,53011,8236,9632
6118,26892,40.8,57044,29029,12697,14195
6119,15299,38.9,69408,42497,7131,8168
6120,12358,29.3,19855,12960,6296,6062
6160,0,-666666666,-666666666,-666666666,0,0
6226,19792,26.6,33723,17951,9199,10593
6231,3805,41.9,116326,43372,1895,1910
6232,3095,42.6,88438,38340,1569,1526
6234,8242,41.9,59488,26616,4386,3856
6235,2368,41.5,76912,33940,1120,1248
6237,5476,47.9,90725,40206,2494,2982
6238,12435,44.4,93816,38946,6287,6148
6239,10223,41.8,47628,25251,5066,5157
6241,7605,38.9,72177,29448,3930,3675
6242,1405,44.9,80357,36757,740,665
6243,0,-666666666,-666666666,-666666666,0,0
6247,2833,45.6,73704,33530,1436,1397
6248,5833,42,110271,41466,2864,2969
6249,7322,44.7,83651,35917,4000,3322
6250,5215,39.4,78037,31639,2353,2862
6254,1950,43.5,89643,36893,972,978
6255,4741,43.2,67891,29162,2427,2314
6256,2378,48.6,48952,25830,1237,1141
6259,4436,42.4,86250,39366,2209,2227
6260,9524,38.5,46657,24128,4531,4993
6262,513,52.3,45125,28780,228,285
6263,108,54.2,26176,16340,82,26
6264,83,51.3,51563,24495,42,41
6266,534,37.8,59702,19843,304,230
6268,11063,24.5,62753,26735,5921,5142
6269,9880,20,-666666666,4048,4459,5421
6277,3999,42.7,70625,35940,1980,2019
6278,4385,38.9,75148,37351,2183,2202
6279,6018,39.5,72011,34916,3280,2738
6280,3046,48,76250,34677,1396,1650
6281,6983,42.1,78958,36943,3507,3476
6282,1131,51.5,73750,44413,508,623
6320,27663,30.3,43357,21664,13092,14571
6330,3366,40.4,67917,29294,1689,1677
6331,5119,43.4,73038,31550,2582,2537
6332,310,62.2,66596,29336,178,132
6333,6390,44.7,106296,46527,3048,3342
6334,2608,44.7,80500,32422,1249,1359
6335,6832,43.4,98427,40158,3302,3530
6336,39,50.5,54485,50046,28,11
6339,8203,40,81368,36542,4191,4012
6340,31769,30.5,55992,30184,17050,14719
6350,84,48.9,71917,54345,42,42
6351,16304,39.7,64333,30734,7814,8490
6353,0,-666666666,-666666666,-666666666,0,0
6354,6089,39.7,55565,25565,2849,3240
6355,12466,47,85634,48820,6087,6379
6357,12729,44.5,71085,33891,6124,6605
6359,5307,45.7,82353,37735,2690,2617
6360,37427,37.3,49620,27611,18228,19199
6365,4751,42.5,74141,33599,2454,2297
6370,7484,42.9,78207,34664,3582,3902
6371,9893,50.2,86237,51109,5069,4824
6373,406,32.3,32473,24049,185,221
6374,8568,41.1,67434,27706,4266,4302
6375,4119,44.4,78650,34716,2070,2049
6376,122,62.5,179531,117074,70,52
6377,2787,38.5,71509,28464,1631,1156
6378,5299,49.3,92183,54436,2607,2692
6379,9119,42,68240,33288,4410,4709
6380,2850,39.8,41596,25215,1438,1412
6382,11911,41.1,57704,27065,6799,5112
6384,2768,41.1,74141,32223,1376,1392
6385,15540,47.7,72047,40058,7542,7998
6387,171,27.5,29957,15785,116,55
6389,118,26.5,-666666666,,78,40
6390,291,47.6,149554,64673,144,147
6401,19163,40.9,45505,25374,9128,10035
6403,5975,41.8,85560,34664,3165,2810
6405,27825,47.4,70960,42716,13166,14659
6409,605,47.9,65441,33920,314,291
6410,29231,42.5,111744,43745,15199,14032
6412,4154,48.9,74911,41055,2093,2061
6413,13205,44.6,70814,37729,6536,6669
6414,321,57.6,160625,34277,234,87
6415,16755,39.5,97656,37140,8286,8469
6416,14076,43.5,75859,38463,6767,7309
6417,4615,46.7,71500,40835,2306,2309
6418,12841,40.7,53098,27568,6232,6609
6419,6501,47.4,112761,52335,3216,3285
6420,4182,42.3,99946,40818,2173,2009
6422,7380,42.5,124179,47679,3775,3605
6423,5174,42.8,82552,40278,2604,2570
6424,12603,40.6,92100,40729,6602,6001
6426,3129,60.3,98170,75003,1421,1708
6437,22377,47.6,96151,53106,10715,11662
6438,3025,41,92989,42977,1572,1453
6441,5103,45.4,96215,44672,2330,2773
6442,2934,46,81772,40734,1247,1687
6443,18289,46.7,110761,53943,8867,9422
6444,134,29.7,103636,22178,40,94
6447,6398,42,110694,41729,3138,3260
6450,37026,39.3,55759,27703,18475,18551
6451,23703,37.8,49068,25759,11432,12271
6455,3288,44,100227,43275,1653,1635
6456,240,57.6,114087,72912,127,113
6457,47539,37.6,59994,32966,22705,24834
6460,38090,42.7,77744,39579,18407,19683
6461,14804,42.7,90798,41647,7315,7489
6467,124,41.1,60972,20500,81,43
6468,19631,42.6,103589,48118,9680,9951
6469,3319,41,90794,37560,1599,1720
6470,16554,44.3,111125,49281,8378,8176
6471,7983,46.4,81570,39790,3947,4036
6472,6600,41.9,94042,35738,3431,3169
6473,24193,46.3,86108,38901,11370,12823
6475,10258,49.9,75549,44150,4827,5431
6477,13934,45.9,106942,48101,6922,7012
6478,12736,43.4,102167,42719,6093,6643
6479,10247,45.3,80387,38685,5262,4985
6480,9487,44.3,88693,42569,4659,4828
6481,1133,45.8,85156,40601,503,630
6482,11218,42.2,106926,47182,5516,5702
6483,16535,40.9,75426,33667,7886,8649
6484,40006,45.5,86138,41679,18957,21049
6488,19864,50.3,73341,43058,9509,10355
6489,32745,44.1,79748,37984,15719,17026
6492,45145,43,75289,36297,22032,23113
6498,6956,47,63520,41338,3397,3559
6510,2577,28.5,42656,42031,1367,1210
6511,53062,28.6,36275,25034,24596,28466
6512,28922,43.8,65559,32230,14182,14740
6513,40765,33.6,36457,20099,19591,21174
6514,27072,37.7,65591,30362,12411,14661
6515,18034,30.9,51611,29312,8561,9473
6516,55349,36.9,52353,26602,26655,28694
6517,14859,40.9,69913,40333,6766,8093
6518,19503,32.1,74230,33858,8491,11012
6519,15997,29.2,24975,14362,7637,8360
6524,5555,43.5,100083,44641,2803,2752
6525,8981,48.1,138082,63756,4632,4349
6604,29972,31.2,34071,18920,14363,15609
6605,23497,32.2,39955,20659,11410,12087
6606,47916,33.7,52324,23824,23773,24143
6607,7379,31.4,30840,13988,3260,4119
6608,14348,26,30833,13949,6619,7729
6610,22475,34.6,38300,19292,10410,12065
6611,36251,43.6,108854,44571,17513,18738
6612,7550,46.6,150000,64002,3704,3846
6614,33760,43.5,77025,36007,16227,17533
6615,17934,41.4,52593,30841,8556,9378
6702,2948,53.4,11368,10855,1331,1617
6704,25682,33.1,36629,17753,11875,13807
6705,27318,35.3,43892,23061,12910,14408
6706,15012,33.5,47837,20259,7415,7597
6708,29238,36.5,50940,25408,14392,14846
6710,9852,29.5,31120,16140,4505,5347
6712,9520,44.3,98151,37951,4782,4738
6716,16688,43.8,83993,35884,7946,8742
6750,1392,45.2,58833,32652,612,780
6751,3527,50.1,83105,42779,1670,1857
6752,1729,51.5,87875,58719,837,892
6754,1850,44.1,83250,39630,953,897
6755,936,40.3,85441,45484,442,494
6756,2779,49.4,78450,38448,1369,1410
6757,2117,47.5,62708,45816,987,1130
6758,404,44.6,101591,39254,217,187
6759,5822,46.8,84306,49674,2868,2954
6762,7550,45,96181,42903,3655,3895
6763,1971,47.3,78438,37127,993,978
6770,31887,39.2,58937,28772,16038,15849
6776,26948,41,80260,40869,13648,13300
6777,1476,46.8,77679,53667,768,708
6778,1326,45.9,93580,37164,697,629
6779,8287,44.1,66783,29796,4041,4246
6782,2240,49.4,75048,31740,1108,1132
6783,2293,51.1,89766,61481,1094,1199
6784,3681,48.6,111094,59338,1800,1881
6785,847,39.9,72404,33636,334,513
6786,9908,40.1,69964,30253,4971,4937
6787,7831,44,76692,33870,3692,4139
6790,36017,44.1,51799,28893,17399,18618
6791,5748,45.5,89883,43065,2917,2831
6793,1000,50.1,79259,62202,490,510
6794,1472,52,89773,61348,733,739
6795,14122,45,97354,41515,6933,7189
6796,1026,52,86333,48014,489,537
6798,9918,47.8,81875,44514,4927,4991
6801,18911,40.9,85884,38941,9383,9528
6804,16598,44.1,107008,48203,8154,8444
6807,6685,43.3,141371,77938,3282,3403
6810,49777,34.6,53944,26542,24055,25722
6811,32182,40.1,84092,37326,15110,17072
6812,14010,43,103100,42261,7108,6902
6820,20925,38.7,205688,94820,10389,10536
6824,34864,38.5,128558,60182,16689,18175
6825,20712,43.1,101519,47180,9384,11328
6830,24690,41.7,109860,92795,11755,12935
6831,14699,46.2,130075,94958,7083,7616
6840,19938,42.6,161848,97498,9832,10106
6850,19950,41.1,83383,44974,9470,10480
6851,28204,42.5,82226,44810,13654,14550
6853,3735,47.4,129266,90491,1830,1905
6854,27246,37.6,56127,34433,13711,13535
6855,7071,45.2,73958,46677,3687,3384
6856,4,54,-666666666,3000,4,0
6870,7179,40.4,176169,105701,3517,3662
6877,24982,42.7,147025,76750,12225,12757
6878,8627,40.1,166050,76870,4346,4281
6880,27025,45.4,158713,92255,13095,13930
6883,10261,42.5,207262,90552,5127,5134
6890,4445,43.8,166938,91130,2126,2319
6896,9056,47.4,119046,60893,4485,4571
6897,18491,42,168047,77424,9103,9388
6901,7213,35.2,59118,47002,3584,3629
6902,66657,33.7,63582,34175,34119,32538
6903,14550,45.4,169464,75146,7061,7489
6905,19067,40.9,99626,50589,9265,9802
6906,8537,36.1,68827,42551,4216,4321
6907,7824,38.7,86434,43274,3800,4024
7001,16895,38.2,71141,23899,9750,7145
7002,63819,38.9,55608,29169,30961,32858
7003,47442,38.1,70434,33521,22010,25432
7004,7420,44.1,97115,43145,3578,3842
7005,15097,43.2,96410,46218,7088,8009
7006,25012,43.9,99209,53784,11761,13251
7008,23487,36,60353,24141,11411,12076
7009,12450,46.3,96092,45056,5688,6762
7010,24110,42.5,62364,36464,11442,12668
7011,40293,34.9,56895,22318,20333,19960
7012,11927,38.4,76721,40319,6053,5874
7013,26026,42.9,76547,38985,12786,13240
7014,5278,33.9,84750,35467,2474,2804
7016,22846,42,113550,49217,10943,11903
7017,34813,38.4,38818,22151,15140,19673
7018,29656,34.7,38118,21227,12756,16900
7020,11706,37.4,101934,64309,5455,6251
7021,2119,41.7,171509,85821,1069,1050
7022,13988,36.9,48532,24489,7168,6820
7023,7390,39.6,127348,46775,3687,3703
7024,35607,45.3,71949,46064,16562,19045
7026,30797,35.2,48715,21906,14832,15965
7027,4239,37.2,83365,38553,2129,2110
7028,7648,39.8,166558,71473,3643,4005
7029,16496,33.2,53051,24379,8500,7996
7030,50929,31.2,107366,70609,25120,25809
7031,15492,41.2,77750,34636,7989,7503
7032,41123,37.2,61782,25936,20916,20207
7033,7977,40.4,92310,33914,3855,4122
7034,9763,38.2,80283,33296,4764,4999
7035,10609,45.8,82895,36922,5373,5236
7036,42231,39.6,61004,27838,19855,22376
7039,29437,43.5,134320,59665,14446,14991
7040,24021,37.8,113837,51141,11484,12537
7041,7199,38.3,108191,51967,3447,3752
7042,25479,38,79525,51588,11858,13621
7043,12861,38.7,162151,72770,6056,6805
7044,13775,44.8,99810,52178,6330,7445
7045,9742,45.9,108824,59597,4527,5215
7046,4218,42.4,166944,79182,2181,2037
7047,61434,36.2,52908,25814,29761,31673
7050,30062,35,34965,18980,14158,15904
7052,46386,40.6,87826,42879,22302,24084
7054,29101,40.7,78253,37884,14123,14978
7055,70215,28.9,32104,14872,35137,35078
7057,11432,39,52451,28422,5672,5760
7058,6163,36.5,103798,42943,3269,2894
7059,15574,43.3,149053,66745,7793,7781
7060,44793,33.8,53800,23487,23074,21719
7062,12571,37.7,61943,25745,5942,6629
7063,14552,33.4,68075,21768,7267,7285
7064,3469,43.4,70909,28148,1694,1775
7065,27701,38.4,58101,28095,13565,14136
7066,14882,43.9,98990,40580,6833,8049
7067,17792,41.1,88714,36653,8524,9268
7068,5813,46.6,109325,61644,2804,3009
7069,6130,46.9,107861,69724,3087,3043
7070,18201,38.7,85784,40768,8843,9358
7071,20841,40.2,71910,34176,9904,10937
7072,6155,43,64954,32872,3041,3114
7073,9091,38,68965,37287,4578,4513
7074,2729,45.9,50673,30323,1349,1380
7075,8071,43.5,96000,38548,4074,3997
7076,23561,41.5,109872,52297,11218,12343
7077,2561,40.3,82593,32520,1243,1318
7078,12912,40.9,223214,103908,6241,6671
7079,16435,35.7,124213,52371,7696,8739
7080,23543,41,88980,36245,11752,11791
7081,16249,44,92120,47427,7948,8301
7082,5107,45.9,129432,59216,2468,2639
7083,53503,41.8,77393,34304,25284,28219
7086,12829,36.8,72717,48129,6846,5983
7087,67566,34,40903,19559,34292,33274
7088,3412,42,45625,23163,1603,1809
7090,30599,40.6,132460,64941,14608,15991
7092,6763,45.6,129306,65467,3667,3096
7093,61919,35.7,47299,26871,30770,31149
7094,17106,41.6,85392,40553,8573,8533
7095,20722,35,80235,33466,10443,10279
7102,12922,30.1,22734,14085,7275,5647
7103,30432,29.1,27459,14843,13735,16697
7104,50813,31.7,34998,17132,24867,25946
7105,50466,34.2,41959,18174,29050,21416
7106,30675,33.4,40067,20745,13764,16911
7107,37788,31.4,32057,15826,18420,19368
7108,24053,29.9,27616,15502,10673,13380
7109,35973,37.8,65654,29215,17890,18083
7110,28384,41.8,85082,39696,13411,14973
7111,54144,34.1,37485,19083,25494,28650
7112,25935,34.6,39271,19570,11943,13992
7114,14352,33.1,19639,11993,8939,5413
7201,24719,32.1,41505,18017,12030,12689
7202,42177,33.3,43534,18502,20711,21466
7203,21212,40.2,48821,24786,9762,11450
7204,13384,39.2,60308,30693,6580,6804
7205,21538,38.2,58333,26187,10735,10803
7206,26860,29.5,45414,16274,12946,13914
7208,32132,34.5,45927,22926,15934,16198
7302,37472,33.6,98952,61093,19569,17903
7304,40750,35.5,44104,23645,19478,21272
7305,63033,34.3,49894,25556,28795,34238
7306,53767,32.5,46312,24047,27675,26092
7307,43283,32.9,54498,26198,21804,21479
7310,12644,30.9,133636,68521,6311,6333
7311,435,33.1,219643,172437,246,189
7401,6595,41.8,131441,55554,3339,3256
7403,7693,38.9,71526,32143,3818,3875
7405,17809,41.5,104085,50371,8946,8863
7407,19685,38.6,62457,29582,9525,10160
7410,32659,41.8,95808,42275,15679,16980
7416,5952,41.3,66793,29833,2929,3023
7417,10655,45.7,149671,82399,5383,5272
7418,2065,43.9,91458,43837,1133,932
7419,8800,44.4,77739,37872,4237,4563
7420,4517,41.9,79000,30769,1794,2723
7421,7072,42.9,89113,36258,3535,3537
7422,6308,40.7,84646,33897,3209,3099
7423,4109,41.4,165827,76235,2051,2058
7424,26416,41.7,75079,34610,12482,13934
7430,26042,42.8,100781,50148,12162,13880
7432,7180,41.7,81373,43757,3315,3865
7435,2267,41.4,96979,49447,1085,1182
7436,12830,40,117742,43755,6399,6431
7438,11566,41.2,102452,39683,5901,5665
7439,2399,42.2,77132,31699,1216,1183
7440,4862,42.7,91756,37722,2362,2500
7442,11126,39.8,92033,35734,5299,5827
7444,10675,47.8,84196,45600,4502,6173
7446,14570,43.4,120883,61666,7193,7377
7450,25175,41.1,142358,70085,12146,13029
7452,11699,41,160417,66241,5770,5929
7456,12273,41.7,103038,37960,6216,6057
7457,3798,37.7,84924,45715,1778,2020
7458,11420,44.6,161314,79871,5541,5879
7460,3543,39.9,89899,36257,1727,1816
7461,19416,42.1,84470,33599,9706,9710
7462,7130,35.6,77909,32487,3571,3559
7463,9704,41.3,108180,43127,4655,5049
7465,6625,47.7,95459,38957,3161,3464
7470,54849,43.2,103170,44665,26138,28711
7480,16881,43.9,99083,39694,8558,8323
7481,16807,44.1,142128,68209,8268,8539
7495,0,-666666666,-666666666,-666666666,0,0
7501,31509,30.8,24321,11594,15194,16315
7502,14685,34.3,52831,21388,7356,7329
7503,19960,31.7,36257,15965,9770,10190
7504,12866,34.8,49334,20000,5981,6885
7505,2376,36.8,28167,18666,1137,1239
7506,18868,41.1,79203,37538,8789,10079
7508,22671,39.2,71741,31730,11100,11571
7512,10833,45,80042,32965,5129,5704
7513,11903,33.7,43668,17260,5942,5961
7514,18738,34.5,34779,17392,8535,10203
7522,20869,29.3,26866,14210,9901,10968
7524,13014,28.9,30920,14521,6093,6921
7601,43466,39.5,54091,30736,21585,21881
7603,8231,38.7,77821,31670,4081,4150
7604,11896,43.5,90880,39224,5555,6341
7605,9060,41.9,78693,42345,4367,4693
7606,2371,39.4,68750,33300,1169,1202
7607,9609,41.3,86368,37214,4681,4928
7608,92,43.3,82321,30658,44,48
7620,1861,50.3,144063,98730,904,957
7621,26911,40.3,79745,33293,12746,14165
7624,8449,42.9,119606,50016,4020,4429
7626,8530,44.8,99306,55482,4090,4440
7627,4904,44.7,138631,67070,2409,2495
7628,17600,41.5,88480,36767,8400,9200
7630,7443,44.5,103558,38673,3414,4029
7631,27211,37.4,71503,43574,12627,14584
7632,5409,48.1,113802,61670,2491,2918
7640,4704,45.5,134057,58185,2369,2335
7641,3406,43.8,135781,56913,1733,1673
7642,10293,42.8,114097,44712,5060,5233
7643,10723,39.7,70520,32368,5446,5277
7644,24278,36.8,53167,26144,11488,12790
7645,7910,41.8,107662,49066,3929,3981
7646,16433,42.4,75414,36434,8002,8431
7647,5176,41.6,85306,35900,2537,2639
7648,5756,45.8,92357,44510,2920,2836
7649,8036,43.8,149871,60283,3765,4271
7650,19750,38.1,60342,30338,10429,9321
7652,26454,47.3,97395,42902,12895,13559
7656,8719,43.4,104651,48646,4051,4668
7657,11112,43.4,67500,30936,5151,5961
7660,12819,36.9,62388,30765,6119,6700
7661,11398,42.8,99556,42030,5542,5856
7662,5622,44.8,71240,35443,2840,2782
7663,13741,40.5,76535,36507,6646,7095
7666,39994,37.8,93463,39950,18362,21632
7670,14664,42.8,124591,74121,6990,7674
7675,26540,43.6,101924,50115,12267,14273
7676,9106,47.4,113148,54105,4392,4714
7677,5768,46,130302,62077,2898,2870
7701,23778,40.4,75012,41938,11684,12094
7702,3838,44.5,114797,52585,1884,1954
7703,387,24.5,79712,41149,219,168
7704,6108,42.1,141250,65740,2893,3215
7711,1364,49,131447,58148,683,681
7712,39099,39.1,53160,33777,18668,20431
7716,8901,41.2,84428,40917,4185,4716
7717,1941,52.2,68856,54648,885,1056
7718,6143,40.5,87398,36267,2833,3310
7719,21769,43.3,79312,42666,10612,11157
7720,4298,42,67065,40009,2243,2055
7721,2998,37.1,79375,32613,1512,1486
7722,10146,43.2,136184,65627,5159,4987
7723,1160,47.5,81875,53128,654,506
7724,21758,41.7,78064,39958,10210,11548
7726,42520,41.9,105943,44667,20369,22151
7727,6851,42,72418,43796,3467,3384
7728,56270,40.7,84190,37994,28467,27803
7730,17374,44.1,87430,34867,8684,8690
7731,38382,37.5,98125,35020,19193,19189
7732,5112,45.1,66903,45991,2727,2385
7733,16583,45.7,125149,64998,8144,8439
7734,13217,39.2,50113,26041,6223,6994
7735,19800,39.3,67832,29745,9596,10204
7737,3966,43.5,77996,37007,1873,2093
7738,6363,44.5,127870,52018,3130,3233
7739,5939,43.1,134406,63455,2838,3101
7740,30879,35,49482,29145,15471,15408
7746,19724,42.5,140759,54008,9797,9927
7747,30332,41.4,94328,42652,14708,15624
7748,27398,42.8,109097,47651,13397,14001
7750,3280,49.5,83589,67365,1498,1782
7751,19014,40.9,138025,53813,8990,10024
7753,37041,44.1,61067,32416,16693,20348
7755,6618,40.7,88678,38428,3042,3576
7756,3242,49.4,58013,43119,1351,1891
7757,5575,45,94861,48174,3019,2556
7758,5631,41.2,91298,36013,2719,2912
7760,9141,43.9,126050,76678,4639,4502
7762,8401,51,73986,52620,4103,4298
7764,8317,39.2,85417,34071,3900,4417
7801,26118,35,62992,25642,13702,12416
7803,3663,39.4,91979,37709,1680,1983
7820,0,-666666666,-666666666,-666666666,0,0
7821,9590,43.1,105506,44494,4830,4760
7822,808,43.6,100718,41315,494,314
7823,7546,50.6,52706,31299,3674,3872
7825,9641,46.2,87724,38306,4944,4697
7826,6385,46.9,87835,38332,3175,3210
7827,4297,45.1,62045,28963,2256,2041
7828,14184,38.1,75631,37734,7084,7100
7830,6480,43.3,133750,55895,3130,3350
7832,3718,48.1,84079,40128,1836,1882
7833,80,44.5,139375,51178,50,30
7834,17742,44.2,105597,51155,8634,9108
7836,13390,40.2,100529,43045,7033,6357
7838,3907,35.8,85313,32595,1974,1933
7840,29527,39.4,74980,36496,14082,15445
7842,116,35,160644,56801,49,67
7843,12241,40.1,85400,37372,6016,6225
7846,93,31.3,74643,38347,51,42
7847,1303,46.8,80455,34114,585,718
7848,4675,46.3,94386,36582,2297,2378
7849,9101,38.6,90505,37788,4747,4354
7850,7361,39.3,93633,34587,3834,3527
7851,74,37.7,50781,19720,48,26
7852,3863,39.7,93065,41637,1710,2153
7853,12876,43.7,137583,58685,6337,6539
7856,3557,54.7,81330,48557,1466,2091
7857,3303,43.2,51398,30293,1614,1689
7860,26490,43.2,77878,35569,12833,13657
7863,4366,44.7,75288,32219,2201,2165
7865,2102,43.1,92802,38761,1077,1025
7866,21588,42.8,98939,44395,10623,10965
7869,25385,39,121524,55883,12486,12899
7870,0,-666666666,-666666666,-666666666,0,0
7871,20858,41.4,124718,50842,10552,10306
7874,8568,41.8,93777,38023,4106,4462
7876,10159,44.3,117473,43739,5127,5032
7878,918,46.8,120647,47136,494,424
7880,73,51,-666666666,41401,38,35
7881,6,84.5,-666666666,16833,2,4
7882,14545,41,75824,34583,6981,7564
7885,10174,40.5,79732,33995,5148,5026
7901,22874,39.9,124080,77664,11393,11481
7920,26397,42.9,125837,67423,12603,13794
7921,7945,47.2,93367,64636,3551,4394
7922,12200,43.4,133569,58349,5974,6226
7924,7658,39.2,106705,63960,4271,3387
7926,97,91.5,24435,28849,49,48
7927,3466,41.9,101125,53593,1786,1680
7928,19140,40.4,142703,76732,9092,10048
7930,8385,43.5,149241,67318,4039,4346
7931,3545,48.4,188452,117705,1747,1798
7932,10601,43.8,106512,57659,4773,5828
7933,3465,41.5,103846,45446,1908,1557
7934,1547,43.5,163618,89784,727,820
7935,486,44.5,117917,58244,240,246
7936,11236,45.6,106951,47087,5344,5892
7939,314,58,-666666666,9574,275,39
7940,16915,36.7,110145,54837,8186,8729
7945,9711,45,148026,69063,4694,5017
7946,3109,43.3,131042,60678,1546,1563
7950,19719,42.4,104509,50704,9762,9957
7960,43760,41.5,100832,59727,21066,22694
7961,0,-666666666,-666666666,-666666666,0,0
7970,137,46,250001,171634,57,80
7974,12054,41.9,138519,55681,6011,6043
7976,652,43.3,217115,64193,318,334
7977,611,46.8,130172,43678,313,298
7979,608,45.4,170466,62598,318,290
7980,2175,46.6,100448,47585,1189,986
7981,9246,43.3,106250,42473,4547,4699
8001,1064,27.3,106800,28290,469,595
8002,22025,39.7,68465,34026,10110,11915
8003,30845,44.1,109752,52075,15162,15683
8004,12412,37.3,70661,28652,6408,6004
8005,22428,45.6,63295,30369,10577,11851
8006,563,59,77727,46202,274,289
8007,5416,39.6,63500,29750,2481,2935
8008,6926,61.5,73094,57928,3285,3641
8009,12470,41.2,77404,35723,5966,6504
8010,11517,41.3,59694,27034,5562,5955
8011,80,49.3,174063,47114,49,31
8012,39703,38.7,70982,30112,19214,20489
8014,594,24.2,66818,21329,303,291
8015,20645,36.9,62002,26086,10734,9911
8016,33162,39.3,71879,30888,15828,17334
8019,1031,40,80804,34839,580,451
8020,2505,41.9,91005,39012,1117,1388
8021,45145,35.4,48327,25650,21773,23372
8022,8962,46.1,87353,42791,4460,4502
8023,464,36.6,48958,23720,170,294
8026,2273,44.4,82955,34981,1103,1170
8027,4860,45,65692,33563,2272,2588
8028,20121,27.9,63353,24492,9757,10364
8029,4859,43.5,62600,29968,2329,2530
8030,13193,36.6,50486,24037,6458,6735
8031,11558,40.4,54245,24164,5531,6027
8033,15845,43.2,103516,52665,7822,8023
8034,18187,44.1,86859,40271,8863,9324
8035,7567,42.9,86907,42843,3685,3882
8036,5794,45.1,88962,36945,2816,2978
8037,23669,43.6,63658,29184,12078,11591
8038,107,36.1,54107,28579,59,48
8039,55,37.3,69688,32471,18,37
8041,1229,41.8,102566,37378,662,567
8042,83,59.3,79375,37107,38,45
8043,29261,43.2,80471,44415,13924,15337
8045,2934,41.4,55984,24812,1289,1645
8046,31731,41.5,67593,27291,14321,17410
8048,12516,38.5,84459,38015,6041,6475
8049,5613,40.3,59846,26528,2865,2748
8050,24629,43.7,72969,33123,11933,12696
8051,10924,40.3,66317,34835,5044,5880
8052,19197,36.5,58545,29104,9293,9904
8053,45663,40.1,92344,41554,22323,23340
8054,41848,42.9,86363,45682,18924,22924
8055,27280,43.4,108036,48426,13466,13814
8056,4437,39.1,123029,43611,2135,2302
8057,20827,44.6,110647,62978,9962,10865
8059,5684,40.9,71563,34141,2782,2902
8060,24648,36.9,77141,34585,11657,12991
8061,2876,31.4,103819,38345,1324,1552
8062,15762,39.2,116964,43169,7799,7963
8063,3120,36.7,61875,25257,1459,1661
8064,171,79.5,-666666666,9578,44,127
8065,7401,42,63598,34005,3449,3952
8066,8484,35.6,45717,23813,3880,4604
8067,1833,43.2,74219,32212,870,963
8068,6943,40.9,57662,30343,3297,3646
8069,12994,37.4,44029,22557,6328,6666
8070,12953,43.9,56377,31466,6264,6689
8071,9685,41.9,71307,32802,4602,5083
8072,162,54.7,64286,28617,88,74
8073,262,55.5,182716,58279,108,154
8074,15,26.5,-666666666,6707,5,10
8075,29311,39,76111,32707,14528,14783
8077,18748,45.6,94407,40528,9151,9597
8078,8436,34.9,56036,25140,4126,4310
8079,10812,39.1,46071,24341,4973,5839
8080,35672,43.4,89488,38252,17353,18319
8081,50784,35.7,79746,31468,24210,26574
8083,9559,40.3,57188,27575,4298,5261
8084,7015,40.7,65974,30016,3518,3497
8085,19033,35.3,98854,36825,9431,9602
8086,7378,42.3,68497,33967,3593,3785
8087,24104,45,57308,29088,11638,12466
8088,24380,47.2,71089,37235,12277,12103
8089,4332,45.2,71538,31268,2261,2071
8090,8924,39.3,83086,32391,4542,4382
8091,5361,39.6,65976,26970,2537,2824
8092,3446,47,65469,31080,1660,1786
8093,10576,36.7,57950,27565,4962,5614
8094,39747,38.9,69499,29278,19604,20143
8095,180,38.6,43696,34185,110,70
8096,35116,39.6,67578,31462,17394,17722
8097,3197,45.9,85188,34069,1593,1604
8098,9129,42.6,76274,34582,4444,4685
8102,7382,27.4,18696,11911,3707,3675
8103,14646,30.1,21888,12659,7575,7071
8104,24364,26.4,24250,12630,10215,14149
8105,29369,30.1,31430,14333,14559,14810
8106,9907,42.2,69658,33849,4681,5226
8107,13910,38,56135,28795,6557,7353
8108,17826,41,72429,37928,8763,9063
8109,22814,40.5,63821,31392,11191,11623
8110,18502,36.4,49747,21396,9458,9044
8201,10234,42.9,57822,27630,5145,5089
8202,2018,62,76071,67884,1071,947
8203,9480,50.2,64516,38205,4608,4872
8204,18543,47.3,56421,30955,8947,9596
8205,27385,39.8,62856,27578,12796,14589
8210,17570,46.3,66610,31664,8677,8893
8212,170,67.8,65833,50789,80,90
8215,13962,39.4,56932,26630,7153,6809
8217,72,66.5,-666666666,1865,48,24
8221,7099,46.1,88214,43840,3527,3572
8223,3851,49.3,70625,35360,1990,1861
8224,669,40.6,62798,24342,305,364
8225,8649,42.9,65511,32278,4156,4493
8226,11640,53.1,57970,40990,5439,6201
8230,5633,48.3,76563,35719,2688,2945
8232,19238,35.4,37330,17268,8870,10368
8234,42491,39.3,71316,29387,20759,21732
8240,3233,20.4,-666666666,3844,1277,1956
8241,1010,50.6,83750,39881,512,498
8242,3003,44.5,50000,29084,1604,1399
8243,1861,60.9,56788,42953,980,881
8244,11001,39.1,48220,26817,4998,6003
8246,158,59.9,145174,57773,79,79
8247,760,62.3,66250,70215,355,405
8248,36,59.4,-666666666,153647,13,23
8251,9708,41.1,44513,24983,4643,5065
8260,13690,49.8,45230,30035,6539,7151
8270,8778,39.3,69083,26193,4403,4375
8302,47895,34.4,49654,19476,26318,21577
8310,2055,53.1,39479,25181,1036,1019
8311,2155,41.6,65968,28316,1152,1003
8312,7787,38.9,62980,26606,3668,4119
8314,2986,35.1,69330,8511,2695,291
8316,324,49.7,55313,26036,135,189
8317,1446,42.7,83409,34503,722,724
8318,12223,42.9,73902,31538,6145,6078
8319,1275,42.4,68750,27937,655,620
8320,0,-666666666,-666666666,-666666666,0,0
8321,101,66.4,41250,37128,60,41
8322,10204,39.5,81983,34718,5048,5156
8323,1005,45.5,70469,33818,491,514
8324,670,42.5,67772,28069,330,340
8326,1586,33.7,59397,22387,897,689
8327,2180,36.9,66033,11328,1975,205
8328,1697,42.1,57857,24449,719,978
8329,192,47,54750,43084,77,115
8330,28371,38,58732,26495,13895,14476
8332,36592,37.9,48750,23904,17572,19020
8340,716,42,100250,39030,333,383
8341,2205,39,36836,24040,882,1323
8343,5267,41.7,86268,31273,2760,2507
8344,5854,41.1,57269,25477,2581,3273
8345,819,50,40938,22063,376,443
8346,1252,36.7,38571,14113,640,612
8348,521,33.4,52950,34998,220,301
8349,2713,31,48503,22107,1556,1157
8350,853,47.1,54138,22676,471,382
8352,591,44.1,73542,23559,339,252
8353,593,39.2,82969,30248,289,304
8360,43402,36.3,47454,22250,20858,22544
8361,18006,43,71984,32072,8645,9361
8401,39591,35.5,29200,18610,19241,20350
8402,6385,57.7,64414,55610,2835,3550
8403,1066,63,77578,68737,515,551
8406,10681,47.3,53609,33782,5326,5355
8501,6404,46,109402,47083,3046,3358
8502,11628,39.3,157661,59158,5781,5847
8505,17223,40.5,87181,39290,8458,8765
8510,4911,45.8,125372,49375,2161,2750
8511,956,35.5,90221,34942,463,493
8512,10438,42.1,84864,48430,5037,5401
8514,4530,40.7,93106,40082,2066,2464
8515,7100,28.5,117355,34756,4593,2507
13788,1018,47.6,55000,26515,509,509
13790,18577,39.9,39518,22493,9019,9558
13794,130,56.2,60476,22865,66,64
13795,3664,44.4,51604,30091,1735,1929
13796,1285,45.3,52950,20713,622,663
13797,2029,39.1,45929,20975,962,1067
13801,1264,44.1,45625,20545,694,570
13802,660,29,58854,21284,324,336
13803,4128,36.5,51593,24864,2056,2072
13804,620,33.8,60192,20615,279,341
13806,187,52.7,59444,26996,105,82
13807,1067,45.7,47917,29919,509,558
13808,1502,53.4,49750,29139,769,733
13809,1637,35.5,36875,19507,799,838
13810,1020,50.9,40083,23337,511,509
13811,4327,45.4,45057,24900,2130,2197
13812,2333,40.7,50547,23405,1188,1145
13813,1051,50.9,50823,19428,550,501
13815,14053,41.4,39818,21355,6736,7317
13820,22820,26.8,42345,21484,10933,11887
13825,3505,46.1,52750,27728,1623,1882
13826,0,-666666666,-666666666,-666666666,0,0
13827,11795,44.2,56025,28315,5951,5844
13830,4899,45.5,53304,22571,2462,2437
13832,510,46.9,35000,20483,256,254
13833,3915,43.5,51976,24879,1910,2005
13834,57,42.8,2499,9535,46,11
13835,1404,41.8,48333,23473,713,691
13838,4417,42.8,38482,21851,2262,2155
13839,1285,48.1,50481,21834,699,586
13841,639,41.7,33750,16497,290,349
13842,644,36.3,79219,21348,353,291
13843,1790,43.1,48393,22889,874,916
13844,885,40.1,48026,18461,524,361
13845,58,-666666666,-666666666,,39,19
13846,267,41.9,76250,34601,142,125
13847,67,50.1,25833,12070,28,39
13849,3968,43.1,42861,23219,2002,1966
13850,21914,45.9,62061,33915,10045,11869
13856,6658,44.1,38730,20727,3246,3412
13859,275,6,73468,17995,200,75
13860,80,21.4,-666666666,19910,39,41
13861,349,37.8,43631,21668,154,195
13862,4336,41.4,50036,23075,2121,2215
13863,761,33.3,41731,18902,398,363
13864,1121,48.7,65613,29949,554,567
13865,6442,43.3,51236,24108,3510,2932
13901,19186,41.1,41344,25517,9442,9744
13902,6151,19.7,-666666666,2467,3090,3061
13903,18737,41.6,44267,26572,9223,9514
13904,9436,41.1,40985,21934,4652,4784
13905,27708,35.9,34520,20867,14422,13286
14001,9866,44,54052,26092,5119,4747
14004,12146,44.1,56163,23546,6631,5515
14005,2118,39,57409,24407,1035,1083
14006,9282,42.9,58511,27614,4449,4833
14008,1545,43.4,46889,26891,735,810
14009,5549,43.8,46287,24217,2800,2749
14011,9952,38.1,61196,17648,6718,3234
14012,2400,43.5,52188,20513,1101,1299
14013,1664,47.8,42663,21244,826,838
14020,23208,41.2,42809,25154,11364,11844
14024,1752,38.4,50577,21344,874,878
14025,3390,42.3,67326,31776,2001,1389
14026,778,40.8,64792,37547,407,371
14028,1322,45.6,53750,25929,661,661
14030,1661,45.3,66750,27617,855,806
14031,9911,47.2,68137,42333,4768,5143
14032,7623,41.7,94092,39517,3798,3825
14033,2170,44.3,81979,32764,942,1228
14034,2978,43.1,58224,17577,2088,890
14035,215,27.6,44615,25899,150,65
14036,5256,43.6,49276,28208,2629,2627
14037,928,47.8,74063,29906,460,468
14039,87,39.1,44583,27530,46,41
14040,2259,42.8,59716,25231,1138,1121
14041,315,43.2,40000,15788,154,161
14042,3834,36.8,32740,19828,1912,1922
14043,24139,41.1,49369,25587,11655,12484
14047,6878,40.5,65554,28398,3367,3511
14048,15043,41.2,39566,21896,7394,7649
14051,19795,43.1,101660,47077,9962,9833
14052,17137,45.6,71278,35380,8308,8829
14054,1280,43.1,48250,24261,668,612
14055,1534,43.8,50673,25226,778,756
14057,8080,47.2,61292,27560,4003,4077
14058,2235,38.4,67069,26998,1161,1074
14059,9619,50.3,75511,35370,4784,4835
14060,599,48.7,46842,22163,310,289
14061,300,39.5,58523,21592,152,148
14062,3166,43.8,50745,23211,1681,1485
14063,14627,30.7,47982,22667,7166,7461
14065,1792,44,40848,19139,924,868
14066,1188,41,46060,22293,645,543
14067,5472,42.4,53009,25492,2779,2693
14068,7289,47.8,71452,35615,3254,4035
14069,763,52.2,62768,32402,435,328
14070,6078,44.2,45192,19695,3627,2451
14072,20469,43.8,80243,35192,9845,10624
14075,43007,42.8,62497,31531,20552,22455
14080,4564,43.9,61569,29754,2350,2214
14081,3081,47.9,52583,28433,1532,1549
14082,302,46.1,45104,26736,122,180
14085,6988,40.7,86092,35935,3710,3278
14086,31920,42,75819,33609,15736,16184
14091,1138,47.7,48750,21656,573,565
14092,11342,49.4,60689,34329,5386,5956
14094,50807,41.2,49849,26124,24685,26122
14098,3107,46.1,54543,25430,1551,1556
14101,2098,41.5,51250,19733,1049,1049
14102,1647,38.2,89722,33414,820,827
14103,10886,38.8,43478,21792,5265,5621
14105,4058,41.3,56474,26209,2098,1960
14108,5507,43.6,57349,28570,2884,2623
14109,827,19.4,-666666666,3843,266,561
14111,3498,40.4,56413,24079,1835,1663
14112,8,-666666666,-666666666,,4,4
14113,630,45.6,47500,33149,307,323
14120,44334,42.4,52587,28764,21372,22962
14125,3751,37,49356,23018,1860,1891
14126,682,47.8,43438,24436,350,332
14127,29940,44.7,77636,41979,14483,15457
14129,1529,41,50417,22923,751,778
14130,241,32.9,46875,19808,124,117
14131,4756,47.9,57500,27970,2457,2299
14132,6859,37.5,59286,26479,3248,3611
14134,125,34.9,56786,15557,44,81
14135,137,32.9,40764,22072,72,65
14136,5252,39.9,43914,22914,2477,2775
14138,2073,35,46250,20276,984,1089
14139,1983,45.8,54593,29457,943,1040
14141,7501,44.5,51310,26738,3711,3790
14143,1200,43.5,53185,25386,595,605
14145,1507,43.4,56938,24847,737,770
14150,42279,43.9,51852,26649,19888,22391
14167,1730,40.2,52888,24678,967,763
14168,104,16.7,44464,14748,41,63
14169,344,31,22301,17648,174,170
14170,2374,46.6,62396,31894,1232,1142
14171,2062,47.2,43793,22575,991,1071
14172,3246,47.1,58750,27435,1660,1586
14173,217,47.9,30481,22418,135,82
14174,5956,46.3,64554,35179,2994,2962
14201,12802,30.3,21594,17517,6479,6323
14202,3741,36.1,40525,40853,2204,1537
14203,1415,35.7,26667,23272,738,677
14204,9235,39.1,23259,18305,4102,5133
14206,22106,39.8,34293,19515,10543,11563
14207,22312,31.9,26630,16054,11188,11124
14208,11492,31.1,24809,13720,4820,6672
14209,8679,34.1,30086,28398,3899,4780
14210,13508,37.7,32197,19265,6556,6952
14211,21545,32,20983,13709,9681,11864
14212,10599,35.7,25660,15109,5249,5350
14213,24134,29.7,25939,15062,12049,12085
14214,19760,32,38698,23921,9907,9853
14215,38980,30.9,31048,17809,17164,21816
14216,22541,38.9,45764,31491,10424,12117
14217,22936,42.2,50254,28939,10947,11989
14218,18805,42.3,36362,22324,9125,9680
14219,10888,43.5,48952,24510,5253,5635
14220,24105,39.7,45831,23617,11409,12696
14221,53475,46.7,75189,40286,24867,28608
14222,15170,29.6,52073,33410,7718,7452
14223,22713,41.3,57076,27398,10975,11738
14224,40074,45,57375,28607,19158,20916
14225,33075,40.8,45279,23970,15541,17534
14226,28827,39.3,60545,35385,13861,14966
14227,22915,47.8,49821,27563,10788,12127
14228,21467,33.1,47801,29131,10633,10834
14261,5600,19.8,-666666666,3570,2655,2945
14301,12643,39.6,21945,17110,6274,6369
14302,49,82.9,-666666666,17349,16,33
14303,5554,41.4,27567,19930,2717,2837
14304,29745,44.7,47878,25791,14739,15006
14305,17691,34.9,34085,19362,7819,9872
14411,14257,39.9,42967,18461,7219,7038
14414,7109,38.8,63083,28053,3763,3346
14415,75,56.1,31765,18291,29,46
14416,3583,42.9,58750,25043,1927,1656
14418,1118,51,50156,22899,591,527
14420,20706,30.6,54643,22887,9532,11174
14422,2490,42.3,64286,27161,1246,1244
14423,4889,43.9,54665,26515,2465,2424
14424,26567,44.7,53231,31461,12839,13728
14425,11051,35.7,58496,26663,5306,5745
14427,2136,40.6,49922,22800,1022,1114
14428,8371,46.2,59587,31415,4287,4084
14432,5850,43.9,53819,28519,2910,2940
14433,4201,41.9,44688,21245,2173,2028
14435,2912,43,63250,31593,1482,1430
14437,11201,43.4,42938,19703,6391,4810
14441,384,39.5,45313,21829,218,166
14445,8006,37.5,49683,25366,4051,3955
14450,41211,43.6,76552,39413,19662,21549
14454,11153,21.7,51625,19381,4787,6366
14456,20132,35.9,48158,23780,9809,10323
14462,578,42.4,50677,23346,311,267
14464,7117,38.9,62783,25609,3489,3628
14466,1734,45.4,67365,30579,772,962
14467,9925,40,65649,30156,4922,5003
14468,18325,43.3,64802,27403,9478,8847
14469,6166,45.6,61694,34282,3049,3117
14470,7871,43.7,51918,26404,3824,4047
14471,2675,51.8,53939,28420,1273,1402
14472,8289,44,91477,45099,4528,3761
14475,263,43.6,72708,31161,114,149
14476,2266,45.4,59179,26897,1087,1179
14477,2137,42.9,54375,25363,1102,1035
14478,1478,21.4,49417,17181,570,908
14479,368,35.1,47143,23403,155,213
14480,822,26.4,45865,19017,396,426
14481,1912,45.1,57071,25185,1002,910
14482,8382,42.2,55470,27228,4158,4224
14485,4454,40.7,44316,24122,2052,2402
14486,293,34.8,51250,36745,138,155
14487,5936,42.4,67542,31377,2989,2947
14489,7356,43.4,42778,22165,3419,3937
14502,10586,40.2,65601,28900,5104,5482
14504,1582,45.3,52566,25437,697,885
14505,5187,44,60000,26264,2554,2633
14506,1371,40.8,96538,42763,647,724
14507,1285,48.6,55625,25537,629,656
14510,4815,44.1,43750,19463,2245,2570
14511,351,53.3,44609,28684,172,179
14512,4855,45.5,50682,29209,2461,2394
14513,13905,42.3,45583,22939,6639,7266
14514,6218,40.5,63798,28782,3053,3165
14516,2254,40.1,54779,23257,1153,1101
14517,2878,40.1,39970,21001,1479,1399
14519,11484,43.5,63538,30108,5727,5757
14521,2806,37.3,44907,19597,1630,1176
14522,9486,43.8,50612,24645,4674,4812
14525,2670,42.9,63179,24755,1310,1360
14526,20229,42.7,77386,38273,9619,10610
14527,12990,41.4,47697,24971,6359,6631
14529,108,63.2,44688,34027,52,56
14530,5434,42,48153,23552,2859,2575
14532,4328,43.7,52500,26769,2212,2116
14533,1717,44.5,56058,28736,884,833
14534,32537,45.9,106113,55041,15710,16827
14536,578,45.8,44688,24257,256,322
14537,164,55.9,62045,31418,53,111
14539,143,48.4,80625,31461,64,79
14541,4610,34.5,59740,16195,3139,1471
14542,41,53.6,54028,45059,27,14
14543,3073,48.3,86875,42409,1468,1605
14544,2420,41.8,58558,24110,1199,1221
14545,174,40.5,58750,22998,88,86
14546,4955,41.9,57295,27485,2456,2499
14548,4496,43,62031,24837,2313,2183
14549,42,51.6,-666666666,20693,26,16
14550,1714,39.9,62951,27371,849,865
14551,5630,41.1,47239,22114,2830,2800
14555,1229,54.9,57500,30559,636,593
14559,18098,41.7,69564,29969,8919,9179
14560,1819,46.9,56858,31347,943,876
14561,3264,41.4,60578,25378,1583,1681
14564,14497,42.9,76231,40149,7085,7412
14568,6203,37.1,76042,27403,2992,3211
14569,6187,42.1,42313,22107,2797,3390
14571,1181,49.4,54659,27669,616,565
14572,5304,38.8,42660,21184,2578,2726
14580,50559,42.3,69189,33860,24235,26324
14585,67,75.5,29063,27045,24,43
14586,10755,32.9,70027,26039,5307,5448
14588,269,34.4,35000,7936,251,18
14589,7713,45.1,55558,30329,3755,3958
14590,5020,42.6,42439,23270,2566,2454
14591,1701,43.6,62768,27194,879,822
14592,224,36.3,83911,29470,119,105
14604,1607,40.5,11830,18466,826,781
14605,13584,25.3,18569,10259,6349,7235
14606,29551,36.4,38545,19604,13629,15922
14607,16144,29.2,40502,35395,8276,7868
14608,12058,31.3,20796,14214,5480,6578
14609,42628,33.4,42123,20957,20486,22142
14610,13655,44.2,56629,46654,6583,7072
14611,17573,31.7,24664,13430,8099,9474
14612,35070,42.4,59216,30541,17079,17991
14613,13112,30.1,28425,15326,6102,7010
14614,1105,32,3906,4699,1016,89
14615,15776,35,38620,21466,7761,8015
14616,28688,42,48975,25767,13395,15293
14617,23124,42.4,60650,30632,10932,12192
14618,22110,39.9,81902,44668,10482,11628
14619,14784,32.9,39494,18927,6857,7927
14620,26110,31.3,38554,25106,12507,13603
14621,33789,32.9,23735,13894,16089,17700
14622,12040,45.7,51875,29960,5624,6416
14623,25877,26.2,46149,19676,14089,11788
14624,36097,40.9,61136,28265,17367,18730
14625,10484,46.4,70114,41145,5063,5421
14626,29724,46.5,53944,30041,13854,15870
14627,2781,19.5,-666666666,3734,1424,1357
14701,40048,39.9,35997,20735,19408,20640
14706,6301,44.6,50647,26461,2921,3380
14707,289,32.5,27429,18130,168,121
14708,273,38.2,43333,20162,125,148
14709,1514,44.1,43173,20471,763,751
14710,3479,44.7,51156,25234,1727,1752
14711,1835,39.8,41000,18737,945,890
14712,3586,48.6,57931,29503,1682,1904
14714,572,34.2,40750,19560,279,293
14715,2763,40.2,45030,22257,1349,1414
14716,3040,35.3,35708,16790,1857,1183
14717,683,45.5,38333,20262,411,272
14718,2320,39.9,57813,22523,1246,1074
14719,3530,44.7,43036,21235,1774,1756
14720,724,26.9,40125,20662,398,326
14721,104,28.5,25227,15429,60,44
14722,407,66.2,73594,25667,204,203
14723,1193,43.3,44861,21465,628,565
14724,2465,41,45667,21713,1240,1225
14726,2155,26.1,41336,13800,1051,1104
14727,5090,45.3,48077,26791,2646,2444
14728,729,42.9,62736,25902,400,329
14729,902,42.7,52961,26749,482,420
14731,1302,51,54625,34860,699,603
14732,157,53.7,52917,21879,85,72
14733,4216,36.9,42891,18789,2191,2025
14735,2626,39.9,38278,19585,1321,1305
14736,150,56.3,34107,23133,75,75
14737,3998,41.9,37113,20976,1979,2019
14738,3700,46.4,47956,23302,1856,1844
14739,2636,40.5,38872,18317,1368,1268
14740,1639,47.3,49345,25020,754,885
14741,2412,38.7,55966,23967,1185,1227
14742,247,79.2,67083,23487,95,152
14743,1896,36.5,42799,17667,974,922
14744,2310,20.9,50298,13415,1098,1212
14747,2192,45.9,43482,21985,1189,1003
14748,851,35,31667,15684,383,468
14750,4448,42.6,53176,31548,2117,2331
14752,174,61.8,44167,33150,42,132
14753,978,41.7,32708,17519,492,486
14754,666,44.9,43750,20342,314,352
14755,3268,39.4,46037,21427,1697,1571
14756,105,61.2,-666666666,11879,9,96
14757,3496,41,44698,28505,1842,1654
14760,18523,41.6,41807,24604,9285,9238
14767,1927,36.6,42986,17534,936,991
14769,1017,52,48977,21366,500,517
14770,2896,43.3,50816,25116,1543,1353
14772,3945,40.3,43494,19892,2012,1933
14774,260,22.9,31103,17153,122,138
14775,2294,36,40769,19469,1199,1095
14777,654,48.7,47917,23558,314,340
14778,1451,20.2,-666666666,3246,681,770
14779,6633,40.5,31537,18587,3219,3414
14781,2437,37.8,48452,19209,1234,1203
14782,2762,33.5,44926,17136,1326,1436
14783,373,42.7,43250,22446,186,187
14784,708,46.6,29583,17717,385,323
14787,5074,49.2,42455,22177,2241,2833
14788,232,28,75972,30066,87,145
14801,5525,40.1,45810,21704,2766,2759
14802,4324,19.9,19018,7374,2517,1807
14803,917,42.5,49375,27464,460,457
14804,1636,42.7,61875,26943,838,798
14805,1026,42.8,53750,23923,510,516
14806,2161,41.6,49792,22379,1069,1092
14807,3088,48,45821,23042,1601,1487
14808,438,51.5,36250,18879,248,190
14809,2345,43.9,42902,22838,1215,1130
14810,12516,44.8,43750,22745,6405,6111
14812,3339,39.1,56211,22273,1849,1490
14813,2685,42.9,44223,21596,1439,1246
14814,2165,41.8,72667,31301,1030,1135
14815,1034,42.6,47500,21544,485,549
14816,293,47.6,49583,21334,123,170
14817,2261,49.4,59618,33218,1147,1114
14818,1836,42.3,45208,26437,885,951
14819,822,37.6,38854,16627,498,324
14820,631,44,41534,19916,321,310
14821,3218,38.4,47500,23696,1614,1604
14822,1391,36.7,35708,18933,723,668
14823,3639,41.4,49868,23168,1884,1755
14824,787,47.8,74650,29946,379,408
14825,1032,46.3,56481,22731,517,515
14826,2148,45.7,46902,23866,1034,1114
14827,100,29.2,24250,13955,29,71
14830,19734,40.2,51902,30447,9648,10086
14836,1124,49.2,51728,23810,538,586
14837,5661,39.1,44318,22443,2779,2882
14838,2010,41.8,55045,24263,1063,947
14839,750,38.4,48667,19427,357,393
14840,3157,51.2,51893,34122,1583,1574
14841,973,49.1,58538,27166,508,465
14842,987,44.8,79009,44736,540,447
14843,12919,40.3,40638,22707,6366,6553
14845,20838,45.1,61005,31716,10090,10748
14846,789,45.5,42198,24207,441,348
14847,2276,44,48080,26236,1085,1191
14850,64877,26.2,46331,27096,31695,33182
14853,2781,19.6,-666666666,2484,1382,1399
14854,17,-666666666,-666666666,,8,9
14855,988,29.3,43750,15913,421,567
14856,134,68.2,48362,29383,59,75
14858,1692,38.5,49554,22249,767,925
14859,913,46.7,39444,20609,412,501
14860,1236,39.5,53750,21245,637,599
14861,1244,50.9,47083,27574,682,562
14864,1131,46,53650,25630,577,554
14865,2582,50.9,38839,20843,1188,1394
14867,5722,35.7,49464,23865,2999,2723
14869,1383,41.9,52125,22418,671,712
14870,10366,41.1,59469,32694,5039,5327
14871,5419,47.1,64468,26136,3056,2363
14872,798,36.3,34258,19077,396,402
14873,2652,42.4,48897,23000,1389,1263
14874,265,54.8,43250,21254,138,127
14877,411,47.4,40682,26716,210,201
14878,683,44.3,65909,31629,325,358
14879,2105,43.6,45119,23827,1021,1084
14880,1488,49.6,42130,25207,714,774
14881,71,80.5,14803,15432,0,71
14882,3867,46.3,76929,43687,1910,1957
14883,4379,40.3,48929,23149,2208,2171
14884,199,54.8,51000,29278,105,94
14885,980,39.7,37000,16782,459,521
14886,6626,42.9,62900,31034,3262,3364
14889,1549,40.8,50000,22675,768,781
14891,4473,43.6,44448,25402,2167,2306
14892,8074,41.3,49623,26191,3885,4189
14893,11,64.8,-666666666,28964,6,5
14894,1337,42.2,40417,21631,674,663
14895,9692,44,38778,24085,4458,5234
14897,853,48.1,41905,19259,465,388
14898,2083,33,38472,14142,989,1094
14901,17495,34,28844,14781,9467,8028
14903,6943,39.7,45000,26194,3354,3589
14904,15519,37.5,36250,19429,7270,8249
14905,9255,42.4,59159,39927,4348,4907
15001,32573,45.2,51424,27566,15776,16797
15003,11613,42.5,35798,21937,5535,6078
15004,211,51.2,37284,30069,128,83
15005,9659,45.2,62584,32484,4764,4895
15006,329,46.2,50114,20336,167,162
15007,334,50.9,73352,28201,174,160
15009,15236,47.9,54833,30290,7319,7917
15010,28115,42.2,47993,26218,13586,14529
15012,16060,47,51884,26770,7752,8308
15014,3184,42.7,43500,22766,1438,1746
15015,1225,48.2,106875,52656,627,598
15017,15518,41.9,59715,38217,7426,8092
15018,668,44.1,50588,20773,319,349
15019,1892,49.1,49050,24822,865,1027
15020,152,43.1,27250,22373,88,64
15021,7662,45.3,51824,25193,3777,3885
15022,10181,43.7,40956,22045,4564,5617
15024,8541,48,53686,30717,3938,4603
15025,16089,43.2,49548,32020,7566,8523
15026,3116,49,62639,32590,1601,1515
15027,2082,44.1,42742,22111,965,1117
15028,130,56.5,52500,23771,64,66
15030,1040,41.4,34792,22485,535,505
15031,554,35.7,50259,25571,410,144
15033,4978,41.2,31107,16355,2314,2664
15034,1838,49.3,41786,25305,892,946
15035,2222,41.6,40104,22558,1014,1208
15037,11037,47.6,55980,27610,5285,5752
15038,309,38.8,26758,10016,175,134
15042,8068,47.5,53697,25396,3850,4218
15043,2680,42.8,65625,26726,1341,1339
15044,26934,44.4,93210,45246,13025,13909
15045,4481,41.1,33611,19027,2262,2219
15046,2628,46.8,56071,32491,1309,1319
15047,0,-666666666,-666666666,-666666666,0,0
15049,954,49.2,43491,25218,440,514
15050,2285,43.4,53587,23613,1095,1190
15051,359,57.9,51023,40495,148,211
15052,3451,43.4,53333,23958,1715,1736
15053,217,28.5,32857,14614,117,100
15054,423,51.3,54620,22034,246,177
15055,1201,46.4,54918,39367,541,660
15056,1136,46.6,38889,26291,507,629
15057,14946,41.2,69042,33047,7378,7568
15059,4231,45.5,35707,21080,1845,2386
15060,798,40,51442,20051,331,467
15061,12339,43.3,54597,27454,5844,6495
15062,7682,47.5,31225,21104,3529,4153
15063,11408,45.8,48877,24691,5523,5885
15064,539,41.3,28542,14654,220,319
15065,11723,44,45246,23488,5486,6237
15066,12916,41.3,43194,22946,6195,6721
15067,2367,40.9,37863,21936,1214,1153
15068,38292,45.3,44778,24866,18508,19784
15071,9897,40.5,60172,34554,4850,5047
15072,119,66.2,16786,14864,52,67
15074,8846,44.1,47740,25590,4394,4452
15075,70,32.5,28864,14921,40,30
15076,1191,43.1,37278,21499,500,691
15077,116,44.8,36250,16919,52,64
15078,305,51.3,20093,30759,166,139
15081,342,50.2,31500,22177,174,168
15082,142,66.5,72760,25870,63,79
15083,823,47.1,43438,22771,423,400
15084,9754,41.9,44295,23531,4812,4942
15085,7579,44.6,62908,32587,3627,3952
15086,298,42.3,103889,38609,129,169
15087,290,40.5,66161,24492,136,154
15088,791,32.5,37917,17949,398,393
15089,5586,47.6,43607,25315,2714,2872
15090,22369,41.5,120432,56627,11346,11023
15101,24988,43.2,80382,38512,12288,12700
15102,29988,45.2,70799,34238,14428,15560
15104,9339,35.6,23403,15354,4411,4928
15106,19090,42.7,44038,28161,9438,9652
15108,40774,41.2,63277,34383,20298,20476
15110,5581,38.6,20152,14095,2558,3023
15112,3372,38.2,40431,20470,1563,1809
15116,14403,46.9,72083,33930,7025,7378
15120,18952,43.8,41453,24423,8673,10279
15122,20123,44.7,45685,23664,9607,10516
15126,6646,41,66209,31688,3315,3331
15129,10844,44.3,64484,30956,5368,5476
15131,8335,51.8,47673,29773,3792,4543
15132,21456,40.2,27429,17094,10210,11246
15133,6443,45.3,45353,25583,3060,3383
15135,5304,44.8,51870,28184,2372,2932
15136,21901,42.4,40034,26514,10688,11213
15137,10123,44.9,39021,23375,4916,5207
15139,6340,48.6,54861,40147,3004,3336
15140,3295,38.8,35724,20561,1596,1699
15142,1358,42.2,124867,85017,648,710
15143,20162,44.2,86084,52470,9724,10438
15144,4081,45.6,52059,26428,1886,2195
15145,7388,43.7,34908,21324,3516,3872
15146,28380,45.8,58083,32302,13679,14701
15147,17314,47.6,44609,27530,8171,9143
15148,2628,39.8,26506,17581,1135,1493
15201,13688,37.7,45784,26392,6709,6979
15202,19654,39.7,43791,29474,9214,10440
15203,10134,28.7,43734,34115,5448,4686
15204,7647,42.8,37041,20505,3559,4088
15205,22459,38.7,51079,32964,10728,11731
15206,29098,36.6,33792,27733,12978,16120
15207,11245,41.5,39707,22792,5141,6104
15208,9941,38.6,31184,26805,4116,5825
15209,12875,42.4,56273,27925,5999,6876
15210,27573,34.6,31880,18348,13094,14479
15211,11428,34.5,50725,33168,5668,5760
15212,28243,38.4,37699,25496,14316,13927
15213,28400,21.7,21928,16458,13468,14932
15214,14535,37.7,38171,22597,6920,7615
15215,12834,41.9,60148,43376,6378,6456
15216,23054,39.9,50998,30389,11188,11866
15217,27439,34.4,62925,44026,13565,13874
15218,13877,41.8,47803,32049,6618,7259
15219,15410,28,20151,13178,7337,8073
15220,17637,38.7,63230,36660,8760,8877
15221,31099,42.3,37488,25657,13692,17407
15222,3550,31.7,63167,53370,1814,1736
15223,6737,41.8,41391,25250,3262,3475
15224,10148,33.7,38058,24708,4738,5410
15225,1086,48,36111,24317,587,499
15226,13715,40,51101,28285,6493,7222
15227,28399,42.5,49519,26926,13388,15011
15228,18099,40.7,72396,41968,8726,9373
15229,14024,40.6,58457,32925,6735,7289
15232,11894,29.1,50870,49682,5945,5949
15233,4387,37.6,33780,20368,3223,1164
15234,14146,44,55538,30433,6775,7371
15235,34257,45.2,50234,26540,15808,18449
15236,29836,44.5,58435,29691,14252,15584
15237,40891,45.3,69103,40158,19337,21554
15238,12654,50.1,79194,63449,6010,6644
15239,21418,41.6,65750,28933,10208,11210
15241,20069,44.4,102380,50330,9807,10262
15243,13220,50,74500,48533,6098,7122
15260,0,-666666666,-666666666,-666666666,0,0
15290,0,-666666666,-666666666,-666666666,0,0
15301,49266,44,50902,27160,24017,25249
15310,323,42.4,36389,19941,154,169
15311,1423,46.6,59583,28683,640,783
15312,3745,43.1,59919,28490,2010,1735
15313,342,42.7,36250,22105,180,162
15314,3923,39.7,46776,23266,1914,2009
15315,785,40.7,53250,22928,339,446
15316,118,43,33636,14622,49,69
15317,36569,43.6,65402,35973,17601,18968
15320,5285,40.4,44786,26613,2517,2768
15321,1447,45.1,70568,35359,608,839
15322,2167,43,41970,19073,978,1189
15323,4271,44.6,51350,24509,2079,2192
15324,571,48,35156,24226,282,289
15325,466,28.9,24375,11490,242,224
15327,1287,43.6,42143,19956,622,665
15329,1718,44.1,48000,20747,817,901
15330,5538,47,70959,32854,2960,2578
15331,931,46.8,35417,20594,458,473
15332,8170,47.8,57107,28137,4021,4149
15333,2232,43,53438,26127,1083,1149
15334,142,43.2,72750,26838,57,85
15337,708,42.4,41875,22037,370,338
15338,1569,45.1,45905,23886,815,754
15340,1455,44.6,74276,30112,717,738
15341,962,44.8,58500,26475,435,527
15342,4834,47.4,52688,28351,2247,2587
15344,1517,48,44500,25946,676,841
15345,1727,44,42386,22928,864,863
15346,531,49.3,40435,22933,269,262
15347,391,45.7,55409,50437,201,190
15348,244,42.7,33750,19689,140,104
15349,1815,50.6,49917,26645,849,966
15350,578,43.7,41083,23199,315,263
15351,719,55.1,21266,19033,382,337
15352,847,42,35125,19302,396,451
15353,38,37.6,73542,22813,20,18
15357,1766,43.9,47865,22240,870,896
15358,1255,27.8,41429,18736,624,631
15359,175,40.8,65139,26391,79,96
15360,1704,46.2,55694,28363,867,837
15361,43,65.4,-666666666,12991,22,21
15362,794,44.2,46944,24563,416,378
15363,707,60.4,37750,25025,371,336
15364,798,45.1,60375,27287,384,414
15366,274,30.6,73269,23549,142,132
15367,9300,39.7,113560,45188,4496,4804
15368,348,31.9,52596,19114,186,162
15370,15132,37.8,45957,18962,8794,6338
15376,1813,39.4,37895,19076,941,872
15377,752,45.5,47750,22726,407,345
15378,0,-666666666,-666666666,-666666666,0,0
15379,88,50.5,33750,21627,44,44
15380,758,34.1,45625,25671,350,408
15401,31654,45,34950,22668,15126,16528
15410,684,37.8,44342,17340,259,425
15411,635,49.2,50833,26986,323,312
15412,297,44.2,38333,21280,146,151
15413,485,37.7,42589,19662,219,266
15417,8798,44.2,38278,21325,4145,4653
15419,4774,22.7,23256,16086,2232,2542
15420,400,32.5,38571,9094,211,189
15421,187,61.5,63558,25173,75,112
15422,107,18.3,21667,9661,71,36
15423,2351,47.4,44683,32878,1258,1093
15424,2765,46.2,37440,18866,1319,1446
15425,19505,42.3,38381,20257,9446,10059
15427,1361,39.4,44559,24489,741,620
15428,1794,44.2,37708,20475,910,884
15429,158,42.3,14931,12028,80,78
15430,202,31.3,47750,17406,129,73
15431,4119,47.2,32185,19108,2049,2070
15432,394,54.9,43750,24180,180,214
15433,910,58.1,43301,23336,537,373
15434,343,49.8,30625,19346,152,191
15435,532,38.2,30478,16357,252,280
15436,2502,40.4,37188,20445,1126,1376
15437,2473,37.2,45257,19883,1424,1049
15438,1992,48,46528,24951,1015,977
15440,364,58.1,48889,22354,167,197
15442,2142,52,32188,19714,946,1196
15443,307,51.1,30288,18329,145,162
15444,283,60.4,20958,16506,110,173
15445,2728,48.2,49298,27544,1342,1386
15446,206,61.6,35924,19363,66,140
15447,115,27.6,-666666666,11974,47,68
15448,309,43.1,20625,23353,132,177
15449,173,61.4,22050,14753,71,102
15450,2232,35.4,53774,8509,2046,186
15451,1085,41.2,44516,21708,578,507
15454,315,54.6,-666666666,16269,186,129
15455,429,33.3,37991,13465,198,231
15456,3113,41.7,43722,19549,1539,1574
15458,2748,38.7,34786,20865,1345,1403
15459,1305,46.7,32422,23327,694,611
15460,77,31.1,26094,11242,38,39
15461,4130,41.6,34194,19127,2009,2121
15462,254,29.9,31250,17891,114,140
15463,0,-666666666,-666666666,-666666666,0,0
15464,1558,44.4,44792,19827,712,846
15466,447,42.5,48958,23075,218,229
15467,126,41.6,40000,20690,69,57
15468,2399,48.4,33750,22548,971,1428
15469,2378,40.1,47034,20297,1275,1103
15470,1086,49.5,56625,26712,567,519
15472,241,49.2,38750,19461,96,145
15473,4297,47.8,49056,24998,2219,2078
15474,1870,41.9,40152,19991,960,910
15475,1279,28.7,38926,17470,593,686
15476,43,67.8,-666666666,9600,15,28
15477,693,52.7,45147,25655,316,377
15478,6918,40,39967,18765,3521,3397
15479,2071,43.8,46573,26310,1033,1038
15480,2182,47,39875,17770,1020,1162
15482,505,53.8,27031,14995,248,257
15483,484,47.9,38482,25055,247,237
15484,553,21.1,17270,8375,280,273
15486,2076,41.4,44097,22234,1032,1044
15489,329,49.6,44635,14291,128,201
15490,1001,45.5,39036,15508,549,452
15492,118,47.2,26719,26790,54,64
15501,16594,43.5,43589,23241,8443,8151
15502,117,35.6,103750,53377,57,60
15510,2265,35.9,-666666666,3866,2265,0
15520,273,37,39297,14767,129,144
15521,2040,40.2,47222,19215,1099,941
15522,11815,44.9,42292,23491,5835,5980
15530,5160,45,42083,21330,2572,2588
15531,4136,49.5,45739,22055,1950,2186
15532,267,37.5,31833,13024,154,113
15533,1506,44,36053,18084,696,810
15534,823,49.9,43688,20685,443,380
15535,2068,49.1,41061,22513,1138,930
15536,414,41.5,48625,21726,212,202
15537,7902,45.6,44039,22525,3704,4198
15538,739,50.4,41375,23737,396,343
15539,575,35.9,34558,16479,280,295
15540,228,48.6,32917,16353,106,122
15541,4014,43.2,46818,23029,1966,2048
15542,1014,41.6,45489,19282,521,493
15544,151,50.6,31184,29665,85,66
15545,2991,45.1,39556,20236,1508,1483
15546,512,25.3,60855,35423,275,237
15547,417,56.3,49625,39490,230,187
15550,1551,48.6,41518,23043,759,792
15551,913,49.6,41118,19904,492,421
15552,6131,43.6,42750,21006,2992,3139
15554,2436,46.6,48065,27087,1313,1123
15555,64,49,32500,16753,36,28
15557,3669,42.6,47683,22210,1855,1814
15558,2197,37.4,37829,20277,1100,1097
15559,2002,48.2,46012,24605,977,1025
15560,178,47.6,68000,31970,88,90
15561,133,55.2,40000,23865,58,75
15562,190,39.8,70938,27614,100,90
15563,3115,45.4,40446,22885,1503,1612
15564,91,35.2,39722,19090,43,48
15601,59313,45.2,52719,30637,28581,30732
15610,3650,44.4,45625,23256,1690,1960
15611,526,43.1,39973,25697,332,194
15612,206,60.6,85341,42158,112,94
15613,14178,47.2,49688,25755,7185,6993
15615,364,41.4,57778,24193,171,193
15616,134,30.2,-666666666,,72,62
15617,433,41.9,43472,19906,217,216
15618,2661,45.8,42845,22889,1332,1329
15620,1008,33.5,40402,19991,531,477
15621,30,8.5,-666666666,,25,5
15622,1382,53.5,44010,31166,620,762
15623,779,50.5,44100,21195,318,461
15624,339,45.3,25944,14436,176,163
15625,108,55.6,-666666666,38629,45,63
15626,5356,51.1,53146,31861,2571,2785
15627,6438,44.3,47031,21693,3144,3294
15628,712,48.1,35179,22015,361,351
15629,688,41.3,39886,19582,334,354
15631,1057,43.3,42171,18842,549,508
15632,9268,44.3,62449,35610,4748,4520
15633,259,52.9,53445,27410,120,139
15634,815,34.3,66488,19299,371,444
15635,101,46.3,25250,14266,13,88
15636,3855,42.7,91954,36069,1991,1864
15637,2191,40.7,51507,24316,1139,1052
15638,386,37.5,51676,17304,176,210
15639,2270,42.2,60139,29178,1131,1139
15640,625,41.9,76016,28575,296,329
15641,503,47.3,40909,26262,276,227
15642,45544,43.6,66267,31747,22128,23416
15644,19355,45.7,47939,26460,9731,9624
15646,199,51.2,25568,14568,74,125
15647,276,51.6,63156,22417,151,125
15650,28469,44.8,42308,23773,13786,14683
15655,288,55,76859,44198,146,142
15656,10208,43.9,47658,25820,5090,5118
15658,8704,50.1,50329,28771,4324,4380
15660,409,38.2,38672,17727,208,201
15661,525,38.1,51438,21374,206,319
15662,357,25.9,-666666666,29828,271,86
15663,553,55.2,44375,30596,295,258
15665,1915,38,53299,20268,1003,912
15666,16538,48.6,46993,24757,7803,8735
15668,13579,49.6,92681,46390,6604,6975
15670,3152,47.4,56200,33368,1570,1582
15671,841,30.6,40139,17944,481,360
15672,3339,48.2,43500,28313,1498,1841
15673,1327,43.2,42321,24294,628,699
15675,971,40.1,51000,25453,458,513
15676,251,37.7,31767,18329,72,179
15677,486,42.7,48594,21932,248,238
15678,231,29.3,36071,18469,85,146
15679,3594,47.8,53225,24473,1934,1660
15680,110,65,40500,20650,48,62
15681,4997,45,46783,24552,2544,2453
15683,8210,42.7,44102,23538,3737,4473
15684,570,53.1,40065,23311,321,249
15686,976,46.4,52000,30797,509,467
15687,1194,46.8,49423,26464,564,630
15688,725,37,43194,18163,367,358
15689,191,52.3,24797,17785,81,110
15690,8858,43.3,37991,21632,4236,4622
15691,27,-666666666,-666666666,,0,27
15692,769,52.7,55360,28615,354,415
15693,238,16.6,19896,13850,140,98
15695,183,43.5,32083,27629,80,103
15696,321,48.5,47500,36610,181,140
15697,2990,36.4,42928,21107,1448,1542
15698,744,53.1,44176,24635,358,386
15701,34509,29.5,40411,23139,16650,17859
15710,322,51.2,39583,20232,175,147
15711,523,28.8,44306,17369,279,244
15712,117,48.1,21023,20188,57,60
15713,221,58.7,38622,21175,148,73
15714,5021,42.9,37826,21019,2329,2692
15715,671,36.6,36667,18333,300,371
15716,801,33.6,28958,12515,386,415
15717,11020,44.5,48675,25984,5778,5242
15721,214,42.4,43750,19536,106,108
15722,2166,47.8,47031,24098,1166,1000
15723,39,49.3,-666666666,34590,11,28
15724,2260,48.7,34911,20300,1088,1172
15725,1494,44.5,50758,22285,728,766
15727,127,39.9,34063,21606,37,90
15728,3122,45.6,42432,23698,1631,1491
15729,1699,42.8,43657,19777,837,862
15730,43,50.2,53750,39777,25,18
15731,418,20.7,32500,15452,251,167
15732,1755,40.9,53452,24494,853,902
15733,116,35.1,32083,13315,50,66
15734,239,48.5,38750,15476,121,118
15736,668,44.9,45292,23839,315,353
15737,125,30.6,33750,16688,54,71
15738,234,51.5,53393,20250,127,107
15739,359,45.1,42500,25701,151,208
15741,75,39.4,44844,19691,35,40
15742,965,41.9,46908,21031,499,466
15744,140,44.1,58125,21136,62,78
15745,371,33.4,28281,16685,205,166
15746,154,29,47188,12956,73,81
15747,2034,40.3,55114,22494,1010,1024
15748,6766,42.8,44382,21547,3280,3486
15750,144,43.1,16667,13595,70,74
15752,75,24.9,43929,19601,40,35
15753,564,43.9,49500,20834,273,291
15754,505,45.1,54191,19982,242,263
15756,212,36.3,43125,20149,152,60
15757,1539,46.1,33889,17068,779,760
15759,3152,42.7,51696,22305,1573,1579
15760,132,32.9,50729,24337,70,62
15761,44,61.6,19167,13130,14,30
15762,907,40.8,57778,22500,475,432
15764,109,49.2,57604,26834,47,62
15765,1916,44.5,57885,24705,1024,892
15767,14536,42.3,39740,21140,6969,7567
15770,256,49.3,63182,28015,157,99
15771,1086,46.1,48958,18820,505,581
15772,1622,43.8,39038,18772,925,697
15773,471,47.2,39432,20495,210,261
15774,3438,42.5,54013,30593,1740,1698
15775,735,45.9,58160,24520,300,435
15776,60,52.8,54167,29458,38,22
15777,148,42.7,40147,13750,71,77
15778,118,42.3,40694,16247,75,43
15779,266,41.6,23125,13042,153,113
15780,151,39.5,48250,19463,71,80
15781,65,36.9,43929,21320,27,38
15783,90,41.3,29038,21639,55,35
15784,68,52.5,46250,23525,33,35
15801,19488,42.6,44277,22734,9614,9874
15821,175,52.5,34688,18909,88,87
15823,1575,41.8,46523,21336,861,714
15824,5152,43.2,42156,21519,2511,2641
15825,9739,44.6,43838,23180,4784,4955
15827,298,38.1,53385,16417,158,140
15828,376,58.1,40833,22298,202,174
15829,1308,36.2,36759,20268,652,656
15832,354,55.1,39375,21465,192,162
15834,4457,47,41179,22687,2199,2258
15840,1867,42.8,38438,20375,937,930
15841,417,37.7,42708,18310,170,247
15845,3379,45.7,37455,22018,1637,1742
15846,3702,44.3,50781,22951,1944,1758
15847,187,41.6,25500,16479,99,88
15848,1041,38.8,50000,20248,524,517
15849,1145,45.4,33250,19779,603,542
15851,6633,43.1,41161,20225,3353,3280
15853,6278,44.3,43246,22064,3173,3105
15856,866,48.9,47578,24521,424,442
15857,13140,46.9,48061,25920,6337,6803
15860,983,53.9,42143,23049,525,458
15861,138,63.3,43036,25757,68,70
15863,173,48,26667,16366,78,95
15864,1757,42.6,46597,22921,906,851
15865,1410,38.8,33534,17479,765,645
15866,227,46.1,62750,67479,117,110
15868,1287,49.6,45234,23503,624,663
15870,1345,44.8,50139,24797,699,646
15901,4063,49.6,16434,14492,2088,1975
15902,12762,40.3,31931,17810,5971,6791
15904,16269,44,46377,27929,7504,8765
15905,20790,47.9,51267,28068,10065,10725
15906,11173,45.6,30011,17682,5588,5585
15909,5410,49,41444,22531,2654,2756
15920,877,48.1,51000,23191,449,428
15921,211,50.8,41667,21513,110,101
15922,181,33.5,23750,11681,81,100
15923,1733,41.3,38631,19485,888,845
15924,970,47.1,37083,21398,475,495
15925,158,44.5,58438,27062,82,76
15926,2594,46.8,41308,22864,1320,1274
15927,839,39.2,34792,21258,424,415
15928,2432,52.8,49744,26699,1292,1140
15929,89,49.5,33750,20445,33,56
15930,156,44.8,18833,13592,67,89
15931,9453,42.2,59147,25310,4805,4648
15934,89,57,24792,34531,39,50
15935,2635,45.2,55050,23327,1306,1329
15936,1597,46.4,49688,22598,841,756
15937,601,45.7,65000,24503,264,337
15938,2512,46.4,46397,23005,1197,1315
15940,3962,32.3,54671,14630,2370,1592
15942,1924,46,51169,31776,1053,871
15943,4048,44.3,40362,21455,1953,2095
15944,3723,44.9,47230,24736,1909,1814
15945,220,43.4,33750,15247,104,116
15946,6987,43.4,44747,21606,3474,3513
15948,618,37.4,25714,13594,284,334
15949,499,42,46250,22160,235,264
15951,497,73.4,24727,25877,135,362
15952,1337,43,51667,24043,666,671
15953,177,45.5,110682,29309,121,56
15954,2294,45.3,39668,25986,1121,1173
15955,2943,44.7,50625,22627,1504,1439
15956,2441,38,43798,23370,1282,1159
15957,575,46.2,45435,23107,285,290
15958,2092,44.2,54167,23973,1062,1030
15960,398,49.2,37672,14393,170,228
15961,765,46.4,54808,25596,406,359
15962,132,34,37917,18880,76,56
15963,10949,46.4,41352,24006,5287,5662
16001,39863,44.7,43968,25303,19733,20130
16002,15637,43.5,62179,27766,8347,7290
16020,1199,41.4,45556,21118,622,577
16022,488,33,43281,18172,246,242
16023,4371,49.1,52685,27845,2104,2267
16024,197,36.9,73750,28072,119,78
16025,5661,42.1,58679,24762,2716,2945
16027,288,35.3,58750,24603,156,132
16028,2127,46.8,38500,19726,1097,1030
16029,647,40,41875,22128,326,321
16030,281,42.8,45938,23654,142,139
16033,5727,45.5,56442,31265,2861,2866
16034,2070,38.3,49250,20977,1021,1049
16035,89,50.8,67500,27475,49,40
16036,270,46.3,41146,19913,115,155
16037,4614,44.6,61197,28937,2427,2187
16038,3804,41.6,48500,22066,1851,1953
16040,959,42.9,44417,20270,486,473
16041,1938,43.8,49896,24022,990,948
16045,1449,28.4,38056,17149,623,826
16046,14608,40.2,91888,49732,7008,7600
16048,154,51,56528,24455,102,52
16049,3355,45.5,44554,21834,1708,1647
16050,1666,39.9,51053,21183,839,827
16051,3242,41.7,50265,24249,1545,1697
16052,2374,45.1,55122,28099,1243,1131
16053,4130,48.2,55844,29656,2059,2071
16054,338,51.1,51667,23437,167,171
16055,8416,45.2,63526,29242,4108,4308
16056,4792,47.8,50727,26518,2189,2603
16057,13758,23.4,45203,21621,6493,7265
16059,8207,44.4,64160,35431,3957,4250
16061,2744,44.6,50724,23868,1363,1381
16063,6669,48,52337,34079,2983,3686
16066,28520,38.1,100588,42057,14217,14303
16101,34561,43,36929,19816,16281,18280
16102,5576,44,44063,23087,2713,2863
16105,14742,47.8,53100,31622,7327,7415
16110,312,50.4,36250,22792,180,132
16111,1346,30.2,36894,18606,646,700
16112,1700,43.1,45402,24076,806,894
16113,391,53.8,76406,32217,186,205
16114,564,48.1,47500,22584,280,284
16115,3407,45.1,53954,24016,1727,1680
16116,2734,48,37488,21739,1327,1407
16117,17059,44.8,44355,23496,8328,8731
16120,2348,40.6,50417,22696,1211,1137
16121,4925,37.8,29711,15803,2298,2627
16123,2284,42.9,58472,29713,1278,1006
16124,1919,42.6,49306,21579,958,961
16125,18141,46.2,41239,21931,8791,9350
16127,15968,34.3,49222,21358,7765,8203
16130,1979,47.3,46630,22759,999,980
16131,802,35.2,43000,16333,387,415
16132,394,43.1,23125,9474,251,143
16133,1639,44.4,50197,27381,861,778
16134,4133,47,41771,22150,2116,2017
16136,683,46.8,34188,20610,289,394
16137,12757,43.8,50159,23545,7318,5439
16140,211,47.6,68250,15934,90,121
22546,15952,36.9,61637,26850,7484,8468
22548,57,58.5,-666666666,58465,43,14
22551,17929,42.3,68313,28954,8793,9136
22553,13821,36.7,92521,35048,6994,6827
22554,52564,33.7,103818,37370,26983,25581
22556,25485,35.3,101463,38038,12564,12921
22560,6120,46.4,45377,21168,2698,3422
22567,3218,38.9,54299,22438,1523,1695
22572,7410,43.4,46818,19098,4299,3111
22576,1674,54.1,43808,26420,812,862
22578,2096,58.8,55078,40838,1080,1016
22579,57,65.8,-666666666,58370,32,25
22580,5249,39.2,49740,23787,2588,2661
22601,28401,35.3,44572,25754,13801,14600
22602,28282,38,72388,30845,14198,14084
22603,13678,45.7,56944,31055,6633,7045
22610,1635,47.1,52118,26796,825,810
22611,8492,45.1,76319,37040,4021,4471
22620,2350,48.2,87353,39951,1055,1295
22623,545,46.3,57404,34161,269,276
22624,2766,40.6,61771,28575,1348,1418
22625,4414,33,74458,27516,2239,2175
22627,469,58.8,74881,65065,238,231
22630,31009,40,60977,29163,15191,15818
22637,1619,53.4,69607,33573,859,760
22639,284,63.7,103125,104922,152,132
22640,845,49,57949,26230,358,487
22641,644,40.9,58750,21393,303,341
22642,3912,37.1,76198,28685,1986,1926
22643,84,64.1,79412,62451,43,41
22644,2484,43,57609,26857,1232,1252
22645,3638,44.8,50202,29258,1871,1767
22646,246,52.3,64097,58442,139,107
22650,1256,37.8,54487,19709,747,509
22652,1263,49.6,64432,30271,731,532
22654,1043,39.3,94160,37441,629,414
22655,19449,35.9,76113,30700,9500,9949
22656,2743,41.2,51923,23718,1420,1323
22657,10508,41.7,54238,27214,5294,5214
22660,1984,37,57813,25441,946,1038
22663,1727,43.9,59509,27507,916,811
22664,9095,42.1,43951,21917,4302,4793
22701,32200,36.3,59808,28317,15824,16376
22709,823,52.8,52813,23235,372,451
22711,10,-666666666,-666666666,,10,0
22712,8053,34.1,76013,27189,3976,4077
22713,1609,39,59796,25558,805,804
22714,1237,37.9,70625,24969,644,593
22715,1723,47.4,99926,31217,912,811
22716,1119,45.9,55200,31227,677,442
22718,497,50.6,68673,29268,230,267
22719,472,55.3,33969,18457,162,310
22720,1083,50.1,74708,33758,567,516
22722,345,43.2,73313,34678,218,127
22723,143,18.3,-666666666,17749,79,64
22724,1708,51.8,73229,39131,835,873
22726,607,33.9,40066,21257,292,315
22727,4683,45.5,52453,24853,2123,2560
22728,3193,41.4,96667,36281,1690,1503
22729,1304,36.9,-666666666,3889,1224,80
22730,43,73.3,-666666666,20533,28,15
22731,78,25.6,-666666666,19290,45,33
22732,348,32.5,71429,21909,177,171
22733,1496,40.1,59097,27533,933,563
22734,3717,31,67125,22482,1791,1926
22735,1690,39.8,66000,25259,1013,677
22736,872,34.7,83056,25722,418,454
22737,3313,39.5,75585,26488,1498,1815
22738,1360,34.6,34432,21536,664,696
22740,1260,45.6,39950,24845,511,749
22741,274,40.5,56125,19315,244,30
22742,2185,40.4,78796,40352,1216,969
22743,196,59.1,120764,39989,94,102
22747,1037,48.5,50069,37723,486,551
22749,312,59.2,67143,89603,124,188
22801,38142,23,41200,20938,18111,20031
22802,28401,32.4,44837,22008,14030,14371
22807,2449,19.2,-666666666,2027,857,1592
22810,690,60.8,41442,26017,343,347
22811,426,50.3,32262,23584,179,247
22812,9048,33.9,54048,25898,4278,4770
22815,8251,37.5,51949,28713,4287,3964
22820,161,65.3,29250,16509,90,71
22821,5894,38.4,49945,23914,2908,2986
22824,5865,46.2,52805,27933,2692,3173
22827,9403,45.8,44765,23099,4502,4901
22830,1944,43.1,47936,20087,1033,911
22831,946,37.9,54116,23877,508,438
22832,1293,44.5,56169,27402,678,615
22834,1092,38.6,40357,30224,531,561
22835,11374,45.5,44817,25388,5666,5708
22840,5191,36.1,70395,40026,2463,2728
22841,2867,42.5,54722,32505,1303,1564
22842,5330,42,44769,22533,2649,2681
22843,2394,44.2,43160,22364,1131,1263
22844,4358,46,41984,25040,2105,2253
22845,0,-666666666,-666666666,-666666666,0,0
22846,1881,35.5,67083,31591,1030,851
22847,978,38.5,63438,22996,446,532
22849,4730,43.1,45833,23601,2335,2395
22850,839,40.7,50341,20827,408,431
22851,6157,41.1,34889,17163,2860,3297
22853,4572,44.1,43598,21226,2088,2484
22901,32149,40.4,58566,38133,15129,17020
22902,21276,35.5,51824,33254,10297,10979
22903,39607,26.6,47192,30440,19243,20364
22904,5019,19.6,63375,2356,2183,2836
22911,17490,39.6,76385,38730,8115,9375
22920,4201,48.9,62938,33153,2032,2169
22922,2298,36.3,45435,22019,1172,1126
22923,4094,39.8,70871,32673,2017,2077
22931,288,58.6,64550,53156,150,138
22932,7516,42.2,76354,31121,3881,3635
22935,633,41.8,38324,19777,346,287
22936,4656,47.1,104850,41340,2373,2283
22937,1857,36.6,45893,20336,999,858
22938,1609,47.7,57199,24669,778,831
22939,5296,36.1,63977,28777,2709,2587
22940,1057,44.6,54514,45530,549,508
22942,8368,44,56750,28926,3846,4522
22943,298,54.8,63250,28103,147,151
22946,279,24.7,89583,29554,165,114
22947,4005,53,86513,56430,1815,2190
22948,182,56.8,97841,39504,110,72
22949,1165,56.8,24939,41301,500,665
22952,2088,46.3,43095,23158,1084,1004
22958,1473,60.8,62596,45926,829,644
22959,1311,52.5,55822,61922,623,688
22960,11001,44,44854,21728,5464,5537
22963,14936,42.1,71723,34752,6885,8051
22964,111,71.2,51667,23768,43,68
22967,1821,45.9,41786,20256,914,907
22968,10353,40.4,70139,27952,5166,5187
22969,1234,41.8,54811,21326,617,617
22971,1652,43,47028,17832,654,998
22972,250,49.2,31016,33086,135,115
22973,6792,42.6,51464,25414,3207,3585
22974,5881,39.6,78952,29037,2278,3603
22976,197,24.9,24904,9108,82,115
22980,31706,41.9,47970,24183,14871,16835
22989,123,45.5,-666666666,32944,74,49
23002,11071,40.5,53193,24940,5394,5677
23004,866,30.6,55098,22687,400,466
23005,14798,41.6,54855,29893,7213,7585
23009,6337,37.8,65473,27022,3068,3269
23011,1751,43.2,57188,26493,1036,715
23015,4388,44,76620,30173,2106,2282
23021,347,53.8,85990,32915,172,175
23022,1418,29.6,50368,21542,735,683
23023,234,55.4,43167,32900,144,90
23024,8090,46.3,49122,28241,4206,3884
23025,247,46,42708,22294,142,105
23027,1179,45.7,34625,23827,618,561
23030,4907,48.3,48102,26256,2376,2531
23032,221,52.5,34118,22530,98,123
23035,1388,40.2,47329,23122,605,783
23038,1437,47.9,50750,25763,666,771
23039,1074,41.8,83750,41879,537,537
23040,4334,41.8,47261,22278,2208,2126
23043,1386,58,42639,32648,773,613
23045,11,-666666666,-666666666,,11,0
23047,1698,47.3,69833,30714,767,931
23050,702,34.7,57656,28387,341,361
23055,936,48,59648,21737,473,463
23056,417,56.7,63533,39500,237,180
23059,33940,38,104163,44947,16407,17533
23060,33848,39.1,79480,35837,16738,17110
23061,19903,44.3,64931,29761,9759,10144
23062,2271,39.9,61955,31726,998,1273
23063,5625,39.1,61938,24780,2351,3274
23064,55,47.4,-666666666,19444,39,16
23065,2068,45.6,78008,34125,978,1090
23066,565,48.9,50313,32800,303,262
23068,337,54.9,46944,37483,171,166
23069,3625,45.9,77604,27690,1983,1642
23070,767,59.8,99250,47337,367,400
23071,1588,56.5,69167,43820,831,757
23072,12486,39.2,55852,27145,6238,6248
23075,10541,34.9,41703,21152,4768,5773
23076,821,50.6,51553,26198,451,370
23079,599,26.7,78068,21266,235,364
23083,1176,51.3,49770,24365,587,589
23084,1508,49.7,59648,29369,805,703
23085,421,45.4,39392,23281,254,167
23086,2705,45,55800,26269,1401,1304
23089,5015,40.2,70129,30892,2406,2609
23091,286,58.3,53750,22248,150,136
23092,563,40.1,47244,22598,270,293
23093,12997,41,50595,23843,6188,6809
23102,3342,43.7,92346,32064,2131,1211
23103,4381,53.7,106750,67963,2185,2196
23106,1270,31.2,45125,16816,666,604
23108,223,47.4,62917,30153,131,92
23109,2358,48.6,48984,30460,1152,1206
23110,846,49.7,55609,22974,548,298
23111,36754,39.8,67346,30480,17469,19285
23112,50595,35.1,80830,33038,25159,25436
23113,23811,46,110574,55819,11396,12415
23114,18676,35.7,86763,36364,8880,9796
23115,243,25.8,33608,11996,144,99
23116,28115,40.6,102891,38876,14079,14036
23117,9520,45.4,61477,31132,4660,4860
23119,215,65.2,29750,46507,83,132
23120,6193,39.1,118564,39253,3042,3151
23123,1618,44.2,32027,23037,609,1009
23124,3436,39.4,69974,27519,1699,1737
23125,79,64,120284,39641,42,37
23126,234,55.8,83043,31949,114,120
23128,1310,43.3,91875,32361,671,639
23129,320,41.9,110517,42027,153,167
23130,351,54.5,49444,21833,88,263
23138,385,54,65375,47075,222,163
23139,23815,42.7,73868,33519,12011,11804
23140,5694,44.1,66463,32257,2815,2879
23141,5816,44.3,70257,33418,3154,2662
23146,3107,47,77207,37414,1455,1652
23148,2051,41.7,55524,26017,1070,981
23149,3135,47.8,46587,23980,1647,1488
23150,12117,39.8,61273,26762,5589,6528
23153,1073,54.2,76964,63814,541,532
23156,1446,47.3,43400,26053,602,844
23160,3132,38.4,-666666666,3163,3090,42
23161,62,66.3,52143,47961,33,29
23163,280,58.4,36574,38416,102,178
23168,6947,39.5,79375,30510,3206,3741
23169,1522,53.3,50085,25192,685,837
23173,2268,20.5,-666666666,3216,1157,1111
23175,1540,56.4,43618,28127,706,834
23176,599,49.2,56144,27470,297,302
23177,962,31.3,41638,15421,577,385
23180,592,42.7,48906,20395,298,294
23181,5618,39.7,63288,26601,2664,2954
23185,46458,40.6,70196,36566,22267,24191
23187,155,21.2,-666666666,3849,72,83
23188,39235,44.1,72070,36961,18634,20601
23192,6382,47.5,71458,38256,3283,3099
23219,3284,25.4,19231,24403,1518,1766
23220,35002,25.3,32684,24057,16656,18346
23221,14702,33.8,56219,44838,7252,7450
23222,25820,36.4,34234,18240,11836,13984
23223,48111,33.1,36855,21085,22068,26043
23224,35885,30.8,33141,15740,16912,18973
23225,39470,37.8,43683,27214,18398,21072
23226,15078,37.6,76599,60491,7207,7871
23227,25961,41.4,45823,28480,12022,13939
23228,33844,35.1,44224,23998,15899,17945
23229,32930,41.4,71638,44244,15821,17109
23230,5360,42,53606,33550,2400,2960
23231,35211,38.3,53705,26308,16862,18349
23233,29081,38.7,91741,44702,14279,14802
23234,42360,33.7,46279,21281,20349,22011
23235,29522,43.6,67956,38191,13993,15529
23236,26234,40.8,74141,33515,12803,13431
23237,21807,36.9,54735,23503,10823,10984
23238,25848,42.3,64927,42323,11730,14118
23250,0,-666666666,-666666666,-666666666,0,0
23294,17222,30.6,52071,27235,8080,9142
23301,1566,35.1,41944,23944,676,890
23302,15,-666666666,-666666666,,2,13
23303,890,52.1,47684,34976,477,413
23304,143,71.9,58773,33201,74,69
23306,933,48.5,53911,29781,442,491
23307,582,51.8,43611,23114,260,322
23308,2128,39.7,40489,15711,975,1153
23310,4564,45.5,36356,23017,2150,2414
23313,117,54.4,38636,24603,82,35
23314,6905,41.9,78891,36245,3470,3435
23315,1466,49.4,55714,26428,677,789
23316,374,23.4,11146,7872,109,265
23320,53339,35.6,69475,32134,24969,28370
23321,35453,35.9,69876,30302,16287,19166
23322,61868,39.9,96091,34364,33079,28789
23323,34915,36.7,68427,27008,16543,18372
23324,22441,30.1,36875,18525,10721,11720
23325,17676,38.7,54972,26886,8311,9365
23336,2968,49.5,38036,28067,1429,1539
23337,358,53.3,32130,18089,164,194
23347,742,39.8,22500,19070,526,216
23350,3492,47,30167,24129,1592,1900
23354,276,25.4,108750,31161,129,147
23356,969,54.1,50833,39570,477,492
23357,771,32.4,28776,12826,450,321
23358,17,-666666666,-666666666,,9,8
23359,989,39.4,35547,16318,587,402
23389,136,73.3,-666666666,13575,42,94
23395,232,70.8,25511,21365,137,95
23398,52,67.2,-666666666,76908,33,19
23401,143,36.8,25417,12668,73,70
23405,955,60.4,30129,22880,530,425
23407,419,39.7,44894,29660,185,234
23408,38,71.2,-666666666,14716,18,20
23409,5,-666666666,-666666666,,0,5
23410,2667,47.9,40707,18946,1254,1413
23413,937,50.3,46442,30607,413,524
23414,160,54.2,12159,12737,76,84
23415,1687,46.3,45176,21759,870,817
23416,476,26.8,53150,17272,245,231
23417,3784,53,39189,26362,1843,1941
23418,819,48.2,64464,27114,428,391
23420,2882,35.2,25573,21538,1378,1504
23421,5078,35.5,42426,19452,2344,2734
23422,206,62.9,42832,43181,74,132
23423,285,63.9,24167,28242,129,156
23426,231,45.9,31713,17481,108,123
23427,218,57.8,30500,20467,109,109
23430,17202,44.7,68348,33599,8459,8743
23432,1360,45.3,85333,40270,654,706
23433,856,54.2,67222,40184,370,486
23434,47846,38,54802,25170,22952,24894
23435,27088,36.9,84531,35118,13315,13773
23436,1146,45.2,99716,49081,578,568
23437,4552,41.1,64806,26213,2047,2505
23438,1899,44.5,63897,26182,851,1048
23440,483,55.7,40833,20990,257,226
23441,81,7.2,-666666666,,64,17
23442,1292,38.3,30714,19406,646,646
23451,42355,36.8,59017,42400,20957,21398
23452,60422,34.9,61522,30521,29294,31128
23453,35707,31.8,66944,26232,17616,18091
23454,62748,34.6,64721,33493,30788,31960
23455,48765,35.7,62949,35517,24027,24738
23456,51261,38.4,92574,33649,25905,25356
23457,4548,44.8,85037,36508,2198,2350
23459,1227,20.5,44750,15288,691,536
23460,829,21.9,-666666666,19173,684,145
23461,168,23.1,-666666666,33879,155,13
23462,61287,31.9,56617,26703,29585,31702
23464,72834,35.9,71192,29404,34922,37912
23480,273,59.4,19250,20356,145,128
23486,210,37.9,58512,15302,107,103
23487,6493,42.8,44369,22350,3156,3337
23488,128,72.7,10566,14845,73,55
23502,22103,34.6,47378,22209,10786,11317
23503,35632,29.4,46001,25706,19731,15901
23504,23272,27.1,26361,14422,10646,12626
23505,30613,28.8,42102,27895,15879,14734
23507,8153,29.9,62755,41859,4344,3809
23508,20456,24.3,50789,24608,11658,8798
23509,13297,38.2,46187,26872,6364,6933
23510,7171,30.3,57788,36768,4059,3112
23511,8725,22.4,89000,25122,7302,1423
23513,31436,31.5,40413,19654,14986,16450
23517,4398,32.3,40513,33048,2165,2233
23518,30581,36.5,53375,27977,15115,15466
23523,7776,28.9,28896,13904,3486,4290
23551,477,21.5,-666666666,22970,342,135
23601,24907,36.4,50068,26325,11559,13348
23602,39925,36.7,61343,30030,19466,20459
23603,3647,27.9,56722,27774,1884,1763
23604,7210,21,51782,16910,4776,2434
23605,13436,35.5,39953,21876,6256,7180
23606,28648,30.5,57230,30407,14059,14589
23607,23709,31.4,27897,15623,11186,12523
23608,43612,31.3,55319,24280,20252,23360
23651,592,33,90625,38274,327,265
23661,13795,42.6,44349,24807,6716,7079
23662,12095,43.5,81701,38373,5950,6145
23663,15279,33.5,41006,18553,7051,8228
23664,9170,42.4,62901,34217,4238,4932
23665,5593,22.2,52313,18789,2974,2619
23666,49434,35.9,55415,27662,24459,24975
23669,43132,34.5,46209,22975,19876,23256
23690,3694,27.7,48400,25491,1902,1792
23691,188,13.3,61146,17203,90,98
23692,18440,45.1,81387,38102,8861,9579
23693,23732,39.9,100488,41315,12078,11654
23696,3845,45.1,93854,39630,1941,1904
23701,23549,41.3,47245,23991,11642,11907
23702,11715,31.6,36079,17461,5576,6139
23703,26988,34.7,60427,26540,13360,13628
23704,18578,34,34072,19754,8829,9749
23707,14694,33.6,42647,24360,6463,8231
23708,313,20.7,-666666666,21727,261,52
23709,64,20.5,-666666666,22231,64,0
23801,5351,20,59138,15992,2857,2494
23803,40187,37.8,39607,20029,19134,21053
23805,19793,42,47366,25032,9536,10257
23806,2061,19.6,-666666666,2761,845,1216
23821,1582,47.8,34663,18883,737,845
23824,7730,43.9,36509,21772,4135,3595
23827,1461,43.6,28266,16578,712,749
23828,416,32.1,62083,26016,196,220
23829,2416,50.8,60536,16993,1901,515
23830,1106,53.5,58825,27070,568,538
23831,33130,38.5,66239,30510,15530,17600
23832,32263,37.2,75942,31379,15438,16825
23833,2501,41.9,53684,22613,1230,1271
23834,25887,39.7,54548,27787,12379,13508
23836,11222,40.8,83433,38295,5321,5901
23837,4661,40.5,47393,23174,2350,2311
23838,16186,43.1,103059,39737,7696,8490
23839,809,45.8,50362,24863,378,431
23840,1835,39.6,49010,21124,772,1063
23841,4190,44.8,51074,20347,1893,2297
23842,7090,43.9,73041,27055,4043,3047
23843,514,58.4,34438,20705,246,268
23844,747,43,23857,14656,290,457
23845,218,51.8,36507,25924,92,126
23846,548,49.3,62824,25972,283,265
23847,16090,42.7,33784,17136,9467,6623
23850,743,36.4,46364,21442,399,344
23851,13625,40.5,36584,20946,6048,7577
23856,935,45.8,42548,19010,437,498
23857,757,52.2,57689,20046,337,420
23860,30917,36.8,40609,20406,16338,14579
23866,2189,44.2,53281,27671,1115,1074
23867,2651,38.1,41319,19207,1032,1619
23868,7739,34.4,35109,12144,4484,3255
23872,2263,43.4,40351,26898,1024,1239
23874,914,48.1,39234,21399,461,453
23875,10714,40.4,62416,27479,5137,5577
23876,505,36.8,68265,25663,232,273
23878,1132,41.9,56667,25177,615,517
23879,608,39.3,62188,21527,335,273
23881,1779,51.5,38295,24405,784,995
23882,2071,38.7,47422,23240,949,1122
23883,3077,39.2,56324,23429,1551,1526
23884,89,65.2,165234,41490,56,33
23885,2539,49.7,75625,31762,1274,1265
23887,303,67.2,29519,28391,158,145
23888,1941,45.3,40000,20256,924,1017
23889,351,55.8,14875,22752,134,217
23890,4697,43,38663,17402,2781,1916
23891,2183,35.2,-666666666,4756,2157,26
23893,231,51.4,29265,20870,92,139
23894,453,41.9,72143,29515,177,276
23897,605,55.2,49602,26401,355,250
23898,2310,48.9,57969,26474,1107,1203
23899,336,51.5,38875,22908,178,158
23901,16490,33.9,35825,18260,7942,8548
23909,2023,19.6,-666666666,3201,651,1372
23915,788,43.6,46957,16970,619,169
23917,3666,47.1,34018,15799,2284,1382
23919,2551,56,37880,23450,1150,1401
23920,3998,40.9,38511,15262,2033,1965
23921,1577,51.3,30580,21220,818,759
23922,2404,46.2,36736,13147,1633,771
23923,2227,44.9,31595,16969,1103,1124
23924,7066,41.5,33773,16983,3140,3926
23927,4077,55.1,37067,26499,2090,1987
23930,6142,39.4,40938,19990,2671,3471
23934,812,47.2,42569,20442,351,461
23936,9193,41,36803,14342,5827,3366
23937,2330,39.1,27803,14633,1031,1299
23938,251,42.8,36250,27280,45,206
23942,1187,44.1,42019,22677,681,506
23943,278,20.6,-666666666,6117,264,14
23944,4481,41.1,30752,16988,2105,2376
23947,3700,44,36330,21326,1856,1844
23950,3397,34.7,28390,15773,1554,1843
23952,168,50.9,44063,22986,117,51
23954,2183,41.1,45357,18736,1145,1038
23958,3375,42.5,39617,23360,1786,1589
23959,1235,38.7,39917,16981,565,670
23960,2066,43.7,43438,17688,1106,960
23962,345,56.5,30455,16539,207,138
23963,421,42.8,85045,22230,245,176
23964,1215,40.5,54438,25988,729,486
23966,1886,46.3,30739,20898,871,1015
23967,1296,41.1,39135,17574,673,623
23968,776,55.1,27250,17871,320,456
23970,8326,46.1,42582,23116,3876,4450
23974,5174,44.1,36530,16011,3076,2098
23976,136,48.8,35536,22757,69,67
24011,231,26.9,75526,73952,131,100
24012,29572,38.3,44010,23400,14408,15164
24013,7762,36.9,30213,13797,3765,3997
24014,17022,44.4,44574,32789,8016,9006
24015,15825,37.8,51028,31237,7831,7994
24016,8847,35.8,24044,17172,4238,4609
24017,23651,36,34030,17238,10966,12685
24018,37223,44.6,66374,37394,17675,19548
24019,26904,41,62912,28152,12489,14415
24020,379,20.3,-666666666,6258,0,379
24053,2901,41.4,30365,14727,1503,1398
24054,6658,42.2,36909,18008,3263,3395
24055,12890,44.4,31013,17985,6353,6537
24058,387,65.4,58189,28347,176,211
24059,746,45.9,62589,39889,371,375
24060,53541,22.6,39477,21795,29164,24377
24064,4360,47.9,67091,29983,2165,2195
24065,6069,45.7,47414,25005,3054,3015
24066,4569,43.8,48686,23319,2296,2273
24067,2539,43.3,47273,21638,1259,1280
24069,1627,47.8,47957,23507,824,803
24070,1504,44.1,63438,25311,713,791
24072,1390,40.4,40565,18453,503,887
24073,29311,36.6,51055,26819,14033,15278
24076,751,60.5,36726,18462,331,420
24077,1237,40.1,47321,25305,644,593
16141,1977,45.9,41827,28282,1062,915
16142,7487,29,50672,19996,3463,4024
16143,3014,48.1,39652,22437,1570,1444
16145,2537,44.7,44397,22095,1174,1363
16146,13952,39.7,31135,19923,6278,7674
16148,16838,48.7,51451,28524,7911,8927
16150,7282,41,47661,24070,3595,3687
16151,80,37.8,40625,24856,48,32
16153,2686,44.6,50714,22506,1388,1298
16154,2780,49,43750,23026,1425,1355
16155,78,80.6,-666666666,20276,16,62
16156,3015,44.2,48523,23144,1490,1525
16157,3369,46.9,43955,20977,1579,1790
16159,4593,43.9,52556,23992,2141,2452
16160,906,41,34226,18869,470,436
16161,729,47.9,25568,17543,319,410
16201,18057,46.4,44094,24130,9077,8980
16210,1144,38.6,43879,19104,619,525
16211,78,60.7,33977,24497,40,38
16212,317,52.4,34514,21615,173,144
16213,158,34.6,31750,19326,67,91
16214,9584,23.9,32857,20316,4206,5378
16217,140,51.1,29750,16424,62,78
16218,1464,42.7,53000,23212,732,732
16222,2466,40.9,49375,22037,1270,1196
16223,117,42.4,40568,15743,55,62
16224,1328,42,41573,20634,592,736
16226,8062,46.1,40519,23137,3809,4253
16228,427,48.3,40972,19371,174,253
16229,4997,42.8,59394,27331,2535,2462
16230,562,34.9,41471,17501,245,317
16232,4306,42.8,41290,20693,2127,2179
16233,1096,42,52381,27616,537,559
16235,1230,45.2,51188,28386,640,590
16236,494,50.5,52961,17470,251,243
16238,412,46.9,58021,27312,173,239
16239,4147,35.6,38256,7984,3505,642
16240,1373,46.8,45057,22054,710,663
16242,4644,43.9,40385,22287,2220,2424
16244,186,39.9,43690,27134,94,92
16245,170,41.9,31875,21717,88,82
16246,231,42.3,42500,20561,126,105
16248,3242,43.1,42108,19459,1673,1569
16249,2017,42.4,52738,25716,1033,984
16250,166,32.9,12059,9981,82,84
16253,73,50.9,49583,20988,37,36
16254,3500,45.9,45776,26771,1795,1705
16255,1896,43.2,44453,21623,985,911
16256,2074,21.6,31635,11710,1076,998
16258,1852,41,50208,24483,900,952
16259,1959,41.6,46324,21853,1010,949
16260,455,55.2,53229,29078,244,211
16262,2883,46.5,48472,25563,1390,1493
16263,458,27.8,66167,28400,227,231
16301,15540,41.7,39305,21419,7691,7849
16311,562,44.5,42404,23099,298,264
16312,3,-666666666,-666666666,,0,3
16313,2037,42.6,42663,19724,1083,954
16314,5425,43,51111,22529,2721,2704
16316,5382,50,43381,28339,2842,2540
16317,1691,42.5,50417,21774,872,819
16319,1212,45.9,53523,23258,595,617
16321,134,26.7,18523,12066,76,58
16322,162,51.3,40278,21007,64,98
16323,16480,47.6,39895,23051,7895,8585
16326,489,30.4,64079,26276,209,280
16327,3186,40.6,49291,21351,1656,1530
16328,78,55.7,46250,25042,44,34
16329,533,42.3,54688,21458,270,263
16331,66,48.3,53333,22747,32,34
16332,45,27.4,12222,12078,14,31
16333,198,54,42917,23560,107,91
16334,340,39.2,55469,22089,172,168
16335,28314,42.2,40741,23520,13598,14716
16340,1748,50.7,40352,22120,898,850
16341,2026,46.8,38690,21089,955,1071
16342,2354,49.8,45682,22476,1220,1134
16343,333,28.6,26875,13467,195,138
16344,632,33.3,32750,15327,301,331
16345,3334,47.1,57500,30522,1704,1630
16346,3674,41.1,45366,20689,1781,1893
16347,2566,49.3,41161,23080,1357,1209
16350,3010,35.6,47656,21786,1538,1472
16351,1578,48.9,35273,18963,807,771
16352,201,51.4,36429,21054,88,113
16353,3127,52.2,32207,18867,1522,1605
16354,11261,42.1,37837,19611,5515,5746
16360,1417,43.5,46488,21477,726,691
16361,92,56.9,90917,35425,63,29
16362,1259,43.8,50375,21684,619,640
16364,1093,46.5,50208,22601,596,497
16365,18521,44.6,43176,26225,9026,9495
16370,346,40.6,39904,16659,169,177
16371,3308,49.6,38559,22229,1596,1712
16372,435,37.3,33750,20851,216,219
16373,3184,43.6,48098,22052,1590,1594
16374,1940,52.4,45481,25106,992,948
16401,6718,40.8,49663,16659,4314,2404
16402,803,46.3,41339,22092,416,387
16403,7056,38.6,48867,18855,3154,3902
16404,3273,39.2,41250,17758,1644,1629
16405,873,43.6,50188,18226,464,409
16406,3666,43.1,46528,19606,1630,2036
16407,11159,40.7,35840,18490,5489,5670
16410,1772,41.6,55781,22654,852,920
16411,1488,42.9,49602,26189,765,723
16412,10856,32.9,44171,25064,4986,5870
16415,8894,43,72113,33144,4419,4475
16416,275,39.5,70417,20804,143,132
16417,8536,43.7,50101,25227,4075,4461
16420,538,48.7,39000,18506,285,253
16421,2496,45.1,62200,26220,1309,1187
16422,169,60.8,57721,31848,86,83
16423,4492,40.6,47693,21913,2094,2398
16424,4460,48,40643,21448,2207,2253
16426,4150,40.6,54984,28019,2146,2004
16427,261,45.4,33333,20051,142,119
16428,12587,41.3,47867,24366,6276,6311
16433,5189,42.9,45977,22641,2619,2570
16434,3413,24.7,40552,13850,1725,1688
16435,2038,37,44438,20963,1001,1037
16436,560,44.8,47500,19533,284,276
16438,7958,40.9,45550,20358,4127,3831
16440,902,43.2,47222,25485,463,439
16441,9756,43.5,52727,26512,4740,5016
16442,3016,41.9,61171,26629,1550,1466
16443,1235,42.8,36276,20338,719,516
16444,1129,19.7,-666666666,2886,508,621
16501,2106,51.3,10182,12226,875,1231
16502,17146,28.8,27097,15478,8810,8336
16503,15548,29.8,21008,11950,7400,8148
16504,17451,38.4,43042,19967,8336,9115
16505,16746,44.7,54592,35653,8132,8614
16506,23484,43.5,59902,33302,11304,12180
16507,10428,30.5,25347,16867,5401,5027
16508,16627,36.1,42849,22402,8227,8400
16509,27634,44.8,56680,32020,13149,14485
16510,25615,39.4,53021,24746,12874,12741
16511,11664,39,53118,23748,5333,6331
16546,1134,19.6,-666666666,3090,442,692
16563,1601,19.6,-666666666,3492,856,745
16601,33742,38.2,38121,20887,16369,17373
16602,29751,41.7,39170,21777,14508,15243
16611,2537,45.1,42989,23517,1186,1351
16613,1548,41.3,50000,23235,750,798
16616,129,45.3,32917,15895,52,77
16617,2854,36.9,50161,21811,1506,1348
16619,301,37.4,32375,18905,174,127
16620,390,39.8,40714,19245,195,195
16621,652,50.5,44083,21754,317,335
16622,204,40.3,51719,22880,89,115
16623,453,43.9,32396,18402,200,253
16624,235,35,46250,23332,104,131
16625,4007,38.5,37314,19971,2014,1993
16627,2243,44.4,38125,17973,1158,1085
16630,5770,38.7,44247,21680,3009,2761
16631,38,64.4,48125,27087,19,19
16633,158,38.1,26000,11099,71,87
16634,259,49.3,49107,22535,132,127
16635,12412,45.5,48678,29443,6114,6298
16636,801,47.6,42303,21236,427,374
16637,2228,47.6,43158,22797,1033,1195
16638,66,34.5,34375,15982,32,34
16639,1569,47.1,35648,19213,802,767
16640,854,50.4,47361,22436,445,409
16641,2598,41.6,44402,21351,1368,1230
16645,130,60.3,30750,21782,60,70
16646,2533,46.6,47171,23572,1282,1251
16647,563,55,38333,27115,284,279
16648,15122,47.2,56187,33312,7123,7999
16650,1973,43.8,43387,20312,1078,895
16651,6003,38.3,37880,16875,4216,1787
16652,18480,39.1,45803,19243,10829,7651
16655,1539,44,46719,21084,727,812
16656,1546,44.1,37750,17097,807,739
16657,1319,47.4,53209,21956,688,631
16659,320,43.3,51667,24489,165,155
16661,947,43.3,34375,18073,478,469
16662,5975,49.2,44156,24635,2891,3084
16664,1955,38.8,54844,22225,959,996
16665,291,43.3,27188,19095,134,157
16666,3393,39.5,40657,20213,1712,1681
16667,1670,34.9,43162,20333,844,826
16668,3543,45.4,42841,21230,1727,1816
16669,2271,41.4,46023,22760,1099,1172
16670,28,61.5,32917,37150,5,23
16671,555,49.8,43274,23316,271,284
16672,262,41.5,34773,21403,143,119
16673,5302,42.6,45048,23629,2580,2722
16674,664,34.9,33750,17340,326,338
16677,161,43.8,35257,19502,106,55
16678,2735,45.3,37723,20676,1284,1451
16679,862,49.6,32353,16355,422,440
16680,307,51.2,57813,25565,165,142
16682,174,45.7,45563,15346,101,73
16683,434,45.3,59583,26639,242,192
16685,338,39.6,100625,33645,194,144
16686,13071,43,46492,23298,6359,6712
16689,549,46.5,45000,19438,229,320
16691,324,47.5,50625,27673,186,138
16692,736,44.8,36250,19641,371,365
16693,4493,38.3,44861,20457,2272,2221
16694,190,53.5,32500,19462,92,98
16695,1211,38,49861,22186,608,603
16699,820,34.7,-666666666,4506,813,7
16701,17940,40.7,40516,21235,8925,9015
16720,1285,48,37850,20967,660,625
16724,96,55.3,39861,26434,44,52
16725,86,39.5,24000,8200,40,46
16726,550,50.4,55147,22433,300,250
16727,200,56.2,81118,55586,96,104
16728,26,43.6,48750,17565,12,14
16729,685,46.7,42250,25928,336,349
16730,62,62.2,37632,20302,17,45
16731,2883,41.6,44286,23164,1423,1460
16732,309,51.5,40000,21098,169,140
16733,144,26.8,45192,19751,60,84
16734,247,48.9,39554,19191,139,108
16735,6262,44.4,42849,22942,3114,3148
16738,2665,38.2,47167,25046,2046,619
16740,1074,42.1,40179,22136,528,546
16743,3958,43.6,37684,20636,1882,2076
16744,515,37.6,72179,25469,198,317
16745,573,39.2,43958,19936,282,291
16746,1412,43.7,41103,22691,738,674
16748,2809,44.6,40872,20037,1389,1420
16749,4227,44.8,43446,25088,2137,2090
16750,336,45.4,43750,21296,170,166
16801,42463,23.8,39558,25732,23057,19406
16802,12776,19.2,-666666666,2627,6069,6707
16803,24251,27.8,50846,31130,12540,11711
16820,1303,38.6,55947,19439,673,630
16821,302,39.1,61378,24151,150,152
16822,1943,43,50294,22575,963,980
16823,26987,41.2,52517,26140,14238,12749
16825,200,24.4,32875,14037,117,83
16826,638,35.2,43971,19999,278,360
16827,4091,37.1,67241,35113,2166,1925
16828,4731,43.9,60176,29639,2367,2364
16829,641,39.9,54286,24469,329,312
16830,14134,41.9,36713,22779,7106,7028
16832,379,40.1,53750,22653,181,198
16833,5337,46.4,39364,21947,2486,2851
16834,155,58.3,50179,22590,83,72
16835,227,38.5,37500,20249,106,121
16836,1085,46.3,42500,20844,549,536
16837,128,58.5,25521,15360,68,60
16838,1755,39.5,42841,20824,893,862
16839,477,32.7,55250,20788,217,260
16840,587,30.7,30313,14546,283,304
16841,6017,40.8,50826,23859,3052,2965
16843,356,44.9,37344,26196,228,128
16844,3047,40.6,61382,25872,1527,1520
16845,1144,37,52868,19161,702,442
16847,368,53.5,32125,20528,163,205
16848,421,38.5,34844,16888,234,187
16849,327,48.9,41583,23620,158,169
16851,941,32.4,97604,30711,525,416
16852,392,35.1,75179,19366,246,146
16853,171,38.8,37344,21953,72,99
16854,950,37.5,50769,20954,485,465
16855,313,49.5,29712,18202,94,219
16858,4027,43.3,50042,22209,1988,2039
16859,568,38.5,56591,21803,273,295
16860,335,42.5,78348,27568,178,157
16861,281,49.6,30795,18702,151,130
16863,657,50.9,43071,21708,269,388
16865,2042,43.8,72941,35844,971,1071
16866,9974,45,41615,22694,5018,4956
16868,438,51.2,83534,29789,214,224
16870,6735,39.1,84808,37320,3491,3244
16871,29,72.1,25000,15707,17,12
16872,1361,34.4,46713,19061,668,693
16874,1358,44,49050,22919,710,648
16875,3802,46.6,50781,29708,1958,1844
16876,356,44.2,40208,18375,158,198
16877,1657,47.3,57750,33315,869,788
16878,1669,46.9,48325,25143,805,864
16879,495,37.7,45625,19516,252,243
16881,1967,40,40662,19571,1051,916
16882,318,28.9,36250,17146,164,154
16901,10339,48.2,45995,26219,4997,5342
16911,421,35.7,47000,21150,244,177
16912,1900,35.2,44878,22485,998,902
16914,2248,44.1,47670,24797,1024,1224
16915,5900,45.9,44842,25930,2819,3081
16917,1355,41.5,49107,22915,697,658
16920,2213,40.2,40139,20712,1116,1097
16921,592,48.1,38438,19098,279,313
16922,2010,47.4,40859,21457,1007,1003
16923,1546,36.5,42734,20934,811,735
16925,3324,42.2,44306,20763,1709,1615
16926,748,37,45833,20726,343,405
16927,720,41.5,36618,18940,369,351
16928,1401,40.1,43929,20830,701,700
16929,2174,45.5,41589,21790,1075,1099
16930,1348,41,44934,20611,675,673
16932,675,34.2,46477,20612,339,336
16933,7741,29.8,46327,20770,3623,4118
16935,1342,44.1,53125,21258,641,701
16936,2067,47.8,52928,24047,1022,1045
16937,272,29.7,40313,22363,155,117
16938,683,49.8,48304,27965,378,305
16939,416,28.9,30577,14874,213,203
16940,398,37.8,30268,15583,200,198
16941,108,43.3,45625,24706,54,54
16942,665,45.7,43007,20547,326,339
16943,439,55.6,41964,23960,252,187
16946,2238,42.6,37306,22095,1130,1108
16947,5262,46.5,48322,23728,2562,2700
16948,1642,45.5,40917,20704,810,832
16950,3427,45.4,38045,19830,1699,1728
17002,642,38.2,41583,17787,351,291
17003,11855,38.3,57550,25367,5715,6140
17004,5225,32.1,38328,17901,2538,2687
17005,406,43.4,45625,20211,198,208
17006,1029,32.5,45000,17860,501,528
17007,5673,43.4,81445,35865,2597,3076
17009,2004,43.5,38571,21132,962,1042
17010,0,-666666666,-666666666,-666666666,0,0
17011,35184,41.9,63137,33351,18438,16746
17013,34398,38.1,51262,27329,16455,17943
17015,21463,44.9,69937,33793,10615,10848
17016,584,76.2,53529,34958,204,380
17017,1845,46,49125,28592,898,947
17018,4175,47.1,58438,32552,2086,2089
17019,18318,40.7,68684,31345,8841,9477
17020,9098,44.4,63655,29388,4611,4487
17021,905,49.3,35592,20720,473,432
17022,29153,38.8,58074,27205,13691,15462
17023,3559,39.7,54708,25178,1784,1775
17024,2001,41.9,61250,25370,990,1011
17025,16608,39.4,62788,32176,8125,8483
17026,3856,41.3,61250,26245,2024,1832
17027,2340,20.5,57813,12856,1058,1282
17028,3455,43.4,63640,27456,1922,1533
17029,574,37.5,38879,13878,297,277
17030,833,43.7,37465,20600,435,398
17032,8507,44.1,55119,25991,4155,4352
17033,17017,40.4,56177,34662,8052,8965
17034,2366,38.7,39697,23123,1098,1268
17035,755,40.5,35909,16466,363,392
17036,22233,41.1,76077,41536,10876,11357
17037,947,39.7,56118,21348,561,386
17038,8286,38.5,65464,27173,4249,4037
17039,34,45.1,-666666666,23700,10,24
17040,2363,44.7,60078,26138,1186,1177
17041,199,78.1,27099,16629,104,95
17042,37020,42.8,57547,29358,18135,18885
17043,5949,39.3,37229,29191,3103,2846
17044,21029,43.7,37140,21407,10264,10765
17045,3123,44,54167,25944,1595,1528
17046,30706,37.1,43663,21737,14606,16100
17047,2753,33.7,43636,19127,1340,1413
17048,4019,38.2,46762,21132,2017,2002
17049,3150,40.2,45000,23772,1730,1420
17050,34035,43.5,81959,41834,16600,17435
17051,4693,42.6,43234,19984,2404,2289
17052,1563,42.7,45446,18595,792,771
17053,5021,43.5,63159,30270,2357,2664
17055,34135,44.1,62602,36256,16305,17830
17056,81,46.3,45577,28221,25,56
17057,22176,38.6,53069,25704,10711,11465
17058,1927,35.8,38242,18470,1016,911
17059,8134,42.1,48682,21546,3841,4293
17060,1282,42,39500,18871,679,603
17061,6985,46,53165,25666,3460,3525
17062,3944,42.9,58365,24641,1929,2015
17063,3258,40.1,50550,21613,1550,1708
17064,367,56.4,72778,49678,144,223
17065,3989,42.5,54076,27737,1983,2006
17066,5091,45.2,32272,18838,2344,2747
17067,14551,38,53860,26435,6977,7574
17068,4763,37.4,58468,24175,2533,2230
17069,113,49.4,42500,25459,68,45
17070,15582,38.8,62909,31236,7491,8091
17071,107,57.1,27344,19948,76,31
17072,209,28,80694,36112,96,113
17073,5300,38.5,59235,22976,2637,2663
17074,7271,39.8,51361,24419,3474,3797
17075,120,57.4,20625,12959,63,57
17076,41,23.4,-666666666,,30,11
17077,19,53.1,-666666666,,10,9
17078,20198,43.9,58929,32655,9815,10383
17080,295,38.9,43750,19038,151,144
17081,48,70.7,29554,22319,34,14
17082,3302,45.1,46645,22334,1681,1621
17083,66,55.3,40208,23189,35,31
17084,4319,47,45256,23994,2081,2238
17086,2300,40.3,47014,21958,1141,1159
17087,3098,37.1,57101,25321,1650,1448
17088,472,64.3,53594,40445,265,207
17090,5220,41,57530,26928,2677,2543
17093,925,32,82625,23048,404,521
17094,2796,38.9,48250,21390,1379,1417
17097,746,44.6,49904,25655,373,373
17098,2451,41.6,46483,22195,1147,1304
17099,1155,43.6,46736,21274,637,518
17101,1928,41.8,20642,26840,1029,899
17102,8032,36.6,37889,26987,4189,3843
17103,11219,33.4,34200,16457,5413,5806
17104,21123,29.2,30726,15648,9339,11784
17109,23153,39.6,50411,27146,10555,12598
17110,24752,39.6,58440,32084,11784,12968
17111,31984,38.2,66935,31374,15957,16027
17112,33190,43.4,76593,38321,16747,16443
17113,11013,33.4,45808,19122,5026,5987
17120,0,-666666666,-666666666,-666666666,0,0
17201,25341,37.3,42823,21848,11715,13626
17202,30193,42.6,60751,30653,15117,15076
17210,177,39.6,100750,37027,75,102
17211,355,46.8,26667,19954,191,164
17212,877,34.1,51905,19371,474,403
17213,613,44.7,59375,23846,303,310
17214,1158,44.7,52112,29722,572,586
17215,208,47.4,57500,19975,97,111
17217,91,33.2,53500,17300,41,50
17219,404,33.6,41458,16552,164,240
17220,469,19.7,36765,16703,248,221
17221,551,40.8,44926,21034,249,302
17222,10468,47.2,48693,24545,4958,5510
17223,331,48.5,42917,18742,152,179
17224,2111,46.1,49432,23061,1131,980
17225,19718,39.7,60278,28265,9791,9927
17228,1193,37.9,40167,18109,600,593
17229,1296,43.2,49688,22954,643,653
17233,5014,42.9,48411,25049,2503,2511
17235,774,40.1,52989,19456,491,283
17236,8268,42.3,54808,25922,4239,4029
17237,2183,29.1,55446,18740,1021,1162
17238,1463,44.7,48594,23626,754,709
17239,204,51.3,59219,22611,99,105
17240,3365,37.5,56186,22211,1653,1712
17241,11715,40.9,51034,24117,5934,5781
17243,1483,37.9,43558,19828,742,741
17244,2399,40.8,50292,25300,1176,1223
17246,84,55.4,49000,40595,51,33
17247,334,81.6,73191,32884,106,228
17249,268,52,33000,17182,107,161
17250,216,25,49773,19002,107,109
17251,131,44.1,56058,27007,78,53
17252,3476,42.7,55805,23335,1930,1546
17253,286,44,45833,21391,148,138
17254,3,22.5,-666666666,6200,3,0
17255,1222,37.8,43182,22267,574,648
17256,14,-666666666,-666666666,,14,0
17257,28878,28.7,48837,22146,13954,14924
17260,1321,42.2,38229,17910,664,657
17261,252,17.6,-666666666,3755,202,50
17262,1642,34.8,34231,17158,812,830
17263,597,47,63430,37458,430,167
17264,2172,46.6,42688,23348,1107,1065
17265,645,32.9,58333,17996,358,287
17266,610,39.6,57321,25587,282,328
17267,2798,42.2,55417,24119,1413,1385
17268,28007,41.1,52657,25477,13167,14840
17270,171,50,63235,31415,56,115
17271,316,52.4,41667,24156,145,171
17272,238,35.9,56042,24305,159,79
17301,3501,40.7,61607,24933,1658,1843
17302,2787,40.6,59593,26560,1446,1341
17304,2930,41.7,59525,26571,1601,1329
17306,319,42.8,59531,27199,162,157
17307,5995,38.7,55302,24628,2969,3026
17309,1673,52.1,40057,18899,891,782
17311,284,49.4,49063,23102,151,133
17313,10593,42,58089,27163,5120,5473
17314,6009,37.3,60656,25605,3101,2908
17315,26333,41.4,54981,26600,12837,13496
17316,8293,41.3,64172,29992,4157,4136
17317,993,33.1,55938,20044,413,580
17318,262,40.8,56288,27369,140,122
17319,10535,37.6,71335,30061,5034,5501
17320,7797,43.3,71354,31945,3696,4101
17321,2230,40.5,64330,27286,1129,1101
17322,6437,38.3,65139,25827,3343,3094
17324,4095,47,59384,25168,2043,2052
17325,28479,41.5,59529,28096,13555,14924
17327,8190,46.7,67791,32177,3945,4245
17329,2404,44,82474,33079,1245,1159
17331,50336,42,59322,27816,24618,25718
17339,6824,43.9,73365,32950,3482,3342
17340,11025,41.3,61568,27541,5564,5461
17343,41,-666666666,-666666666,,0,41
17344,3443,36.5,48125,23087,1601,1842
17345,7146,39.8,55438,24887,3502,3644
17347,6481,36.2,61559,26010,3277,3204
17349,7280,46.1,77350,34293,3441,3839
17350,13242,41.1,52275,23142,6768,6474
17352,1361,41.7,68125,26177,587,774
17353,3290,42.4,59923,27827,1734,1556
17355,187,40.4,55893,25493,98,89
17356,22171,40.2,57673,26526,11060,11111
17360,5854,38.6,73317,31081,2965,2889
17361,5595,45.5,74684,35488,2818,2777
17362,13941,42.2,65031,27608,7081,6860
17363,9790,44,74559,31985,4697,5093
17364,3634,40.8,60179,23997,1917,1717
17365,2152,46.5,57656,30120,1059,1093
17366,5852,37,53561,23305,2915,2937
17368,6989,42.9,56845,28713,3614,3375
17370,5366,38.5,60909,27719,2873,2493
17371,279,43.6,65313,30717,156,123
17372,4251,40.2,58689,26352,2199,2052
17401,17561,28.8,27050,12698,8637,8924
17402,35126,42.1,60900,31840,17967,17159
17403,39766,37,47155,27185,19043,20723
17404,35687,37.5,52079,26262,17466,18221
17406,22834,42.1,60481,31447,11488,11346
17407,2176,38.6,81875,31484,1145,1031
17408,22377,43.6,63355,30024,10703,11674
17501,4522,41.4,49117,25433,2063,2459
17502,2637,41.9,65250,34550,1254,1383
17505,2216,23.6,69821,21594,1015,1201
17507,26,-666666666,-666666666,,13,13
17508,284,59.1,125087,42004,112,172
17509,4595,28.7,60833,22222,2282,2313
17512,17398,38.8,48042,23250,8198,9200
17516,4788,43.3,59531,27573,2377,2411
17517,15768,38.8,66026,26705,7970,7798
17518,1446,28.1,43077,16594,758,688
17519,6953,31.9,58947,21919,3437,3516
17520,4660,38.6,68587,25146,2295,2365
17522,32475,38,54669,26925,15789,16686
17527,6159,28.9,60262,22976,3115,3044
17529,4349,27.8,53913,19647,2247,2102
17532,3475,39.8,55317,23732,1683,1792
17535,2354,25,58214,19174,1100,1254
17536,2999,29,59177,21763,1629,1370
17538,7040,42.7,84722,35955,3614,3426
17540,9226,33.9,54915,23257,4534,4692
17543,42594,41.3,67111,32475,20644,21950
17545,21542,42.5,59720,27787,10556,10986
17547,6999,36.2,57555,27745,3474,3525
17550,849,33.7,72434,22408,368,481
17551,11012,23.9,51582,22503,5345,5667
17552,19116,40.1,62131,28047,9573,9543
17554,7928,39.1,58125,26184,4014,3914
17555,7525,35.1,66829,24729,3831,3694
17557,14175,37.3,54004,24041,6922,7253
17560,5165,41.2,44836,20831,2511,2654
17562,4604,31.6,61989,22815,2360,2244
17563,3901,33.7,58100,20935,1971,1930
17565,2170,46.3,65313,31292,1137,1033
17566,11974,35.9,54813,23316,5963,6011
17569,5209,38.7,69850,28995,2637,2572
17570,215,42.4,34712,12752,78,137
17572,3575,29.8,60382,23439,1673,1902
17576,207,47.6,62917,17338,140,67
17578,7811,38.8,62784,25072,3790,4021
17579,6029,34.6,66844,24491,3011,3018
17581,914,41.1,57900,22394,470,444
17582,2056,39.9,80574,31851,1023,1033
17584,8876,51.3,65369,31680,4323,4553
17601,48769,44.5,64145,35652,23130,25639
17602,53743,34.2,42364,20820,26697,27046
17603,61719,35.5,44752,24702,29745,31974
17606,592,86.1,26875,19539,179,413
17701,44911,37.5,37456,20733,21668,23243
17702,10564,41.3,45923,23338,5224,5340
17721,1989,34.3,39631,21475,979,1010
17723,55,54.3,36250,24167,26,29
17724,5571,39.9,41232,19898,2793,2778
17727,37,58.3,40938,23881,18,19
17728,5172,45.5,58778,25432,2697,2475
17729,63,59.3,37917,28684,31,32
17730,284,48.4,86115,30743,180,104
17731,159,59.1,51250,30926,75,84
17737,5881,42.3,51007,24229,2868,3013
17739,40,60.5,23750,22653,19,21
17740,12940,38.9,51187,22463,6620,6320
17742,62,32.5,28125,19240,21,41
17744,3109,47,45032,20402,1638,1471
17745,19153,33.6,36547,21788,8977,10176
17747,3231,34.8,52543,19012,1613,1618
17748,245,48.2,23571,23414,103,142
17749,266,43.8,42969,18985,146,120
17750,107,47.5,69844,27541,69,38
17751,7553,41.7,51806,23282,3912,3641
17752,4948,38.1,45988,21764,2440,2508
17754,11917,48.9,57828,31737,5874,6043
17756,12220,42.8,49313,23331,5594,6626
17758,912,51.7,40625,23449,450,462
17760,550,48.6,48269,26150,279,271
17762,524,40.3,70833,24126,258,266
17763,422,40.4,34583,19256,231,191
17764,2212,47.7,27630,16997,1077,1135
17765,926,42.6,50455,24797,487,439
17767,84,54.7,46023,26921,55,29
17768,216,54,29531,16666,112,104
17771,3487,44,48418,22902,1756,1731
17772,2500,39.6,55719,25770,1302,1198
17774,1261,35.7,45795,20033,635,626
17776,267,57.6,42500,21896,146,121
17777,7324,40,45777,23509,3725,3599
17778,75,62.8,26875,30791,33,42
17779,165,32,52500,22819,73,92
17801,16142,41.9,35870,21392,7787,8355
17810,6033,37.9,58207,12523,4753,1280
17812,1439,42.2,45000,18440,723,716
17813,1966,37.7,44868,20801,975,991
17814,4476,45.2,45270,21918,2302,2174
17815,31207,32.1,44521,23296,14799,16408
17820,5587,45.4,47813,25460,2814,2773
17821,18604,43.5,53067,30955,8845,9759
17822,0,-666666666,-666666666,-666666666,0,0
17823,1223,41.4,47917,20154,603,620
17824,3835,50.6,53640,28584,1780,2055
17827,681,42.4,43375,22351,352,329
17829,259,32.3,42917,17913,146,113
17830,1956,46.4,45938,23697,960,996
17832,670,42,32656,23348,338,332
17834,3603,41.9,45772,23078,1660,1943
17835,152,47.7,44375,25198,89,63
17836,206,34.6,56875,26617,96,110
17837,20017,34.8,48878,23530,10432,9585
17840,511,36.9,37159,16527,275,236
17841,4894,41.2,46875,19385,2469,2425
17842,8646,41.4,45859,22201,4396,4250
17844,10012,38.3,46512,24106,5066,4946
17845,2244,43.3,40988,20469,1138,1106
17846,3537,46.6,43276,25685,1715,1822
17847,12150,42.1,43484,22843,5818,6332
17850,602,41.4,36161,17109,278,324
17851,7741,46.8,33101,21099,3582,4159
17853,3351,38.9,45691,19667,1672,1679
17855,959,39.8,51667,25716,506,453
17856,3627,42.9,54261,25772,1837,1790
17857,7501,46.1,50952,25778,3743,3758
17859,3062,48,53550,27479,1465,1597
17860,2138,50.3,53311,25800,1114,1024
17861,78,59.8,70417,26112,42,36
17862,444,31.1,37292,18047,245,199
17864,2543,33.6,44806,17141,1381,1162
17865,143,35.9,54583,17618,60,83
17866,10474,41.6,34508,16618,6591,3883
17867,175,46.3,63333,32187,90,85
17868,1091,45.6,51397,28293,518,573
17870,14941,38,48561,26572,7240,7701
17872,9934,42.2,37212,20177,5066,4868
17876,1628,54.7,48235,28755,723,905
17878,1382,48.5,50365,25525,654,728
17880,70,51,26250,14127,32,38
17881,1461,45.3,33512,20535,641,820
17884,229,45.6,29141,17364,100,129
17885,187,57.3,58542,19654,111,76
17886,860,40.1,41149,18563,474,386
17887,215,58.2,27452,18487,105,110
17888,280,44.7,44375,22341,157,123
17889,2662,45.1,51541,24837,1179,1483
17901,23985,43.7,41063,23348,11545,12440
17920,336,41.6,46875,21300,166,170
17921,7252,43.8,47956,22013,4353,2899
17922,4930,43.6,60270,27885,2584,2346
17923,359,49.1,40804,23852,193,166
17925,406,36.2,45625,18919,207,199
17929,1805,40,53468,23951,916,889
17930,399,38.4,33594,19534,231,168
17931,8713,39.9,41091,16470,5897,2816
17933,66,44.8,-666666666,44289,33,33
17934,490,44,28125,15552,258,232
17935,1617,46,39792,20737,754,863
17936,836,33.6,40833,20345,397,439
17938,2489,42.7,58409,23520,1119,1370
17941,828,41.3,42813,21586,421,407
17943,336,57.2,51250,21805,201,135
17944,259,29.5,42500,18047,113,146
17945,177,49.1,42986,21099,75,102
17946,215,62.1,15469,10440,90,125
17948,4917,39.2,28725,16369,2348,2569
17949,277,37.2,52875,17157,155,122
17951,303,36.8,48571,19053,125,178
17952,211,58.5,22500,16628,77,134
17953,430,49,41875,20386,205,225
17954,4512,40.4,36588,20161,2166,2346
17957,281,51.9,34479,28140,135,146
17959,1428,47.3,42500,23351,686,742
17960,3864,46.6,49911,26896,1989,1875
17961,7012,46.2,63971,35487,3287,3725
17963,9482,42.8,58447,25115,4842,4640
17964,748,40.3,46000,21392,372,376
17965,2042,42.6,41053,22358,1040,1002
17967,2305,49.3,44728,24537,1156,1149
17968,359,34.5,62813,22531,162,197
17970,3350,41.4,34358,18192,1615,1735
17972,10958,43.3,51074,26776,5375,5583
17974,222,61.4,40227,22089,98,124
17976,6929,40.8,30261,17506,3660,3269
17978,156,44.7,30341,24763,87,69
17979,88,76.2,48669,32502,44,44
17980,2963,45.3,50240,24934,1492,1471
17981,2712,43.9,43289,21464,1370,1342
17982,481,38.4,31964,19742,242,239
17983,1478,53.8,42132,24229,709,769
17985,1203,45.5,52895,26520,602,601
18011,5548,40.2,71432,29676,2704,2844
18013,17971,42.8,57550,27196,8883,9088
18014,11513,44.9,52755,25248,5603,5910
18015,31728,30.9,44933,22662,16628,15100
18016,0,-666666666,-666666666,-666666666,0,0
18017,37274,44,62882,31975,17568,19706
18018,32977,37.4,46567,25184,15282,17695
18020,20387,45.6,78938,36043,9699,10688
18030,664,40.8,40625,20843,357,307
18031,7601,35.5,74469,32356,3794,3807
18032,9316,42,49653,25074,4402,4914
18034,8573,36.4,87063,41476,4132,4441
18035,169,37.6,87083,43851,118,51
18036,12607,46,79951,37215,6559,6048
18037,7240,43.7,58438,29588,3660,3580
18038,2708,45.7,64821,28662,1387,1321
18040,15993,41.2,91238,37722,7858,8135
18041,5298,41.7,68279,30903,2589,2709
18042,41921,35.2,45441,23227,20627,21294
18045,26145,44.9,76341,34821,12727,13418
18046,0,-666666666,-666666666,-666666666,0,0
18049,17302,42.2,63636,32830,8536,8766
18051,3790,42.2,98021,44494,2124,1666
18052,26971,41.6,55861,28067,13112,13859
18053,2632,42,64405,28456,1208,1424
18054,4329,46,71630,31575,2105,2224
18055,12665,43.4,61265,32546,6244,6421
18056,737,55,48074,25188,394,343
18058,9671,44,59261,25950,4477,5194
18059,1159,42.6,107917,32669,617,542
18062,24419,42.1,73263,36368,12135,12284
18063,586,55.2,45234,25383,300,286
18064,24472,44,75629,31740,11852,12620
18066,5800,44.3,77566,32984,2765,3035
18067,18252,42,62518,29490,8955,9297
18068,151,-666666666,-666666666,,48,103
18069,8031,43.7,80718,39702,4099,3932
18070,875,42.4,59917,24433,411,464
18071,10460,44.6,49361,26741,5260,5200
18072,6486,41.9,55941,28153,3203,3283
18073,9675,39.8,78720,31870,4569,5106
18074,6191,41.9,84482,34444,3084,3107
18076,2906,37.5,57011,29039,1495,1411
18077,2345,44.5,68125,37426,1221,1124
18078,7228,43.5,77198,35110,3572,3656
18079,245,47.2,85237,28840,110,135
18080,11650,43.9,58415,26082,6029,5621
18081,270,51.8,45068,19769,103,167
18083,532,36.2,32440,23650,245,287
18085,962,41,69063,29834,482,480
18086,602,45.3,79107,24964,288,314
18087,716,30.6,44900,18495,409,307
18088,8275,46.7,61140,30906,4161,4114
18091,5932,45.2,46409,25585,2680,3252
18092,3176,47.9,80288,38407,1566,1610
18101,4739,30.7,17250,10749,2909,1830
18102,47576,28.6,26575,12853,22850,24726
18103,48527,38.2,48289,24848,22619,25908
18104,43409,43.8,67929,34072,20511,22898
18105,67,87.1,-666666666,28281,25,42
18106,6961,44.3,74702,35046,3390,3571
18109,16312,35.4,38506,18555,8045,8267
18195,0,-666666666,-666666666,-666666666,0,0
18201,27647,38.3,32720,17994,13802,13845
18202,11738,42.7,33246,19271,5432,6306
18210,7676,40.2,52460,22404,3644,4032
18211,1303,49.5,76010,26819,599,704
18212,128,39.2,77569,27048,56,72
18214,2243,43.8,59779,24613,1231,1012
18216,996,50.4,42250,23114,497,499
18218,2374,43.1,30773,17245,1155,1219
18219,1400,52.2,56080,32151,705,695
18220,361,41.4,46750,26937,193,168
18221,501,42,59722,19450,277,224
18222,9432,43.4,67753,30915,4747,4685
18223,122,43.7,49458,37056,66,56
18224,5576,44.8,39900,22689,2607,2969
18225,43,-666666666,-666666666,,43,0
18229,9531,43.9,58315,27133,4938,4593
18230,63,43.9,36875,25403,29,34
18231,658,40.3,39890,20585,327,331
18232,3914,42.7,32436,16509,1937,1977
18234,419,33.2,65821,21880,136,283
18235,19323,45.7,51865,25112,9222,10101
18237,3848,39.1,42140,20172,1811,2037
18239,433,29.1,40398,11212,207,226
18240,3835,51.5,39641,23673,1886,1949
18241,825,39.3,39432,18000,388,437
18242,207,45.3,25833,17758,87,120
18244,451,38.9,41711,21355,251,200
18245,546,46.6,58095,24269,319,227
18246,162,44.6,57857,20767,69,93
18248,572,41.6,52105,24070,290,282
18249,3691,44,65795,34454,1948,1743
18250,3020,37.7,49904,26066,1574,1446
18251,108,53.8,75536,35700,67,41
18252,11174,45.1,37003,20950,5393,5781
18254,862,46.1,44130,23577,474,388
18255,4399,46.4,50867,23999,2178,2221
18256,419,51.4,50700,20038,201,218
18301,28426,36.6,57945,24616,13753,14673
18302,17418,38.8,58935,26916,8964,8454
18321,1825,44.6,56750,31301,913,912
18322,2779,46,50188,25077,1260,1519
18323,67,39.8,73750,53346,32,35
18324,10193,41.6,60587,23979,4648,5545
18325,2605,40.6,56580,28376,1281,1324
18326,4589,45.7,64773,28561,2201,2388
18327,596,43.2,39000,27313,285,311
18328,7398,41.5,58110,23445,3605,3793
18330,9412,35.5,64132,23436,4607,4805
18331,1056,46,32708,21017,587,469
18332,3080,37.6,52442,22808,1295,1785
18333,453,41.7,58839,22034,234,219
18334,4014,38.9,51233,20411,1995,2019
18335,525,45.5,52440,22280,274,251
18336,4158,44.6,50536,24871,1854,2304
18337,14527,44.5,71836,31062,7433,7094
18340,141,49.8,90938,29916,65,76
18342,382,41.8,46806,34203,171,211
18343,3773,47.9,62420,33797,1875,1898
18344,3390,37.6,50385,30085,1630,1760
18346,2925,37.8,59083,21447,1462,1463
18347,2397,49.3,51638,27940,1320,1077
18349,226,65,54375,33108,93,133
18350,2026,46.3,54265,28376,1178,848
18351,570,37,42500,23054,251,319
18352,1364,29,46400,23507,678,686
18353,12005,45.3,64063,26058,6165,5840
18354,645,43.9,52262,31206,296,349
18355,1286,49.3,62240,29063,535,751
18356,272,43.9,132612,28300,186,86
18357,271,46.5,71434,28951,127,144
18360,28061,43.4,57003,28597,13956,14105
18370,930,46.7,58969,44533,502,428
18371,631,41.9,74155,33816,199,432
18372,3035,39.5,54884,27674,1537,1498
18403,6998,41.6,46926,25988,3396,3602
18405,2666,43.9,54265,24602,1446,1220
18407,13779,43.1,37065,21727,6849,6930
18411,22163,43.8,70405,39090,10602,11561
18413,146,43,38875,27969,97,49
18414,5392,48,63802,33817,2732,2660
18415,1075,57.7,43802,28885,578,497
18417,1217,50.6,41290,25320,605,612
18419,4778,39.1,53750,25057,2260,2518
18420,57,31.9,40694,17326,29,28
18421,4625,44.7,46725,24855,2234,2391
18424,5046,46.6,49795,27143,2637,2409
18425,1481,36.9,43295,21364,779,702
18426,4604,49.1,47165,25371,2628,1976
18427,188,26.6,31528,9460,85,103
18428,11540,49.6,55092,29440,6062,5478
18430,21,65.1,14583,7476,7,14
18431,13089,44.6,43906,23436,6173,6916
18433,6882,44.6,46472,25685,3230,3652
18434,4232,39.2,46344,21951,2051,2181
18435,747,38.7,57750,27230,378,369
18436,14212,45.5,55929,25141,7238,6974
18437,179,54.9,30000,20454,79,100
18438,937,58.8,42154,35740,436,501
18439,430,44.5,54038,28798,215,215
18441,343,34,24125,14720,142,201
18443,346,57.7,66375,43280,193,153
18444,14054,43.3,64099,30030,7048,7006
18445,2222,40.2,49922,21985,1166,1056
18446,3916,44.3,44519,22582,1913,2003
18447,10160,44.6,47242,24913,4714,5446
18451,398,59.2,44375,29780,183,215
18452,5010,52.7,38826,25039,2395,2615
18453,1097,50.8,55833,27936,552,545
18454,28,56.5,42750,37282,10,18
18455,102,30.6,73276,35196,54,48
18456,456,39.8,60368,28567,221,235
18457,73,72.4,56042,27048,47,26
18458,3040,45,52656,30760,1517,1523
18459,63,61.1,27813,15283,20,43
18460,231,55.8,51979,23631,129,102
18461,325,54.3,36563,43322,172,153
18462,403,48.5,41071,23011,189,214
18463,262,45.5,57273,37327,136,126
18464,1147,45.4,59000,30877,535,612
18465,1588,45.7,47292,23845,777,811
18466,17450,35.1,54458,20815,8781,8669
18469,475,49.5,46406,22651,208,267
18470,2116,50.7,54954,29750,1083,1033
18471,610,47.8,121771,50288,304,306
18472,7415,42.3,47560,15284,5210,2205
18473,432,41.8,50052,27326,206,226
18503,1141,53.7,15724,15557,727,414
18504,21199,40.9,41693,21502,9844,11355
18505,20933,40.3,38796,21924,9704,11229
18507,4745,46.4,51032,37044,2363,2382
18508,11644,42,36118,19832,5494,6150
18509,13612,35.2,43648,23041,6544,7068
18510,14577,27,39109,17888,7035,7542
18512,11989,42.6,44688,26160,5675,6314
18517,4959,45.4,41901,23472,2323,2636
18518,8299,43.6,49347,26281,4220,4079
18519,4838,41.6,38990,24672,2309,2529
18602,339,53.1,102857,49252,180,159
18603,19334,43.2,42966,22815,9053,10281
18610,4813,41.9,52468,21659,2318,2495
18612,17393,42.9,61291,29950,8846,8547
18614,2744,47.6,39464,21667,1461,1283
18615,1745,49.1,51094,30046,855,890
18616,527,56.5,32212,21933,235,292
18617,1851,44.3,26435,15633,1011,840
18618,3769,46.7,59798,30699,1819,1950
18619,202,43.8,46406,22188,116,86
18621,5934,43.2,44093,19799,3618,2316
18622,260,45.6,31944,16972,125,135
18623,2489,47.2,43989,22618,1260,1229
18624,656,47.1,61563,34485,323,333
18625,452,56.1,55078,32975,225,227
18626,676,54.8,53333,26711,317,359
18628,291,53.1,40625,23538,111,180
18629,1694,46.7,48787,23981,872,822
18630,3325,38.6,49808,24959,1656,1669
18631,1380,49.5,58791,28561,726,654
18632,403,51,36406,26556,229,174
18634,13752,44,37220,21710,6427,7325
18635,4049,44.4,45651,23664,1908,2141
18636,1507,44,54569,24908,804,703
18640,17219,45.5,44152,26850,8127,9092
18641,7378,43.9,46379,24538,3566,3812
18642,3887,43,42139,26017,1919,1968
18643,12555,45.1,50817,28992,6069,6486
18644,7195,46.5,48576,31477,3435,3760
18651,8587,42.9,34250,20256,4104,4483
18653,114,32.3,41667,19475,43,71
18655,6471,43.4,48542,23326,3315,3156
18656,2404,42.4,54615,25473,1238,1166
18657,12270,42.4,50278,25371,6266,6004
18660,3254,45.2,53125,25319,1632,1622
18661,5332,48.4,44919,25361,2621,2711
18701,3198,21,15227,9771,1534,1664
18702,41119,37.2,37212,21122,20339,20780
18704,31356,44.8,47977,26762,14671,16685
18705,14066,44,38834,22929,6858,7208
18706,16176,44.8,39239,23837,7644,8532
18707,15939,42.5,75613,34007,7693,8246
18708,10121,41.9,75254,33285,5592,4529
18709,2910,36.6,31667,20642,1400,1510
18801,8701,46,49944,25038,4399,4302
18810,5876,42.6,43193,22259,2639,3237
18812,1566,49.5,65556,31229,808,758
18814,172,25.5,44688,15393,88,84
18816,169,34.1,42188,21167,74,95
18817,207,39.6,35781,21149,75,132
18818,1361,43.6,50789,23056,733,628
18821,1152,52.5,35875,22776,663,489
18822,3651,40.8,47520,19829,1757,1894
18823,161,56.6,43472,25074,69,92
18824,1341,46.2,48654,23538,748,593
18825,138,50.8,47813,21312,64,74
18826,1600,53,51111,27375,806,794
18828,224,50.5,34750,25537,109,115
18829,799,43.4,47750,24678,416,383
18830,792,55.3,55125,30773,410,382
18831,952,50.9,39474,22591,430,522
18832,1920,37.6,47198,22423,1060,860
18833,1964,43.6,45850,23156,974,990
18834,3712,43.3,52028,26002,1956,1756
18837,3158,40.7,45161,22481,1559,1599
18840,11177,44.1,48731,24824,5503,5674
18842,284,36,53542,22493,124,160
18843,145,54.4,49097,30173,74,71
18844,2005,39.7,60294,23830,960,1045
18845,360,46.7,50179,28033,192,168
18846,851,42.8,55781,23825,451,400
18847,5888,44.3,38404,20544,2916,2972
18848,8997,45.3,48580,25816,4497,4500
18850,2151,41.9,50234,23291,1095,1056
18851,879,46.3,44000,22332,452,427
18853,4449,42.9,55795,26548,2259,2190
18854,1360,43.7,52750,29184,699,661
18901,27725,44.7,84056,44656,13423,14302
18902,20820,41.5,113606,48011,10334,10486
18912,8,-666666666,-666666666,,3,5
18913,76,33.1,185337,98600,45,31
18914,21694,39.4,101522,40247,10631,11063
18915,882,48.1,94844,54488,436,446
18917,2286,34.2,52109,27434,1200,1086
18920,226,51.1,98194,49615,134,92
18923,928,36.7,115221,48905,526,402
18925,6497,41,125750,54982,3251,3246
18929,8435,41.6,133226,50080,3929,4506
18930,2358,51.3,83438,39453,1196,1162
18932,470,37.9,75750,28028,205,265
18935,21,-666666666,-666666666,,10,11
18936,55,27.9,-666666666,29545,41,14
18938,14105,49.6,96685,63400,7207,6898
18940,29183,44.6,114423,59217,14453,14730
18942,3275,47.4,72442,33596,1648,1627
18944,24984,41.4,78312,33220,12144,12840
18947,6864,42.6,115725,44258,3391,3473
18950,194,55,133800,52311,88,106
18951,34354,41,66162,31745,16939,17415
18954,9660,44.3,120959,48227,4706,4954
18955,1455,41.6,63629,27041,663,792
18960,12566,44.9,68159,32062,6054,6512
18962,602,43.6,64712,32775,318,284
18964,13955,42.8,71442,33105,6642,7313
18966,38010,45.9,88549,39848,18624,19386
18969,14791,41.5,75465,34977,7286,7505
18970,813,36.6,69286,27014,416,397
18972,3698,46.4,62689,31807,1839,1859
18974,41325,44.4,66758,32311,19679,21646
18976,19464,41.4,89817,39006,9427,10037
18977,3917,48.7,150104,67048,1890,2027
18980,551,44.4,96000,36748,268,283
19001,17115,40.8,68345,32315,8422,8693
19002,33342,43.3,100326,55129,16267,17075
19003,12674,37.9,76496,42921,6005,6669
19004,9492,43.3,104933,64883,4622,4870
19006,21048,46.6,90234,44492,10529,10519
19007,20703,39.3,48032,22525,10118,10585
19008,20572,45.6,72580,34253,9940,10632
19009,982,35.6,76111,28317,495,487
19010,20900,36.5,103737,61752,8797,12103
19012,6754,40.4,86555,36557,3277,3477
19013,35451,30.8,27289,15507,16167,19284
19014,21067,38.5,75373,30987,10363,10704
19015,16313,38.1,55788,26640,7939,8374
19017,366,44.4,77107,41578,190,176
19018,23283,37.1,56264,27004,10576,12707
19020,55650,39.3,60657,29519,27883,27767
19021,10105,40.5,57052,24814,5260,4845
19022,3561,37.9,39243,17644,1655,1906
19023,22710,30.2,38790,18351,10928,11782
19025,5558,44,110000,53710,2613,2945
19026,30324,37.9,66783,32455,14493,15831
19027,19494,41.9,69793,42082,9138,10356
19029,3973,40.4,50756,27842,2092,1881
19030,12249,41.1,61776,26803,6000,6249
19031,4678,47.9,82917,46519,2079,2599
19032,6617,35.1,54388,22878,3237,3380
19033,8669,38.7,63216,28273,4279,4390
19034,5641,44,112813,59408,2701,2940
19035,3528,52.2,161667,121659,1659,1869
19036,12789,40.2,53364,27236,6051,6738
19038,31405,41.2,82275,37562,14586,16819
19040,20318,40.5,69807,32556,9511,10807
19041,6132,43.1,123080,75511,2696,3436
19043,2370,35.4,49231,27149,1057,1313
19044,16294,36.9,68913,34778,7922,8372
19046,17685,45.7,78715,50701,8330,9355
19047,35202,42.9,81100,37203,17240,17962
19050,27743,40,55530,28746,13134,14609
19053,26005,41.7,74219,31582,12148,13857
19054,17607,40.1,67637,26484,8617,8990
19055,13223,41.1,64422,25657,6929,6294
19056,15616,40.8,69314,29481,7631,7985
19057,18171,38,62863,25069,8806,9365
19060,11321,43.8,123227,48125,5761,5560
19061,20087,38.5,56412,25904,9341,10746
19063,35666,45.5,87347,45554,16862,18804
19064,24689,43.5,93000,37598,12152,12537
19066,6212,40.7,191711,73281,2913,3299
19067,50790,42.1,91182,47323,24866,25924
19070,7043,45.5,67284,31451,3295,3748
19072,9129,45.5,107959,70532,4056,5073
19073,18629,47.7,98297,57295,9059,9570
19074,5894,40.7,69423,28619,2801,3093
19075,7390,39.9,90132,38231,3585,3805
19076,6606,36.2,67727,26908,3518,3088
19078,10988,40.3,57211,29488,5573,5415
19079,9309,32.8,41096,18982,4092,5217
19081,9875,39.6,90275,42692,4636,5239
19082,41431,32.2,38029,17989,19840,21591
19083,36111,40.4,90946,38286,17583,18528
19085,8602,21.6,178233,61416,4300,4302
19086,11402,45.6,91318,43986,5378,6024
19087,32663,40.1,108409,59529,15497,17166
19090,19147,39.7,66857,31724,9147,10000
19094,4544,38.2,47395,24708,2192,2352
19095,7549,42.3,67170,39796,3396,4153
19096,13967,45.5,111563,66800,6374,7593
19102,4056,30.9,76962,70711,2105,1951
19103,22427,34.1,63709,68578,9686,12741
19104,52800,22.3,19236,11836,26439,26361
19106,11424,36.1,93720,82017,6004,5420
19107,12327,30.1,44402,35509,6108,6219
19109,0,-666666666,-666666666,-666666666,0,0
19111,68620,34.4,44123,21079,33126,35494
19112,0,-666666666,-666666666,-666666666,0,0
19113,117,60.1,106250,33686,51,66
19114,30651,42.1,54074,28077,15300,15351
19115,33780,44.9,45799,27954,16420,17360
19116,31763,43.2,48058,26328,14934,16829
19118,9626,41.8,77271,61192,4203,5423
19119,29017,42,58378,35681,13355,15662
19120,76430,28.5,33966,14324,36133,40297
19121,33543,25.8,16105,11873,15298,18245
19122,19784,25.7,23509,13115,9188,10596
19123,13285,32.5,48798,33206,6294,6991
19124,64044,31.7,28726,14414,29974,34070
19125,23070,33.3,41186,22917,11663,11407
19126,16282,37.4,40031,20646,7846,8436
19127,5457,27.3,63849,36087,2546,2911
19128,35720,34.8,62052,35202,17788,17932
19129,11582,31.9,49807,31388,5534,6048
19130,25731,32.6,62721,46026,13037,12694
19131,42194,36.3,27914,19513,19396,22798
19132,36218,35.1,24233,13833,16279,19939
19133,25881,28.6,14185,8811,11522,14359
19134,61108,29.7,24291,12497,30380,30728
19135,32336,34.1,35859,17186,15207,17129
19136,36865,35.2,44641,21065,19348,17517
19137,8439,40.1,43522,20537,4225,4214
19138,34573,35.4,34795,17655,14529,20044
19139,43181,32.1,24627,14663,19024,24157
19140,53778,32.6,22654,12868,24925,28853
19141,32058,35.5,29601,16882,14509,17549
19142,29381,28.6,30306,13451,13852,15529
19143,66372,33.4,30995,18891,29762,36610
19144,44380,34.9,29961,20248,20126,24254
19145,47776,35.2,35761,21173,21735,26041
19146,34837,33.2,42068,32882,16047,18790
19147,35014,34.7,60400,41669,17680,17334
19148,51455,36.2,39413,21209,25389,26066
19149,53731,32,36906,17559,25536,28195
19150,24273,43.3,46462,24486,10688,13585
19151,32824,34.9,40358,20171,14061,18763
19152,33238,40.8,50584,24346,16007,17231
19153,12053,39.5,47138,23795,5794,6259
19154,33419,38.9,58319,26175,16349,17070
19301,6247,46.8,98148,53205,3060,3187
19310,2919,34.2,66354,25047,1517,1402
19311,9094,33.2,93628,37668,4559,4535
19312,11604,45.7,123777,67228,5438,6166
19316,94,48.7,133828,65614,49,45
19317,9453,46.2,106667,58817,4359,5094
19319,1097,20.1,70536,8058,441,656
19320,52798,37.5,67460,30225,26016,26782
19330,5495,44.2,68772,32209,2684,2811
19333,6935,39.9,96346,64526,3072,3863
19335,46691,40.2,91997,42761,23084,23607
19341,16916,38.8,90114,45002,8580,8336
19342,18709,47.7,80429,47594,9264,9445
19343,8432,43,109583,43487,4110,4322
19344,11947,40.5,59896,28406,5614,6333
19345,734,20.5,-666666666,5301,131,603
19348,21798,42.8,90196,46817,10927,10871
19350,11406,42.3,126621,53742,5762,5644
19352,10466,26.9,121241,33561,5331,5135
19355,24743,41.5,109706,56243,12410,12333
19358,479,35.9,46875,23117,234,245
19362,6270,36.4,61920,23813,3250,3020
19363,17104,34,62548,25591,8250,8854
19365,6929,35.4,67829,27623,3465,3464
19367,104,41.2,16587,19515,61,43
19372,1536,35.3,75347,44586,882,654
19373,4693,36.1,177813,38792,2934,1759
19374,1498,36,95519,24826,1036,462
19375,74,33.4,-666666666,38799,47,27
19380,50098,40.7,84843,44922,24462,25636
19382,53404,37.6,90873,44086,26116,27288
19383,2902,19.4,-666666666,2850,1179,1723
19390,13606,39.2,77462,33946,6517,7089
19401,41799,34.6,48791,24341,21095,20704
19403,44773,41.7,76178,38474,22592,22181
19405,5252,34.1,50450,30681,2909,2343
19406,23327,38.8,74104,40865,11348,11979
19422,18485,44.8,106803,58384,8957,9528
19425,14067,38.7,150192,57231,7271,6796
19426,39344,37,108814,39990,20555,18789
19428,16650,34.7,75136,40654,8142,8508
19435,198,70.1,34694,34581,65,133
19436,605,84.1,54519,56688,158,447
19437,615,60.3,215338,112033,301,314
19438,24283,40.3,90449,40360,11809,12474
19440,18191,42.1,74223,34067,9080,9111
19442,0,-666666666,-666666666,-666666666,0,0
19444,10584,43.1,115993,56982,4960,5624
19446,55090,42.1,76263,39942,27110,27980
19453,1348,47.4,50000,32745,648,700
19454,27927,40.4,87658,41541,13323,14604
19456,774,31.8,118689,33766,410,364
19457,193,51.3,68929,30216,160,33
19460,40163,38.9,79227,42414,19509,20654
19462,14845,42.4,86552,40209,7046,7799
19464,45593,38.6,55900,28301,22288,23305
19465,17053,43.2,81998,37752,8304,8749
19468,25668,40.7,71923,35389,12442,13226
19472,34,-666666666,-666666666,,34,0
19473,15891,39.6,89224,36680,7799,8092
19474,519,54.2,106607,53276,194,325
19475,11550,42.9,61117,35537,5976,5574
19477,152,42.7,-666666666,34505,75,77
19492,391,65.9,63269,29597,157,234
19501,898,38.4,44886,25581,479,419
19503,1380,35.5,56505,22022,732,648
19504,5377,41.7,76698,33415,2642,2735
19505,2944,47.5,60511,28656,1532,1412
19506,7167,43.2,65797,27802,3649,3518
19507,3483,40.9,57067,24278,1665,1818
19508,15646,43.5,74730,35038,8224,7422
19510,7466,38.6,77520,30379,3497,3969
19511,218,68.3,70898,32402,97,121
19512,17055,44.9,57335,28671,8192,8863
19518,14789,39.9,76946,32060,7471,7318
19519,95,45.4,-666666666,15343,39,56
19520,5639,47.3,68688,37560,2798,2841
19522,15082,44,67914,30166,7364,7718
19523,316,28.9,66528,24957,165,151
19525,14562,40.5,89503,33849,7275,7287
19526,11487,44.4,56426,27261,5536,5951
19529,3233,45.1,58710,32194,1588,1645
19530,15941,24.4,57153,22125,7077,8864
19533,8077,40.6,60870,23810,4621,3456
19534,2026,41,64479,31339,1106,920
19535,48,58.5,-666666666,89125,23,25
19536,437,45.5,44464,27310,216,221
19538,46,65.1,-666666666,53348,23,23
19539,4783,43.6,72788,29886,2346,2437
19540,11689,42.9,68306,34255,5971,5718
19541,3971,42.2,74000,29330,2231,1740
19542,0,-666666666,-666666666,-666666666,0,0
19543,6029,35.5,76124,31348,3071,2958
19544,152,46.7,58125,25689,62,90
19545,498,41.7,57765,33526,231,267
19547,4250,43.6,72292,30675,2251,1999
19549,268,38.2,48472,20794,123,145
19550,591,33.9,39318,14556,407,184
19551,5021,46.2,62685,27996,2527,2494
19554,345,48,57188,31415,208,137
19555,3458,45.1,53958,27142,1697,1761
19559,273,39.9,64375,39948,143,130
19560,7776,40.7,64183,28967,3857,3919
19562,2609,44.9,59542,28118,1145,1464
19564,54,61.3,38542,27159,23,31
19565,8774,45.3,56201,27088,4200,4574
19567,5248,41.4,58101,26669,2699,2549
19601,33574,30.3,23935,12862,16926,16648
19602,17433,30.2,21795,12447,8366,9067
19604,26983,28.3,35337,13894,13495,13488
19605,19205,44.6,58033,28147,9170,10035
19606,34724,39.6,64047,29429,16640,18084
19607,22062,41.8,53919,29906,10075,11987
19608,22354,41.3,77551,34872,10716,11638
19609,9530,41,55231,28866,4574,4956
19610,15757,46.2,69179,44948,7508,8249
19611,10845,32.2,40317,18047,5047,5798
19701,41159,35.9,83056,32424,20544,20615
19702,52830,33.3,67510,29998,25751,27079
19703,14806,36.4,51739,25256,7108,7698
19706,2204,42.2,71691,25530,1085,1119
19707,15675,46.1,113206,55653,7538,8137
19709,37173,36.7,94886,35266,18336,18837
19710,18,-666666666,-666666666,,9,9
19711,50844,35.1,72209,36700,24679,26165
19713,30969,36.1,57044,28559,15033,15936
19716,1330,19.9,-666666666,3408,598,732
19717,3951,19.1,2499,2607,1748,2203
19720,59808,36.3,54233,23410,28688,31120
19730,484,55.8,64149,34373,244,240
19731,141,49.5,41786,34440,63,78
19732,82,57.3,-666666666,41126,43,39
19733,253,37,52188,21957,98,155
19734,10955,38,85283,30784,5230,5725
19735,0,-666666666,-666666666,-666666666,0,0
19736,0,-666666666,-666666666,-666666666,0,0
19801,15656,32,27394,18082,7459,8197
19802,25396,35.6,40394,20879,11507,13889
19803,21373,46.8,97944,52285,10119,11254
19804,18027,39.8,53809,25509,8499,9528
19805,40586,32.5,41980,21297,19095,21491
19806,9864,45,65051,58977,4744,5120
19807,7236,48.6,172865,106151,3355,3881
19808,37286,43.6,70567,35512,17923,19363
19809,14405,39.4,60726,33961,7118,7287
19810,25460,45,87325,40585,12269,13191
19901,36636,31.2,47232,21820,16809,19827
19902,180,20.9,-666666666,19047,154,26
19904,32516,36.9,54368,24643,16154,16362
19930,2185,63.6,62438,44891,1019,1166
19931,211,54.8,50250,32695,124,87
19933,8384,40.5,49935,21841,4191,4193
19934,13255,39.5,64980,30062,6362,6893
19936,306,29.3,51250,17116,193,113
19938,8762,39.1,68737,24828,4527,4235
19939,6651,48,56289,26850,3210,3441
19940,5642,37.8,57594,21790,2819,2823
19941,3270,30.1,46582,16473,1627,1643
19943,12473,38.3,60628,24124,6393,6080
19944,551,63.7,62000,56948,258,293
19945,8758,44.4,43677,25457,4337,4421
19946,4445,38.8,58125,26542,2266,2179
19947,18710,36.7,50329,19682,10094,8616
19950,7400,43,57857,23698,3626,3774
19951,1879,49.3,83088,37119,955,924
19952,9940,39.5,47951,22968,4712,5228
19953,4218,43.4,56205,24290,1916,2302
19954,1388,39.8,57292,23522,740,648
19955,78,41.2,60000,20758,46,32
19956,14994,38.3,46892,21867,7016,7978
19958,20339,56.6,54938,36049,9688,10651
19960,7510,35.1,50922,19733,3523,3987
19962,9943,35.2,67367,27668,4812,5131
19963,19147,45.3,52766,25914,8925,10222
19964,1263,46.4,66042,26773,623,640
19966,27050,46.7,51581,24824,13059,13991
19967,432,58.5,55147,41503,194,238
19968,8936,45.4,61250,30411,4251,4685
19970,6226,57.6,62992,35694,3133,3093
19971,11576,57,61069,42472,5933,5643
19973,21788,43.5,45600,23063,10300,11488
19975,8345,49.2,53023,27020,3936,4409
19977,24446,37.7,59519,25423,12833,11613
19979,642,32.5,51700,19224,344,298
20001,40811,30.7,78848,43055,20008,20803
20002,56331,34.5,65000,39506,27655,28676
20003,27383,34.7,107966,59373,14157,13226
20004,1531,39.7,126765,136144,838,693
20005,11858,33.4,81864,78332,6833,5025
20006,3049,20.2,30208,10973,1604,1445
20007,25590,34,107511,82437,11758,13832
20008,27590,35.9,100953,86104,12278,15312
20009,49979,32.9,88684,63014,25744,24235
20010,32084,32,65287,38365,16087,15997
20011,62569,36.9,54488,31521,29739,32830
20012,14441,45.2,78356,46709,6735,7706
20015,15614,43.9,159016,83738,7298,8316
20016,34144,37.8,118141,75650,15442,18702
20017,19195,37.3,56980,29998,8854,10341
20018,18296,39.8,52317,29519,8051,10245
20019,52572,35.3,34832,20504,22244,30328
20020,51176,32.1,34685,20445,22983,28193
20024,11678,39.9,72870,54079,5376,6302
20032,36772,28.3,31184,17212,16831,19941
20036,5207,31,78935,72645,2316,2891
20037,14502,27.5,76948,65111,6607,7895
20045,0,-666666666,-666666666,-666666666,0,0
20052,503,19.7,-666666666,5746,243,260
20053,0,-666666666,-666666666,-666666666,0,0
20057,3886,19.6,-666666666,1663,1782,2104
20064,1723,19.7,-666666666,3875,860,863
20105,12468,32.6,127464,46006,6121,6347
20106,5439,42,80031,34301,2598,2841
20109,36470,30.6,65017,27944,18192,18278
20110,45480,33.1,75584,29563,23404,22076
20111,31845,33.4,85829,31078,16331,15514
20112,26017,40.2,139902,47156,13216,12801
20115,6006,44.6,70845,45510,3124,2882
20117,2428,47,103214,58414,1148,1280
20118,8,56,-666666666,25663,4,4
20119,4197,43.1,111339,42333,2094,2103
20120,41732,35.5,111272,47233,20218,21514
20121,28902,31.8,92115,38493,14713,14189
20124,16278,39.1,167400,58001,8278,8000
20129,712,42.5,180481,66474,404,308
20130,247,57.5,51458,42144,129,118
20132,17262,37.4,129180,44582,8810,8452
20135,2898,42.9,90083,47781,1588,1310
20136,30283,32.3,128444,39742,14875,15408
20137,1422,45.5,108333,47312,726,696
20139,181,50.8,144464,47298,75,106
20141,6588,38.4,124180,44305,3234,3354
20143,1081,42.8,139938,51051,497,584
20144,1289,47,115667,52703,772,517
20147,57758,34.4,122115,47367,27767,29991
20148,31453,32.3,161433,52835,15494,15959
20151,21744,34.2,122054,44788,10361,11383
20152,26591,33.7,144250,47880,13472,13119
20155,31724,35.8,127974,46480,15704,16020
20158,4149,43.5,120991,47915,1903,2246
20164,36808,32.9,87288,32893,18572,18236
20165,33306,37.5,129827,53220,15967,17339
20166,9857,33.7,106797,43608,5207,4650
20169,20792,38.1,139508,50601,10405,10387
20170,41673,35.3,104371,42213,21561,20112
20171,47565,34.1,141433,56548,23597,23968
20175,29156,36,112815,47154,14850,14306
20176,47889,35.5,113668,45608,23618,24271
20180,5990,41.6,123594,52738,2940,3050
20181,7891,41.3,108438,41387,3970,3921
20184,888,48.1,174526,70546,402,486
20186,14892,42.4,78161,38522,6799,8093
20187,15860,40.8,116206,44989,7892,7968
20190,18127,37.8,94806,57093,8792,9335
20191,28968,39.1,108013,50231,14261,14707
20194,13501,39,131926,74887,6275,7226
20197,1482,43.1,136677,61140,704,778
20198,2248,45.9,61837,40392,933,1315
20202,0,-666666666,-666666666,-666666666,0,0
20204,0,-666666666,-666666666,-666666666,0,0
20228,0,-666666666,-666666666,-666666666,0,0
20230,0,-666666666,-666666666,-666666666,0,0
20240,0,-666666666,-666666666,-666666666,0,0
20245,0,-666666666,-666666666,-666666666,0,0
20260,0,-666666666,-666666666,-666666666,0,0
20307,127,30.3,-666666666,40008,118,9
20317,355,84.7,21591,34528,268,87
20319,104,20.7,-666666666,20768,104,0
20373,68,21.8,-666666666,23674,68,0
20390,233,21,-666666666,21370,223,10
20405,0,-666666666,-666666666,-666666666,0,0
20418,0,-666666666,-666666666,-666666666,0,0
20427,0,-666666666,-666666666,-666666666,0,0
20506,0,-666666666,-666666666,-666666666,0,0
20510,0,-666666666,-666666666,-666666666,0,0
20520,0,-666666666,-666666666,-666666666,0,0
20535,0,-666666666,-666666666,-666666666,0,0
20540,0,-666666666,-666666666,-666666666,0,0
20551,0,-666666666,-666666666,-666666666,0,0
20553,0,-666666666,-666666666,-666666666,0,0
20560,0,-666666666,-666666666,-666666666,0,0
20565,0,-666666666,-666666666,-666666666,0,0
20566,0,-666666666,-666666666,-666666666,0,0
20593,0,-666666666,-666666666,-666666666,0,0
20601,24814,36.4,93020,37051,11921,12893
20602,25835,32.3,79611,31417,11913,13922
20603,30964,34.9,102605,40302,14641,16323
20606,360,57.5,58472,27776,203,157
20607,9923,41.4,123851,44726,4743,5180
20608,781,46.6,63274,30667,366,415
20609,1081,42.3,53203,28804,611,470
20611,972,51.2,64773,36372,480,492
20612,279,58,42143,26609,90,189
20613,14440,39.3,106571,37984,7586,6854
20615,424,43.4,114375,43920,221,203
20616,6684,35.8,91645,31021,3085,3599
20617,1007,41.1,96042,33581,448,559
20618,689,42.3,85875,48785,350,339
20619,10529,32.3,97114,41207,5002,5527
20620,1359,37.9,74801,38268,727,632
20621,1405,47.1,61731,32782,716,689
20622,5087,39.9,98750,36059,2587,2500
20623,2878,38.4,139960,45227,1329,1549
20624,1213,45.4,68750,34302,648,565
20625,628,47.3,62440,31235,255,373
20626,256,51.1,122969,74845,139,117
20628,316,40.5,82159,33234,184,132
20629,219,57.8,143523,89219,89,130
20630,334,34.8,118646,37420,172,162
20632,280,44.8,50987,27092,182,98
20634,6562,31.9,79944,35961,3181,3381
20636,10349,41.6,102500,41822,5196,5153
20637,4675,47,128750,46709,2294,2381
20639,14422,42.3,123906,41365,7267,7155
20640,10614,36.7,68431,29577,5214,5400
20645,926,42.4,96000,41410,554,372
20646,19060,42.2,104971,42591,9598,9462
20650,13467,42.2,99936,42863,6949,6518
20653,25587,29.9,73958,31250,13048,12539
20657,20181,34.8,90399,33666,9653,10528
20658,1014,40.8,82000,43589,553,461
20659,23872,35.6,89831,32535,11705,12167
20660,2,-666666666,-666666666,,2,0
20662,2557,45.1,85069,32845,1315,1242
20664,2836,39.9,64276,34595,1345,1491
20667,509,48,70699,35068,239,270
20670,1331,22.5,60104,21481,845,486
20674,829,57,91667,55582,414,415
20675,1312,51.9,89934,42305,612,700
20676,3503,40.2,91987,33977,1797,1706
20677,2477,44.4,130857,48230,1224,1253
20678,11877,40.1,80087,33081,5924,5953
20680,1270,52.2,76952,36570,488,782
20684,857,40.9,89063,36697,276,581
20685,6614,43.8,109750,42903,3425,3189
20686,933,19.8,-666666666,19442,356,577
20687,379,59.6,60511,32155,179,200
20688,1633,68.3,61458,45030,747,886
20689,1562,41.6,127375,41892,790,772
20690,457,54.5,95192,55331,205,252
20692,1475,43.6,74919,39834,677,798
20693,1008,48.8,110924,42831,544,464
20695,5537,42,100758,43311,2695,2842
20701,108,37.8,-666666666,1526,0,108
20705,25487,37.1,76486,32090,12411,13076
20706,38161,35,69879,26773,18688,19473
20707,31938,36.2,76549,35628,15179,16759
20708,25287,32.6,60754,31955,11534,13753
20710,9396,32.3,42962,23151,4388,5008
20711,6592,40.6,69338,36101,3292,3300
20712,8954,33.5,44104,25696,4287,4667
20714,4398,37,68171,36201,2009,2389
20715,27772,38.1,107361,38596,13614,14158
20716,20779,37.9,96409,41746,9751,11028
20720,21755,38.7,130890,47374,10361,11394
20721,26412,42.4,119851,49989,11835,14577
20722,5408,35.1,56133,22339,2526,2882
20723,29882,35.2,108318,43735,14335,15547
20724,16024,36.4,89215,42927,7647,8377
20732,10071,35.8,97649,39399,4974,5097
20733,2873,40.6,96311,37522,1581,1292
20735,36505,41.9,100651,38883,17138,19367
20736,9556,43.7,114539,40050,4775,4781
20737,20427,30.2,59427,23375,10938,9489
20740,28459,25.4,61952,25854,15118,13341
20742,8583,19.3,-666666666,2394,4277,4306
20743,37626,36.2,57973,26209,17468,20158
20744,50632,42.6,90248,40558,23916,26716
20745,29710,35.7,60629,26851,14147,15563
20746,28624,34.2,62449,28640,12490,16134
20747,38415,35.6,61188,28509,17693,20722
20748,38371,38.2,62112,31164,17423,20948
20751,2273,48.1,98241,52561,1206,1067
20754,6911,43.8,109211,43291,3422,3489
20755,10369,22.8,58643,20078,5336,5033
20758,559,51.6,85179,39146,251,308
20759,3174,40.3,137216,53149,1597,1577
20762,3632,25.1,51631,21961,1765,1867
20763,1708,37.6,67330,35729,1018,690
20764,4643,38.8,96479,42709,2264,2379
20765,465,52.6,84573,80643,243,222
20769,5962,42,118990,44168,2933,3029
20770,24873,33.8,59857,31392,11656,13217
20772,43749,39.2,99183,41455,20844,22905
20774,42874,40.1,91855,40263,19161,23713
20776,3672,47.8,94741,40360,1776,1896
20777,3230,46.9,180583,61299,1442,1788
20778,2085,44.8,103550,52216,1025,1060
20779,1375,49.6,111500,52065,668,707
20781,11665,32.3,66210,28140,5887,5778
20782,33840,32.7,59574,28230,16163,17677
20783,47331,31.6,57787,21269,27089,20242
20784,29484,33.4,56678,24472,14582,14902
20785,36357,34.1,60324,28077,16690,19667
20794,14579,38.2,77313,22284,9124,5455
20812,251,44.1,128750,65597,135,116
20814,27804,39.6,114577,75735,13077,14727
20815,30774,44.5,131994,96215,13933,16841
20816,16037,44.6,168693,97304,7561,8476
20817,36370,44.5,170293,83448,17295,19075
20818,1967,50,192891,79976,954,1013
20832,25454,41.1,119743,46363,12615,12839
20833,7186,45.8,137411,60398,3371,3815
20837,5888,43.4,122663,45364,2872,3016
20838,250,44.7,132344,52448,106,144
20839,133,40,54917,50871,59,74
20841,10796,36.8,149022,41846,5556,5240
20842,1597,47.3,78608,40728,863,734
20850,46629,40.4,107459,54267,21940,24689
20851,13641,35.3,82201,35084,6949,6692
20852,42364,38.8,97600,57613,20179,22185
20853,29714,42.5,100435,41023,14613,15101
20854,49759,46.9,192648,86809,24151,25608
20855,14176,43.1,120603,51908,7056,7120
20860,2513,45.1,109922,59149,1104,1409
20861,1705,49.1,161369,73925,855,850
20862,161,62,148875,80660,93,68
20866,12627,37.1,93828,39412,5748,6879
20868,1170,27.6,130347,40269,612,558
20871,14393,34.7,126685,44442,7016,7377
20872,12942,38.4,103125,38991,6245,6697
20874,58537,34.2,84560,37266,28403,30134
20876,26037,33.9,90702,36242,12323,13714
20877,34886,34.3,64976,29510,16913,17973
20878,63474,37.6,116347,52034,30284,33190
20879,25269,35.2,89182,34084,12432,12837
20880,516,50.8,116429,52742,204,312
20882,14157,44.2,141648,51302,7165,6992
20886,34023,34,77136,35177,16294,17729
20895,19005,42.3,122896,55151,9034,9971
20896,936,44.7,128750,60581,434,502
20899,115,61.6,19375,19452,96,19
20901,35837,36.4,93023,39892,17631,18206
20902,49074,34.5,76646,33510,24293,24781
20903,25119,30.9,56903,24071,13098,12021
20904,55688,37.3,70628,34193,25922,29766
20905,19071,43.2,116806,42974,9314,9757
20906,67387,39.8,72354,33506,31664,35723
20910,39252,35.1,78738,48649,18736,20516
20912,24264,36.5,62204,36478,11545,12719
21001,21813,39.2,58060,28468,10340,11473
21005,2198,22.6,75078,27655,1193,1005
21009,29509,35.1,85510,36180,14362,15147
21010,125,33.4,90000,35611,64,61
21012,20781,40.7,101367,43166,10071,10710
21013,5150,42.4,104089,37220,2431,2719
21014,35192,41.9,88054,39108,17535,17657
21015,28447,40.5,101027,41912,13747,14700
21017,7575,31.4,74381,33678,3841,3734
21028,3638,43,95000,37120,1826,1812
21029,12107,42.6,183966,60719,6131,5976
21030,24585,38.6,75047,43576,11620,12965
21031,32,-666666666,-666666666,,16,16
21032,8743,44.1,116847,55891,4440,4303
21034,3314,45.7,60871,28061,1696,1618
21035,7899,45,129904,61963,4074,3825
21036,2311,44,143750,50313,1122,1189
21037,21050,42.1,100242,45324,10298,10752
21040,25053,32.5,52165,22331,11431,13622
21042,39243,44.1,142528,57591,19546,19697
21043,42415,37.1,107986,46654,20835,21580
21044,41906,37.7,98478,50644,20183,21723
21045,40365,37.2,92258,39780,20366,19999
21046,15940,36.5,104535,48575,7328,8612
21047,11831,45.6,111300,47643,5885,5946
21048,10714,45,95527,41971,5618,5096
21050,18145,42.3,86901,38950,8764,9381
21051,252,44.8,71500,39942,139,113
21052,278,31.7,38611,16705,106,172
21053,3227,45.5,90361,36118,1626,1601
21054,9589,44,119009,49174,4604,4985
21056,222,57,226786,286534,118,104
21057,3834,51.9,103448,50303,2030,1804
21060,29233,38.5,63316,30002,14046,15187
21061,53491,36,60430,29841,25776,27715
21071,454,34.9,95156,43922,250,204
21074,14199,42.1,81500,33279,6545,7654
21075,27181,32.8,89911,39145,13132,14049
21076,13745,37.1,110890,46354,6855,6890
21077,155,67.9,78190,43314,47,108
21078,18417,43.7,65344,34416,8857,9560
21082,404,52.9,69107,63091,218,186
21084,7561,47.2,92794,39307,3820,3741
21085,16257,41.6,73158,34103,8220,8037
21087,5541,47.9,92738,40036,2785,2756
21090,9986,43.7,71938,33640,4780,5206
21093,36945,47.5,82649,50515,17513,19432
21102,11261,42.8,83870,34866,5664,5597
21104,4715,43.3,125000,45078,2198,2517
21105,18,-666666666,-666666666,,9,9
21108,17890,42.6,107736,45917,8626,9264
21111,4326,50.8,114632,62862,2060,2266
21113,31219,34.3,95919,44293,14708,16511
21114,26636,34.2,107715,44027,13092,13544
21117,56894,34.7,76645,40516,26333,30561
21120,7052,45.1,118450,47105,3482,3570
21122,60968,39.2,88880,37243,30518,30450
21128,13902,39.1,82875,38483,6578,7324
21130,365,27,63393,17983,216,149
21131,7204,44.9,128182,56918,3719,3485
21132,2040,43.8,106875,40628,1033,1007
21133,31020,39.7,75010,32572,14526,16494
21136,33190,39.8,72571,39403,15674,17516
21140,3338,44.5,145560,56853,1630,1708
21144,32328,36.4,91719,35923,15423,16905
21146,26703,43,121484,50667,12968,13735
21152,5891,42.1,94701,49303,2894,2997
21153,318,44.7,198750,115650,149,169
21154,7165,44.6,76548,32243,3774,3391
21155,2425,42.9,50670,24654,1192,1233
21156,399,58.5,70000,42386,166,233
21157,37650,40.3,71826,33419,18447,19203
21158,19873,41.2,79148,33503,9695,10178
21160,2143,43.5,73125,35026,1219,924
21161,5732,43.6,82621,36667,2771,2961
21162,3687,38.9,80341,32171,1750,1937
21163,7280,41,122083,48494,3573,3707
21201,15867,29.5,27465,26154,6859,9008
21202,22700,31.3,30425,20318,13027,9673
21204,20116,37.2,73611,40183,9511,10605
21205,16100,28.7,25522,12944,7332,8768
21206,50182,36.3,48428,23556,22690,27492
21207,50107,38.8,51179,24611,22089,28018
21208,32173,49.2,67244,43774,14310,17863
21209,28831,35.8,70809,43005,13572,15259
21210,14805,31,82689,52715,7156,7649
21211,17051,36.5,55819,33894,8325,8726
21212,33255,37.9,61912,40345,15300,17955
21213,30307,38.3,34046,17892,13533,16774
21214,20590,38.4,61014,28223,9646,10944
21215,63448,41.2,34471,19396,29176,34272
21216,25517,43.4,31988,19446,11625,13892
21217,40443,33.2,26187,18309,18312,22131
21218,49552,33.5,38261,25000,23077,26475
21219,8978,46.8,59900,30878,4389,4589
21220,39816,38.1,61672,28327,19520,20296
21221,40407,37.6,52355,25879,18842,21565
21222,54523,40.8,48267,23611,26166,28357
21223,24049,33.7,25565,15576,11609,12440
21224,49552,32.5,55085,29434,24837,24715
21225,34315,33.2,37487,18480,16235,18080
21226,7749,33.8,61250,25720,3716,4033
21227,34386,35.3,55168,25514,17698,16688
21228,48483,42.3,76114,35952,22912,25571
21229,44470,36.4,45055,22242,20661,23809
21230,33556,31.8,63805,39114,17217,16339
21231,16801,31.5,53750,34859,8505,8296
21234,69893,38.5,58332,29853,32308,37585
21236,38166,37.2,69219,33004,17518,20648
21237,29832,37.5,61172,29456,13738,16094
21239,30147,35.7,51331,24183,14057,16090
21240,0,-666666666,-666666666,-666666666,0,0
21244,37742,35.1,59494,27046,18381,19361
21250,3234,19.7,-666666666,1365,1909,1325
21251,769,19.6,-666666666,1390,376,393
21252,2643,19.5,-666666666,1330,1252,1391
21286,19831,38.6,68682,39216,9258,10573
21401,36938,42.3,84054,49555,18258,18680
21402,6212,21.3,109125,18303,4649,1563
21403,30352,42,83056,47668,14591,15761
21405,525,45.3,250001,91388,221,304
21409,20355,40.9,107029,45759,10094,10261
21502,43422,42.5,37262,21393,23354,20068
21520,2044,41.6,55278,25189,924,1120
21521,1307,44.8,42000,21964,694,613
21522,105,51.3,60156,30416,60,45
21523,265,39.7,52841,17398,165,100
21524,554,39.2,31607,17362,275,279
21529,485,49.9,37250,26253,223,262
21530,1586,57.3,37569,19074,818,768
21531,2134,45.9,36831,20443,1045,1089
21532,16088,31.1,39119,19928,8008,8080
21536,4499,40.4,49271,26583,2181,2318
21538,724,38.1,40037,19068,384,340
21539,2684,39.9,42098,18728,1340,1344
21540,91,28.5,24063,12190,38,53
21541,1258,49.6,32415,34365,716,542
21542,492,47.2,45417,21785,246,246
21543,78,52.6,52656,29656,57,21
21545,1995,40.9,49222,23721,1000,995
21550,14345,43.8,41250,23375,7062,7283
21555,1945,37.5,56042,20477,862,1083
21557,2162,41,45972,24851,944,1218
21561,2532,47.6,63938,34753,1236,1296
21562,3084,42,49800,23433,1547,1537
21601,23685,46,57875,35712,11155,12530
21607,611,40.4,70946,25594,353,258
21610,398,48.6,54063,31633,201,197
21612,305,55.9,56071,30928,146,159
21613,17603,39.5,41001,25894,8353,9250
21617,9827,42.1,93535,38715,5211,4616
21619,5606,43.8,79556,37882,2705,2901
21620,12364,46.7,53761,29793,5388,6976
21622,708,49.9,29826,17796,434,274
21623,2080,37.8,66471,28056,1021,1059
21624,130,62.5,54938,43078,61,69
21625,2720,43.1,62546,26745,1411,1309
21626,132,53.6,36250,19478,68,64
21627,24,57.3,-666666666,29233,9,15
21628,481,46.8,62438,42523,214,267
21629,9321,38.5,64901,26121,4523,4798
21631,2500,47.6,67589,35972,1243,1257
21632,5588,42.2,42683,22557,2631,2957
21634,408,38.2,87721,31827,154,254
21635,2208,45.1,66000,32920,1151,1057
21636,1309,39.4,60926,28546,624,685
21638,4938,42.7,94180,45026,2434,2504
21639,4845,35.1,65361,23730,2371,2474
21640,1224,47.3,47778,22722,538,686
21641,43,40.3,78750,32200,22,21
21643,5276,45.4,54662,25348,2495,2781
21644,222,14.8,71894,23769,138,84
21645,1055,42.5,44844,31558,620,435
21647,243,62.6,59063,42782,74,169
21648,358,48.3,64559,21472,179,179
21649,1892,30.9,50658,17150,1064,828
21650,69,48.4,26750,64594,48,21
21651,3248,35.7,62625,26773,1615,1633
21652,144,74.8,66282,118366,67,77
21653,50,70.2,26667,29382,19,31
21654,967,63.3,66490,54547,382,585
21655,5132,41.9,61880,29010,2635,2497
21657,982,40,82593,24116,513,469
21658,3863,48.1,85909,49509,2006,1857
21659,1747,46.5,70145,25770,813,934
21660,4449,37.5,63144,26220,1986,2463
21661,2739,50.1,48594,30472,1261,1478
21662,901,44.8,71894,47452,428,473
21663,3389,57.2,67277,47590,1543,1846
21664,856,35.7,52604,19864,426,430
21665,240,45.7,61750,61174,156,84
21666,12762,42.9,98465,38993,6050,6712
21667,216,56.4,78438,53922,118,98
21668,1888,37.6,59091,27602,966,922
21669,202,52.3,43333,23549,80,122
21671,967,48.3,81223,44556,559,408
21672,215,61.4,38958,28792,121,94
21673,3252,44.8,64846,39024,1656,1596
21675,76,61.3,17708,23725,44,32
21676,421,66.1,26886,33067,173,248
21677,536,45.8,76250,33015,297,239
21678,2573,46.4,61970,44217,1283,1290
21679,418,60.9,72404,48846,194,224
21701,36417,39.3,72646,36135,17280,19137
21702,37601,36.7,69948,34353,18283,19318
21703,33226,32.8,76531,33669,16739,16487
21704,14222,36.1,116869,42606,6779,7443
21705,3,-666666666,-666666666,,1,2
21710,4907,43.3,102167,41900,2486,2421
21711,892,36.3,70870,25060,453,439
21713,9102,46.6,76412,39757,4429,4673
21714,45,71.7,-666666666,27233,17,28
21716,4976,34.3,56708,26819,2517,2459
21717,0,-666666666,-666666666,-666666666,0,0
21718,166,52.3,71429,41994,72,94
21719,1332,44.4,56477,26627,634,698
21722,5499,44.5,57014,24870,2947,2552
21723,628,43.9,104638,60225,284,344
21727,6323,25.5,57455,20249,3036,3287
21733,1125,39.7,82778,36550,565,560
21734,974,44.3,52750,25218,470,504
21737,1402,40.2,160580,63425,670,732
21738,3415,46.3,196361,79768,1707,1708
21740,60616,37.4,42979,21826,31010,29606
21742,32609,40.8,66169,31525,15521,17088
21746,2835,33.7,-666666666,3154,2835,0
21750,3999,38.6,47857,21608,2107,1892
21754,6015,44.8,136289,52514,3019,2996
21755,5628,44.9,102972,40156,2752,2876
21756,3374,39,86250,32758,1798,1576
21757,2715,46.6,72572,33160,1398,1317
21758,4909,46.5,88274,38169,2446,2463
21762,170,48.1,94375,38896,61,109
21766,529,58.6,53646,28500,274,255
21767,963,43.7,25592,17464,452,511
21769,11000,44.9,106646,45705,5777,5223
21770,5645,43.9,105325,40673,2799,2846
21771,28700,41.8,107775,42558,14003,14697
21773,5466,45,90769,37073,2770,2696
21774,12242,38.4,113086,41158,6132,6110
21776,5165,46.4,92853,37923,2560,2605
21777,1538,38.2,106667,39575,759,779
21778,1288,36.4,78158,31370,650,638
21779,985,46.4,95391,42543,541,444
21780,1745,41.3,64545,26253,988,757
21781,74,19.5,-666666666,9842,30,44
21782,4621,40.7,67894,28753,2355,2266
21783,9222,40.8,68408,30057,4360,4862
21784,39259,41.9,103994,41668,19809,19450
21787,11073,40.9,72004,29702,5415,5658
21788,11811,42,74471,32034,5807,6004
21790,41,74.6,28889,28132,16,25
21791,5660,40.6,87531,34227,2875,2785
21793,10624,37.1,81970,34180,5112,5512
21794,2585,45.7,178977,61188,1382,1203
21795,9507,44.2,56332,27495,4731,4776
21797,8466,45.1,125375,48068,4281,4185
21798,2625,43.3,80000,37660,1335,1290
21801,30997,32.5,51188,25037,14439,16558
21802,47,61,-666666666,15040,24,23
21804,38081,33.1,48904,25454,18289,19792
21810,247,27.5,54875,26715,68,179
21811,20754,52.8,60676,33305,9602,11152
21813,2897,42.8,85292,34739,1442,1455
21814,449,55.8,26375,27987,215,234
21817,4889,41.1,31522,18076,2359,2530
21821,815,57.5,34028,21893,427,388
21822,1801,49.8,38304,30580,752,1049
21824,124,61.7,31250,17571,63,61
21826,4941,34.2,54250,26785,2343,2598
21829,880,33.3,43684,19161,443,437
21830,3619,39.4,66014,27581,1696,1923
21835,631,56.3,58548,29170,328,303
21837,2560,46,59762,31148,1287,1273
21838,1649,51.3,70905,27491,827,822
21840,466,41,55250,21256,237,229
21841,1047,35.5,39063,21286,578,469
21842,11442,51.7,60534,44890,5763,5679
21849,3870,38.8,51729,24440,2063,1807
21850,2610,42,54103,25161,1312,1298
21851,7699,39.5,39859,23818,3692,4007
21853,11106,24.7,37758,16810,4783,6323
21856,870,45.7,50313,20092,454,416
21861,962,34.4,42933,19600,449,513
21862,441,52.2,47241,25386,341,100
21863,5213,46.1,49245,25638,2542,2671
21864,901,31.8,63088,24762,533,368
21865,690,51.5,55313,30247,391,299
21866,45,55.5,26667,17644,25,20
21867,44,52.7,-666666666,19655,20,24
21869,606,42.4,51833,28831,275,331
21871,3188,41.4,41696,14849,2312,876
21872,470,50,59698,30885,228,242
21874,2442,42,64333,26288,1195,1247
21875,6351,36.1,40507,21416,2908,3443
21890,2902,33.6,-666666666,1762,2902,0
21901,16786,37.3,65951,29821,8258,8528
21902,181,59.4,-666666666,10319,161,20
21903,6106,41.5,66518,29535,2897,3209
21904,7623,40.3,68125,30569,3601,4022
21911,11312,40.6,66048,27452,5846,5466
21912,1062,31.2,75288,26551,607,455
21913,657,35.4,48438,21029,333,324
21914,551,49.5,62656,31973,345,206
21915,2824,49.9,69701,40445,1308,1516
21916,34,73,-666666666,6609,34,0
21917,2649,38.4,85234,30567,1320,1329
21918,4157,44.1,80161,32624,2000,2157
21919,3827,50.4,49038,30873,1800,2027
21920,167,54.2,31833,20811,98,69
21921,43383,37.5,65716,28848,21685,21698
21930,116,52.6,66176,34842,32,84
22003,58390,40,93823,39118,27953,30437
22015,44657,38.5,120575,46393,21964,22693
22025,16955,40,115000,48008,8248,8707
22026,15221,29.9,77264,29691,7057,8164
22027,2567,44.9,187768,61580,1201,1366
22030,55490,33.9,102140,44418,27517,27973
22031,31329,35.3,106728,47975,16147,15182
22032,29574,42.5,128483,48399,14288,15286
22033,37605,35.7,103052,48592,18569,19036
22035,0,-666666666,-666666666,-666666666,0,0
22039,18676,46.8,196637,74250,9239,9437
22041,27018,37.3,73839,36327,13867,13151
22042,32356,36.4,94135,42970,16234,16122
22043,25910,35.6,103972,48915,12994,12916
22044,13054,36.2,72977,42772,6666,6388
22046,16588,38,126711,57725,7964,8624
22060,9757,26.9,78506,28960,5040,4717
22066,19475,43.5,214219,89776,9814,9661
22079,32986,34.8,99025,41435,16528,16458
22101,30370,45.2,180540,88139,14347,16023
22102,22146,40.2,112427,82461,10697,11449
22124,18249,41.6,156912,71575,8636,9613
22125,648,49.4,95446,61190,294,354
22134,9072,22.6,58461,22398,6188,2884
22150,27551,36.9,86486,35789,13760,13791
22151,17734,40,99527,39127,8759,8975
22152,29094,40.3,113351,47018,13826,15268
22153,31906,38.5,135641,49164,16324,15582
22172,9111,33,62042,33484,4333,4778
22180,23941,38.5,127205,53471,12004,11937
22181,15008,39.2,150929,62724,8003,7005
22182,26044,42.2,160631,68905,12902,13142
22185,0,-666666666,-666666666,-666666666,0,0
22191,61863,30.9,79198,31401,30860,31003
22192,54216,35.8,98169,42064,25723,28493
22193,74742,33.4,90378,32824,37310,37432
22201,34069,31,113683,75255,17605,16464
22202,21004,35.1,110092,74763,10306,10698
22203,22929,32.1,95410,58123,11884,11045
22204,49521,33.9,76052,39365,24804,24717
22205,17882,39.4,140819,61687,8753,9129
22206,20460,33.9,98985,59986,9322,11138
22207,33057,38.5,169636,77782,15823,17234
22209,12036,31.5,93906,67605,6453,5583
22211,895,22.2,25000,23302,821,74
22213,3374,39.9,141458,67590,1747,1627
22214,120,23.5,-666666666,30400,100,20
22301,11723,35.8,119443,63555,5659,6064
22302,17495,36.4,94446,60048,7994,9501
22303,13144,37,83281,48039,7167,5977
22304,46148,34.8,76061,46903,21471,24677
22305,15416,32.2,78220,45488,8121,7295
22306,31996,35,61975,33122,15152,16844
22307,10272,41.8,103143,61723,5056,5216
22308,13188,43.7,163632,67237,6434,6754
22309,32207,36.6,81458,37930,15771,16436
22310,28712,40.1,108482,50492,14184,14528
22311,18648,35.2,66319,37348,8847,9801
22312,29836,34.2,76845,36048,14759,15077
22314,29600,40,117037,79403,14604,14996
22315,27231,36.2,128008,55764,13368,13863
22401,25931,28.8,47040,27222,12023,13908
22405,29763,36.8,84528,35980,14611,15152
22406,21838,36.9,84980,34695,10225,11613
22407,56381,35.8,78164,31502,27698,28683
22408,27405,34.9,84551,32200,13171,14234
22427,3702,31.5,42232,20651,2152,1550
22432,424,31.9,44038,17186,107,317
22433,215,52.3,81326,31740,115,100
22435,2578,43.2,44806,20584,1243,1335
22436,881,39.6,50068,20684,538,343
22437,964,46.8,48750,22098,546,418
22438,262,28.8,27679,23795,98,164
22443,8134,47.4,49091,25096,4002,4132
22448,826,23,52143,21625,526,300
22454,1887,43.2,41859,22859,825,1062
22460,1568,46.5,43229,26317,760,808
22469,1639,47.6,37820,18099,799,840
22473,5202,51.2,54250,27822,2515,2687
22476,633,41.9,54265,19775,374,259
22480,945,75.8,55950,40180,392,553
22482,3141,54.9,40864,27107,1512,1629
22485,23325,37,82256,34680,11547,11778
22488,1486,43.5,43942,26946,675,811
22503,4372,52,55611,29641,2090,2282
22504,162,58.7,38889,33275,71,91
22508,13767,44,73876,33759,6792,6975
22509,0,-666666666,-666666666,-666666666,0,0
22511,1271,56.8,46000,29812,649,622
22514,2451,44.6,49271,23579,1149,1302
22520,5541,45.1,59148,27954,2700,2841
22529,434,56.9,33096,18973,168,266
22530,103,71,48224,32078,65,38
22534,2961,33.4,58854,20248,1400,1561
22535,362,52.3,51100,38654,183,179
22538,255,42.8,103021,33144,160,95
22539,2177,61.9,59881,35808,1038,1139
22542,1335,42.2,71615,29173,629,706
12768,708,49.5,32852,22663,344,364
12769,142,50.2,48750,29437,67,75
12770,260,42.2,49886,30767,122,138
12771,14263,41.1,42797,23896,6804,7459
12775,2195,41,81274,34474,1123,1072
12776,2095,48.3,51429,25175,990,1105
12777,827,53.1,70156,41645,374,453
12778,230,39.3,30045,28798,155,75
12779,1907,30.4,41840,22919,1038,869
12780,2066,43.4,41952,21152,973,1093
12781,374,43,58409,19359,156,218
12783,2247,41.2,51121,19489,1356,891
12784,100,50.4,46339,24853,34,66
12785,1056,50.3,47953,24961,480,576
12786,664,48,49250,27383,378,286
12787,432,56.6,55385,35276,166,266
12788,3548,38.7,46111,18898,2159,1389
12789,1887,37.5,51827,23318,914,973
12790,4517,44.4,50393,26399,2272,2245
12791,762,29.9,45815,25209,408,354
12792,348,49.8,40739,25334,157,191
12801,14652,39.5,45538,27630,6975,7677
12803,7983,42.3,58083,26402,3829,4154
12804,26308,44.6,60152,32970,12662,13646
12808,381,65.1,66058,41306,206,175
12809,3512,46.9,61168,28932,1762,1750
12810,563,45.2,58333,26841,304,259
12811,182,54,35536,18649,81,101
12812,140,58.3,63750,47416,76,64
12814,1571,51.8,56375,30861,765,806
12815,958,52.3,52083,30089,459,499
12816,4518,46.9,50365,26152,2227,2291
12817,2198,45.1,53690,27035,1032,1166
12819,350,52,45000,23435,136,214
12821,2160,33.2,29728,2988,1998,162
12822,6197,39.3,50617,22180,3109,3088
12823,187,54.8,21375,24676,122,65
12824,929,53,66429,33652,479,450
12827,3877,42.9,58893,22897,2039,1838
12828,9664,42.9,54253,26243,4815,4849
12831,17644,40.3,71393,33481,8799,8845
12832,6603,42.5,45162,20900,3157,3446
12833,4172,48.2,62056,37664,2103,2069
12834,6566,44.9,60913,28599,3259,3307
12835,2381,48.8,50662,25361,1278,1103
12836,689,53.4,54625,26502,355,334
12837,1004,42.9,42721,19629,484,520
12838,562,47.7,69167,32302,310,252
12839,13537,37.5,44449,23643,6574,6963
12841,118,67.5,22039,38778,50,68
12842,1134,46.4,46563,24290,585,549
12843,456,48.5,55395,25187,244,212
12844,263,52.6,75900,39957,125,138
12845,4955,47.9,70341,37075,2443,2512
12846,3295,46.4,73125,28523,1683,1612
12847,551,53.5,58906,36644,331,220
12849,570,37.2,70594,23789,265,305
12850,3019,38.2,75337,30090,1577,1442
12851,191,57.9,39250,28586,99,92
12852,471,56.3,50417,24518,220,251
12853,1443,46.9,41563,20113,698,745
12855,130,50,51250,31150,68,62
12856,73,65.3,46484,39001,39,34
12857,497,46.5,47411,23691,260,237
12858,51,63.8,62500,68512,25,26
12859,2339,36.7,59886,28618,1207,1132
12860,980,22.1,46500,14671,484,496
12861,658,47.9,55288,33550,341,317
12862,0,-666666666,-666666666,-666666666,0,0
12863,644,44.8,63229,27480,366,278
12864,71,32.8,-666666666,24707,43,28
12865,3596,46.1,53250,29124,1829,1767
12866,36864,41.7,67979,38236,18063,18801
12870,1423,51.1,53616,27167,681,742
12871,4235,40.3,61301,31348,2122,2113
12872,69,44.5,-666666666,4739,19,50
12873,670,57.5,41786,26337,309,361
12874,167,69.2,95250,56923,88,79
12878,881,49.8,47679,24804,457,424
12883,5025,48.9,42083,28334,2383,2642
12884,347,35.5,41827,21018,203,144
12885,4627,47.3,49533,27047,2375,2252
12886,242,36,52679,23458,92,150
12887,5567,41.2,45098,19584,3254,2313
12901,33137,34.5,43010,23717,16236,16901
12903,1118,50.2,51681,34757,489,629
12910,2273,42,57159,21191,1433,840
12911,23,54.6,-666666666,34809,8,15
12912,2140,42.8,50880,24247,1004,1136
12913,1228,47,53643,28152,609,619
12914,932,33.1,41250,19369,458,474
12916,2225,40.2,44063,24346,1037,1188
12917,1187,45.5,50972,29600,604,583
12918,2320,38.3,54078,23409,1247,1073
12919,2883,37.8,50807,21301,1503,1380
12920,2797,39.5,47931,22167,1545,1252
12921,2441,45,60833,29771,1168,1273
12922,40,61.5,54135,36468,24,16
12923,604,45.3,43021,21866,308,296
12924,133,26.5,47656,12340,59,74
12926,1754,44.3,46284,26061,934,820
12927,230,62.3,55227,35166,120,110
12928,2083,38.4,46081,24518,1086,997
12929,3930,39.8,44712,5618,3370,560
12930,830,35.7,45903,20977,443,387
12932,1308,50.7,45402,25280,617,691
12933,13,11.9,-666666666,,3,10
12934,1117,35.9,35500,19579,559,558
12935,1583,40.5,43843,24119,824,759
12936,708,47.1,57639,29376,333,375
12937,1599,38.2,41324,21583,823,776
12939,204,35.6,43472,26855,124,80
12941,1374,44.6,72361,40100,634,740
12942,724,44.4,42188,24003,370,354
12943,216,58.1,51250,48375,109,107
12944,3959,46.2,48869,28209,1931,2028
12945,442,53.3,65714,35292,232,210
12946,5370,45,47091,31960,2757,2613
12950,978,38.6,38977,17838,518,460
12952,422,58.1,40441,29818,194,228
12953,15780,38.9,50378,18510,9972,5808
12955,389,44.6,60078,23969,195,194
12956,1142,40.8,50000,18502,584,558
12957,1703,47.4,31368,20742,744,959
12958,1703,34.2,34405,20142,879,824
12959,1659,40.8,51520,23116,827,832
12960,1388,38,53603,22412,774,614
12961,255,56.4,64000,22212,146,109
12962,5977,39.6,68694,31644,2860,3117
12964,147,47.7,92188,55559,74,73
12965,418,45.7,32500,17926,206,212
12966,3537,37.1,47019,19442,1804,1733
12967,1216,39.4,49444,17784,658,558
12969,521,47.9,35000,20639,284,237
12970,976,21,53250,9966,676,300
12972,6316,45.8,66260,32497,3204,3112
12973,232,53.1,53929,20950,118,114
12974,1410,39.6,34492,21688,690,720
12975,384,43.2,50714,28431,183,201
12976,111,54.5,45074,28239,50,61
12977,1803,36.2,-666666666,4610,1794,9
12978,325,45,73571,23177,186,139
12979,2472,42.2,60139,31712,1086,1386
12980,1236,44.6,38629,22671,626,610
12981,2497,40.6,55923,28868,1184,1313
12983,7881,46.1,47329,29090,4058,3823
12985,1069,38.8,42917,21785,545,524
12986,6120,39.3,55221,25917,3184,2936
12987,291,53.2,38125,30725,122,169
12989,1069,45.9,55417,31512,526,543
12992,4612,44,52888,24956,2365,2247
12993,1691,48.1,44000,23579,857,834
12996,1720,52.4,43198,24274,883,837
12997,1205,43.6,53158,26794,606,599
12998,583,40.7,34256,15419,294,289
13020,154,46.8,33875,17432,86,68
13021,39208,41.6,46296,25873,19030,20178
13024,1666,39.1,-666666666,521,1666,0
13026,1707,35.3,71359,27166,867,840
13027,31466,43.5,67225,35186,15110,16356
13028,1400,40.8,40592,25220,726,674
13029,7205,37,68010,29595,3472,3733
13030,3259,46.6,55938,27417,1642,1617
13031,15120,44.4,69877,35266,7248,7872
13032,13724,42.6,53314,25780,6566,7158
13033,4432,37.8,56292,24997,2174,2258
13034,1885,46.2,58466,29942,898,987
13035,8422,42.9,65556,33737,4163,4259
13036,8643,41.1,56056,24416,4219,4424
13037,8611,40.8,62214,27428,4052,4559
13039,17821,40.2,74561,32794,8839,8982
13040,2415,42.4,46250,23478,1221,1194
13041,10919,37.6,77708,30781,5481,5438
13042,2149,46,52788,24808,1042,1107
13044,2482,43,59286,24715,1242,1240
13045,30031,32.2,43985,21565,14277,15754
13051,13,-666666666,-666666666,,13,0
13052,1666,45.1,52546,25180,882,784
13053,3997,42.9,60799,31478,1972,2025
13054,1388,38.8,45833,21394,582,806
13057,15196,44.6,55705,27708,7375,7821
13060,2418,46.8,54481,27988,1074,1344
13061,1213,48.1,66250,32218,683,530
13062,277,26.6,48464,18475,146,131
13063,2000,40.7,76618,29949,998,1002
13064,11,66.8,69167,85409,3,8
13066,11550,46.6,83295,50705,5308,6242
13068,5693,44,66480,30384,2791,2902
13069,24791,39.2,43312,22201,12660,12131
13071,889,45.4,64191,27300,459,430
13072,1008,39.7,46563,19009,588,420
13073,6382,41,50561,24679,3121,3261
13074,4519,39.9,49198,21472,2040,2479
13076,2465,41.2,61250,24201,1300,1165
13077,6530,43.6,55933,28865,3141,3389
13078,10314,45.4,83355,42397,5256,5058
13080,3924,40.3,72782,26627,2067,1857
13081,1175,47.1,52054,28327,614,561
13082,4535,47.3,59460,28874,2220,2315
13083,1662,41.8,43690,22832,824,838
13084,4428,42.9,65617,29815,2233,2195
13087,189,58.1,137188,50422,100,89
13088,21912,45.2,53395,29910,10682,11230
13090,30191,38,70376,31149,14999,15192
13092,2889,39.9,66213,25345,1463,1426
13101,2605,40.7,57279,23818,1328,1277
13102,308,18.4,43722,9365,155,153
13103,434,33.3,14158,7038,221,213
13104,16201,42,92194,43805,7740,8461
13108,6385,44.4,81149,37138,3221,3164
13110,2348,45.8,63696,31768,1270,1078
13111,1842,45.5,45573,20281,875,967
13112,1944,40.4,65313,28860,986,958
13113,292,39.2,59375,22862,146,146
13114,6695,39.6,50850,23418,3170,3525
13115,107,33.5,45833,19313,78,29
13116,3470,42.7,62926,33394,1649,1821
13117,161,56.3,55750,24137,84,77
13118,6207,41.9,57450,21347,3494,2713
13120,2189,37.6,50417,22147,1081,1108
13122,1052,38.6,47375,19668,491,561
13123,94,57.9,66333,28441,50,44
13124,104,43,46875,29946,56,48
13126,37440,34.7,48062,23426,18796,18644
13131,3839,39.5,50613,22148,1892,1947
13132,3441,45.7,59577,27956,1751,1690
13134,33,56.2,38281,21861,8,25
13135,6932,41.9,53919,26659,3415,3517
13136,454,47.6,36458,18991,252,202
13138,30,-666666666,-666666666,,15,15
13140,4178,41.8,44646,22445,2057,2121
13141,541,30.3,42917,19703,282,259
13142,6312,38.9,47453,25258,3157,3155
13143,2992,39.6,46034,17549,1774,1218
13144,1714,35,47625,18117,912,802
13145,1837,43.3,42692,20809,907,930
13146,2242,37.2,44286,19143,1099,1143
13147,1638,34,80139,27179,857,781
13148,10716,41.5,45591,24751,5306,5410
13152,8175,49.9,86378,51806,3955,4220
13153,208,47.7,95156,31664,124,84
13155,692,33.9,35750,18432,404,288
13156,2207,45.4,44167,22793,1175,1032
13157,726,50.5,38068,22852,367,359
13158,1737,41,51188,20797,926,811
13159,5384,43.5,71893,33846,2775,2609
13160,1960,40.8,63167,24653,974,986
13162,530,44.6,78750,30326,306,224
13163,334,47.8,66500,30586,202,132
13164,2559,34.2,77039,30308,1312,1247
13165,10776,43.1,45779,23692,5079,5697
13166,5529,43.7,55531,26315,2916,2613
13167,3202,37.6,54788,21911,1475,1727
13202,5352,27.7,14537,14721,2910,2442
13203,16230,36.3,26250,19943,7712,8518
13204,20375,29.5,26841,16155,10243,10132
13205,18790,34.8,31501,18415,8662,10128
13206,16415,37.8,40429,23553,7477,8938
13207,13573,32.3,40808,21423,6213,7360
13208,22401,32.3,31558,17387,10813,11588
13209,13305,41.9,50988,25986,6581,6724
13210,27440,21.4,24591,16048,12268,15172
13211,6931,36.1,46372,21447,3263,3668
13212,20535,43.3,51997,27572,9912,10623
13214,8690,33.7,62386,30517,4032,4658
13215,15582,44.3,77905,36431,7368,8214
13219,15166,44.9,59945,30341,7401,7765
13224,9079,38.6,54196,29840,4324,4755
13290,0,-666666666,-666666666,-666666666,0,0
13301,223,31.9,66944,34057,111,112
13302,1637,40.7,39896,19111,849,788
13303,1099,44.7,60000,30694,586,513
13304,1505,44.8,74408,38136,780,725
13305,371,40.1,76375,23065,183,188
13308,3415,41.9,41128,21221,1778,1637
13309,5920,42.8,52542,23949,2932,2988
13310,598,32.1,83625,28084,350,248
13312,320,56.1,41250,30699,166,154
13313,486,32.7,38125,16885,211,275
13314,549,34.8,42639,19743,298,251
13315,1464,43.6,58142,23885,733,731
13316,6897,40.8,50027,23182,3478,3419
13317,3747,47,50065,24103,1828,1919
13318,1244,41.8,48750,23411,635,609
13319,1131,31.9,42344,28757,411,720
13320,2035,47.7,44464,25757,994,1041
13321,1020,41.8,50841,27523,418,602
13322,1052,41.6,48125,22462,529,523
13323,11452,40.2,62681,30458,5374,6078
13324,2291,44.7,37055,20541,1203,1088
13325,1011,38.8,51576,27420,520,491
13326,5456,50.4,57375,35094,2539,2917
13327,1822,40.9,41302,22111,936,886
13328,1267,50.2,59265,30771,623,644
13329,3853,38.1,39444,19432,1979,1874
13331,164,71.5,72813,53455,77,87
13332,2572,34.6,41782,18906,1345,1227
13333,59,66.9,52083,20931,27,32
13334,1257,42.4,67500,30532,722,535
13335,1721,41.4,52083,22636,871,850
13337,753,59.2,45403,30960,387,366
13338,1033,54.2,50625,26451,494,539
13339,6781,38.4,40963,20391,3379,3402
13340,7981,43.1,48671,23845,3767,4214
13341,149,36.6,42679,26729,49,100
13342,199,46.3,70536,30268,106,93
13343,1622,46.1,45417,26414,868,754
13345,252,37.1,30733,19495,120,132
13346,6648,22.6,63469,22872,3333,3315
13348,1179,49,51641,29881,566,613
13350,10113,43.1,37665,21566,4797,5316
13352,253,18.8,60078,12481,136,117
13353,37,58.5,33929,23341,23,14
13354,3235,41.7,69199,28071,1507,1728
13355,860,27.7,36250,15990,407,453
13357,11199,38.4,44500,22905,5299,5900
13360,525,51.3,50250,26906,290,235
13361,1012,40.1,53355,21025,578,434
13362,148,38.1,93906,31003,69,79
13363,2470,36.1,61574,25184,1149,1321
13364,162,53.1,19318,14877,87,75
13365,8978,43.2,43425,23291,4620,4358
13367,8806,40.6,47716,23450,4317,4489
13368,1402,38.7,46827,21457,710,692
13402,1587,46.4,43387,19660,789,798
13403,7605,40.3,64890,18696,5353,2252
13404,242,38.2,52583,19208,120,122
13406,757,44.5,53203,26311,379,378
13407,5338,43.6,45692,22635,2581,2757
13408,3712,21.4,41548,13917,1855,1857
13409,2801,38.6,56008,22536,1266,1535
13410,274,45.9,22813,21258,135,139
13411,3732,45.6,43183,20770,1853,1879
13413,15769,47.4,64366,38574,7391,8378
13415,55,62.6,70625,27725,38,17
13416,2223,43.6,55268,24719,1066,1157
13417,3329,36.7,34758,22452,1377,1952
13418,184,49.7,43750,22908,94,90
13420,1271,56.8,60438,39710,664,607
13421,14501,40.7,47109,24317,6910,7591
13424,2641,41.2,59965,25411,1430,1211
13425,2374,39.6,44280,25973,1239,1135
13428,1649,47.9,46250,23986,773,876
13431,2136,45.2,57279,24486,1016,1120
13433,1879,42.1,35577,16918,954,925
13435,203,39.4,51250,25190,110,93
13436,70,55.6,61111,36046,37,33
13437,413,48.8,48839,21959,193,220
13438,4072,41.8,54514,25722,2180,1892
13439,3693,46.3,43750,22848,1836,1857
13440,42059,42.3,49755,25861,21416,20643
13441,18,16.5,-666666666,,16,2
13450,150,55.1,31845,22708,72,78
13452,4665,38.3,40072,18687,2368,2297
13454,708,43.3,38688,19116,335,373
13456,4162,49.7,57292,33564,2142,2020
13459,2061,46.1,45800,23049,1148,913
13460,4194,44.9,44078,20760,2037,2157
13461,3081,45.7,58500,33419,1514,1567
13464,1048,44.9,53854,23982,542,506
13468,480,38,46375,22323,196,284
13469,971,35.9,64107,29674,499,472
13470,687,54.4,42847,24096,345,342
13471,3676,40.3,47386,20382,2013,1663
13472,213,57.2,67768,34342,110,103
13473,665,44.9,48750,22161,347,318
13475,33,54.6,14821,23467,9,24
13476,2825,43.2,48224,28083,1333,1492
13477,1662,36.2,50875,23706,707,955
13478,2872,44.6,68690,27455,1486,1386
13480,3500,41,48512,24955,1757,1743
13483,195,35.4,40147,29648,98,97
13484,165,12.1,68947,20913,96,69
13485,936,44.6,42313,20988,494,442
13486,573,46.6,47000,31482,296,277
13488,103,33.6,65625,31237,45,58
13489,561,47.8,43929,25425,284,277
13490,1399,47.5,80841,37259,736,663
13491,3798,40.7,52888,22734,1922,1876
13492,11644,45.5,62543,32718,5816,5828
13493,1990,39.4,46023,19665,1069,921
13494,371,57.6,41250,24080,179,192
13495,2168,38.4,48576,24413,1052,1116
13501,37763,35,31519,18148,18157,19606
13502,33615,36.8,38290,20401,16625,16990
13601,38646,32.9,42296,23194,19136,19510
13602,3269,22.1,50667,21206,2794,475
13603,10734,22.7,41430,16060,5321,5413
13605,5000,39.1,48068,23084,2586,2414
13606,3118,35.8,63071,25348,1531,1587
13607,1886,49.3,36554,25189,1009,877
13608,1549,32.7,51615,20501,772,777
13612,2771,35.3,52841,24737,1402,1369
13613,2791,39.2,31645,17786,1428,1363
13614,373,47.2,36250,23670,167,206
13615,981,40.5,52422,24468,494,487
13616,1819,26.6,42500,19336,1013,806
13617,11486,28,50785,23387,5814,5672
13618,1829,52,57625,36875,931,898
13619,10767,37.2,45888,22716,5441,5326
13620,2309,38.7,50909,21044,1101,1208
13621,613,40.1,42000,24313,308,305
13622,2855,33.2,57041,21803,1409,1446
13623,101,31.1,60833,19611,68,33
13624,5409,36.8,53077,24985,2999,2410
13625,1895,45.6,45508,25308,1046,849
13626,2042,41.2,59708,26371,1124,918
13628,204,37.3,58750,26443,118,86
13630,1373,37.7,51563,21194,732,641
13633,288,32.4,66250,22176,161,127
13634,5017,38.5,54456,21442,2498,2519
13635,837,46,33194,21320,409,428
13636,216,37.6,64643,25781,87,129
13637,4270,28.4,55104,23870,2293,1977
13638,196,32.8,24600,25834,97,99
13639,189,34.1,32708,16121,103,86
13640,241,62.8,88125,48388,120,121
13641,69,78.7,36518,33835,49,20
13642,9976,39.8,40218,19134,5277,4699
13643,80,14.5,-666666666,,27,53
13646,2758,37.2,43304,21710,1467,1291
13647,64,60.5,98365,39370,35,29
13648,2166,41.4,45000,21137,1060,1106
13650,1222,49.3,45548,29540,586,636
13651,137,63.9,76042,52015,70,67
13652,1678,44,45500,21960,849,829
13654,2680,26.2,46833,16214,1480,1200
13655,3400,36,28889,13744,1730,1670
13656,2807,37.3,53668,23662,1435,1372
13658,2112,45.1,53850,28384,1030,1082
13659,624,35.8,46250,20532,332,292
13660,2429,37.5,43832,21381,1234,1195
13661,1769,39.1,49948,20791,881,888
13662,16941,43.1,41668,22965,7973,8968
13664,522,39.8,60139,26989,283,239
13665,1402,25.8,33750,14700,721,681
13666,294,41.4,26484,14365,178,116
13667,2870,40.5,39744,21371,1434,1436
13668,3470,34,43500,21975,1755,1715
13669,16562,42.1,41835,24436,8625,7937
13670,465,45.8,38438,19679,260,205
13672,744,43.2,35368,20472,352,392
13673,2229,31.5,48984,22655,1011,1218
13674,151,27.7,41591,21206,54,97
13675,33,46.9,-666666666,15900,8,25
13676,16444,22.4,43415,19687,8445,7999
13677,153,10,-666666666,,81,72
13678,153,31.5,15685,8888,74,79
13679,1872,38.1,49861,22689,977,895
13680,1236,36.7,48611,29226,581,655
13681,791,35.1,41000,18756,395,396
13682,737,46.5,71250,32892,358,379
13684,1098,42.9,45500,22499,580,518
13685,2163,33.4,62586,33971,1095,1068
13687,525,52.9,43287,36855,234,291
13690,892,33,43167,20439,390,502
13691,3051,38.4,51851,26318,1596,1455
13692,45,69.6,-666666666,50898,14,31
13693,547,50.2,50250,27421,289,258
13694,1372,45.8,59926,30951,659,713
13695,58,57.3,64318,30678,42,16
13696,47,-666666666,-666666666,,0,47
13697,2106,41.6,42143,26131,1037,1069
13730,3073,40.9,40102,20717,1530,1543
13731,1012,54.6,46000,29750,515,497
13732,8190,41.5,74842,31417,3991,4199
13733,5348,45.1,45960,23625,2771,2577
13734,2425,42.1,66810,29231,1138,1287
13736,2527,38,55023,21787,1304,1223
13739,898,45.9,47150,26333,460,438
13740,472,46.7,43594,31263,241,231
13743,3846,43.1,55000,25455,1717,2129
13744,1332,47.2,64405,26956,743,589
13746,2263,44.4,44844,22795,1142,1121
13748,4021,42.2,45577,20851,1759,2262
13750,946,37.2,47798,19289,469,477
13751,144,46.1,38828,20851,92,52
13752,788,53.2,60076,41663,430,358
13753,5737,34.8,47792,22780,3022,2715
13754,3846,43,42193,22928,1870,1976
13755,1342,42,41574,19223,682,660
13756,493,53.3,45089,20298,212,281
13757,1109,48.5,54702,28092,584,525
13760,44363,43.1,50420,28224,21165,23198
13774,327,19,73636,16095,180,147
13775,1877,42,50655,24168,842,1035
13776,522,45.6,44107,24845,206,316
13777,627,47,44904,21469,312,315
13778,6030,46.6,51260,26933,3032,2998
13780,999,45.4,56000,24477,514,485
13782,625,52.9,42212,24803,312,313
13783,2060,50.3,37632,22461,1063,997
13784,115,50.3,26786,14157,58,57
13786,633,36.5,53611,19979,402,231
13787,3748,37.9,46923,18800,2045,1703
25265,1422,44.3,32875,20858,713,709
25266,1119,38.7,28088,14996,628,491
25267,571,43.3,48295,23263,285,286
25268,689,54,25417,16995,382,307
25270,1089,41.7,43472,16606,516,573
25271,9361,39.9,40368,22990,4458,4903
25275,2152,38.3,36528,19977,1128,1024
25276,7246,43.8,25999,16869,3421,3825
25285,510,51.6,45250,21107,238,272
25286,1591,46.1,30559,17155,811,780
25287,1108,38.5,27262,18108,313,795
25301,2084,47.2,25649,30039,925,1159
25302,15588,41.6,43712,25612,7581,8007
25303,7090,41.9,51143,30387,3286,3804
25304,8958,44.1,54144,51089,3926,5032
25305,0,-666666666,-666666666,-666666666,0,0
25306,6372,47,39645,21375,3058,3314
25309,13495,43,39524,26428,6495,7000
25311,10058,45.3,35607,27948,4881,5177
25312,14509,41.6,40833,22079,7498,7011
25313,13198,36.8,58092,30592,6294,6904
25314,16294,43.5,80853,49200,7769,8525
25315,3299,42.4,35958,19201,1518,1781
25320,6405,43.2,44883,24301,2971,3434
25401,14987,34.7,36600,21158,7046,7941
25403,13436,36.8,74200,32710,6595,6841
25404,21508,35.9,47630,23369,10283,11225
25405,11616,39.8,52654,24261,5821,5795
25411,12747,45.4,40098,23302,6412,6335
25413,8327,35.7,57429,25811,4332,3995
25414,17147,40.1,72833,32308,8054,9093
25419,9209,43.6,59949,33228,4511,4698
25420,3948,43.8,61356,24111,2120,1828
25422,1786,54.3,24674,18117,884,902
25425,12757,42.2,67365,30849,6536,6221
25427,12630,42.9,54619,27919,6445,6185
25428,10023,37.1,56985,26739,4694,5329
25430,9007,38.6,50619,23154,4597,4410
25431,219,50.5,31161,21822,120,99
25432,151,24.9,70417,19983,82,69
25434,2570,46.4,26861,17564,1299,1271
25437,201,45.2,23750,21880,119,82
25438,6364,33.7,42737,25839,3336,3028
25442,1734,35,73949,31249,804,930
25443,7075,34.4,69125,31746,3300,3775
25444,248,59.1,21633,30937,110,138
25446,1865,39.1,54226,21996,959,906
25501,1468,30.8,43233,21147,825,643
25502,1170,45.8,37250,19069,571,599
25503,555,28.7,23285,11554,315,240
25504,12446,44.8,49543,26866,6393,6053
25505,638,46.2,62419,20867,306,332
25506,4212,41.8,30567,13674,2067,2145
25507,1041,44.9,24817,20471,490,551
25508,9394,41.3,32647,19530,4623,4771
25510,4990,41.1,62527,28365,2633,2357
25511,795,55.2,25688,20774,314,481
25512,1128,45.4,24167,15651,589,539
25514,3331,45.1,26025,15097,1556,1775
25515,2799,38.9,43417,16633,1372,1427
25517,3051,37.8,29720,13982,1546,1505
25520,1311,47.8,30600,19805,650,661
25521,945,29.9,28667,13781,433,512
25523,2901,46.3,42825,26128,1367,1534
25524,2919,48.2,46250,21333,1583,1336
25526,21589,40.8,59772,30598,10268,11321
25529,1422,46.1,48368,18706,831,591
25530,5272,40.4,39298,21070,2317,2955
25534,265,50.3,15875,14698,133,132
25535,3007,39.1,45671,22594,1593,1414
25537,1699,47.5,40395,22290,778,921
25540,275,39,28375,13372,105,170
25541,8730,43.3,48199,26621,4244,4486
25545,5292,38.8,48500,27498,2574,2718
25547,1272,35.8,51656,16762,582,690
25550,8935,42.9,40781,20540,4330,4605
25555,2007,44.8,45882,21416,1003,1004
25557,1462,50.9,37256,22352,740,722
25559,2105,41.9,55120,22464,1096,1009
25560,8533,40.5,71284,33516,4162,4371
25564,1431,28.7,31577,16444,642,789
25565,559,41.6,30781,21469,299,260
25567,987,38.1,25500,14947,526,461
25570,6825,42.5,28681,15283,3242,3583
25571,2371,43.7,36650,16769,1108,1263
25573,1286,38,46038,20254,639,647
25601,5517,43.1,39469,21766,2577,2940
25606,818,27.5,33024,14908,432,386
25607,967,36.6,33882,21386,416,551
25608,1145,41,38547,19701,533,612
25611,606,45.4,65909,21624,293,313
25617,694,51.5,46080,28468,314,380
25621,2267,46.6,36223,22799,1172,1095
25624,222,59,41534,20264,139,83
25625,1704,38.8,49667,20176,979,725
25628,536,32.6,32600,17146,247,289
25630,953,40.1,35521,15067,460,493
25632,788,45.9,39741,18171,446,342
25634,928,45.9,35461,19939,517,411
25635,1438,48.9,50033,25419,741,697
25637,934,38.6,34917,15699,506,428
25638,1373,53.3,29837,17639,693,680
25639,556,36.1,39271,20082,373,183
25644,418,27.6,19583,9455,188,230
25646,1011,48.6,37043,24576,542,469
25647,564,52.1,39115,24521,311,253
25649,892,47.3,42734,21912,452,440
25650,791,37.7,35250,17670,354,437
25651,542,54.6,27188,16530,267,275
25652,1456,37.6,34375,15744,521,935
25653,722,53.2,36615,21372,363,359
25654,191,54.6,33125,11077,118,73
25661,6521,43.5,43261,24682,3041,3480
25666,944,39.1,19982,11835,512,432
25669,908,44,35302,16972,482,426
25670,6881,38.2,43197,19746,3509,3372
25671,1229,42.1,33185,16357,593,636
25672,268,40.4,27734,18170,167,101
25674,2141,40.6,30098,17763,1030,1111
25676,1090,35.1,23365,15319,534,556
25678,1588,39.2,26458,20210,753,835
25688,333,52.1,65125,25336,153,180
25690,235,42.9,76765,30037,106,129
25692,798,44.7,23958,15175,360,438
25696,93,19.9,-666666666,17544,48,45
25699,119,42,11875,6104,77,42
25701,23851,38.5,34617,25373,11749,12102
25702,8561,35.8,30986,18459,3919,4642
25703,6705,21.9,14798,8531,2966,3739
25704,16668,39.6,39390,20936,8199,8469
25705,20866,39.3,42835,26312,10049,10817
25801,34247,41.4,37124,23308,16680,17567
25810,175,67.3,40948,17689,115,60
25811,231,55,57278,25932,115,116
25812,2078,47.2,35788,19358,1118,960
25813,7965,38.4,37713,16193,5226,2739
25817,658,38.6,58750,18821,362,296
25818,553,29.5,62873,21885,219,334
25820,580,36,27298,12175,283,297
25823,2335,37.1,38707,18698,1021,1314
25825,2237,45.9,52063,29169,1149,1088
25826,168,34.2,82763,26181,76,92
25827,2727,50.2,38827,20555,1308,1419
25831,1166,51.3,26174,16456,578,588
25832,4613,37.6,60139,29762,2047,2566
25836,254,62.4,22250,16818,120,134
25837,264,33.9,15481,11409,132,132
25839,569,48.4,78324,31305,327,242
25840,7215,48.1,35521,22606,3464,3751
25841,701,54.1,37115,23364,381,320
25843,884,48.7,57214,38006,472,412
25844,1869,33.6,39152,14078,859,1010
25845,652,47.6,31810,22225,376,276
25846,523,38.8,22118,8205,188,335
25848,558,35.5,24000,11029,298,260
25849,445,51.3,62794,21504,276,169
25853,125,-666666666,-666666666,,0,125
25854,1422,42.6,60531,23891,701,721
25855,222,67.3,-666666666,9270,98,124
25857,479,38.9,19886,10358,226,253
25862,217,50.3,18036,11361,86,131
25864,133,60.4,36042,33104,50,83
25865,1368,38.8,65163,25341,697,671
25868,487,47.4,42625,16399,227,260
25870,108,46.8,15441,14939,30,78
25871,530,40,39167,21422,269,261
25873,937,30.8,30473,16804,442,495
25875,500,39.5,40568,19484,246,254
25876,146,53.9,63276,27496,97,49
25878,798,52,29028,17081,346,452
25879,703,31.4,22443,9420,508,195
25880,6620,38.6,39430,18967,3232,3388
25882,2702,39.1,35208,21040,1291,1411
25901,11336,42.5,35091,20070,5428,5908
25902,420,45.7,22067,15964,183,237
25904,298,44.5,30982,27495,128,170
25906,416,34.9,52455,33048,183,233
25907,162,31.5,28462,15772,55,107
25908,98,9.9,-666666666,,34,64
25911,14,-666666666,-666666666,,14,0
25913,453,35.3,53854,21638,201,252
25915,264,50.4,26622,14143,116,148
25916,142,50.6,35096,10964,61,81
25917,1744,51,38711,18064,890,854
25918,4140,44,31238,20752,1993,2147
25920,233,69.2,40978,19508,99,134
25921,1872,38.7,39432,19089,855,1017
25922,195,57.2,65909,30638,109,86
25928,384,48.8,12470,13296,214,170
25932,106,37.2,56292,35961,37,69
25936,33,22.9,35000,11970,18,15
25938,1210,39.1,40988,15870,565,645
25942,71,57.3,-666666666,13377,45,26
25951,5987,49.1,30120,16344,2860,3127
25958,868,49.4,38138,16342,448,420
25962,3792,44.5,32309,17415,1918,1874
25969,1188,45.5,31726,17442,733,455
25971,1037,48.9,49792,25757,553,484
25972,228,55.8,27991,28790,158,70
25976,2255,50.6,32679,17358,1056,1199
25977,117,61,32938,15833,57,60
25978,618,50.5,39850,21965,296,322
25979,721,36.4,33448,16151,356,365
25981,1106,42.5,36957,22416,643,463
25984,2307,36.9,32609,15916,1132,1175
25985,315,47.5,18594,18749,153,162
25989,260,45.7,30972,23465,114,146
26003,43424,43.6,41248,26112,20981,22443
26030,601,46.9,40000,18937,300,301
26031,1553,44,30800,18563,731,822
26032,1409,19.9,53125,14036,752,657
26033,2593,51.5,35691,23105,1285,1308
26034,5010,41.7,36038,19195,2262,2748
26035,2804,40.7,40729,18842,1360,1444
26036,442,47.5,47313,21779,217,225
26037,6776,49.4,48472,24603,3369,3407
26038,3108,44.2,51354,28405,1415,1693
26039,923,44,45524,20250,464,459
26040,1748,48.9,33333,20948,825,923
26041,16295,43.8,37296,25528,8034,8261
26047,6827,44.4,41010,21444,3449,3378
26050,1139,52.6,31960,19158,571,568
26055,1658,49.2,59632,25796,859,799
26056,195,39.3,44286,26465,94,101
26059,2729,46.3,46128,30266,1289,1440
26060,1789,38.9,51037,23053,891,898
26062,21068,46.3,38582,25479,10212,10856
26070,7933,47.6,40653,22889,3752,4181
26074,1152,20.5,26429,8476,301,851
26075,521,45.5,45750,26526,256,265
26101,29526,40,34084,19643,13608,15918
26104,17482,44.5,46767,25439,8301,9181
26105,12252,43.8,42750,28888,5813,6439
26133,1299,46.3,43250,21586,657,642
26134,975,44.5,28587,19066,414,561
26136,583,44.3,29107,12210,334,249
26137,843,51.5,21667,12760,455,388
26138,134,13.4,-666666666,3854,86,48
26141,125,65.3,19479,13890,47,78
26142,2842,28.6,37623,14826,1572,1270
26143,4425,45.5,34568,22043,2130,2295
26146,934,38.3,60375,24929,436,498
26147,2288,42.7,32778,19578,1123,1165
26148,238,47.3,44306,13973,108,130
26149,2744,49.1,33015,18262,1340,1404
26150,6132,37.6,51534,22871,3155,2977
26151,439,47.8,13854,12074,205,234
26152,47,37.7,-666666666,18113,12,35
26155,8791,45.2,42823,21947,4331,4460
26159,2683,45.5,35401,20059,1227,1456
26160,1061,48.2,42426,28171,608,453
26161,314,53,31719,24763,182,132
26164,8346,46,38556,21856,3857,4489
26167,974,49.3,23846,22160,496,478
26169,887,54.3,40625,19653,454,433
26170,5923,41.6,42276,21746,3340,2583
26175,3470,43,42539,19919,1672,1798
26178,335,59.2,41591,19999,150,185
26180,1878,38.6,32857,19488,1014,864
26181,6187,45.6,56908,31513,3180,3007
26184,2192,48.9,46691,27295,1123,1069
26187,6081,46.2,57173,30776,3035,3046
26201,19973,40.4,41432,20228,9782,10191
26202,762,42.1,49205,17950,429,333
26203,251,26.1,29292,10455,162,89
26205,3079,41.8,32128,16382,1393,1686
26206,2781,44.8,24973,23205,1290,1491
26208,821,41.9,35000,19291,405,416
26209,60,51.5,21438,39195,27,33
26215,412,10.3,27154,6251,198,214
26217,425,48.5,23958,13914,226,199
26218,2393,43.5,31890,18035,1294,1099
26222,330,46.6,37042,20417,174,156
26224,217,51.8,27188,17100,111,106
26228,50,67.5,-666666666,24742,42,8
26230,150,43.9,29545,20634,75,75
26234,1754,42.4,34647,14801,1009,745
26236,11,-666666666,-666666666,,11,0
26237,431,44.6,55125,17042,155,276
26238,625,46.4,36628,21284,306,319
26241,14408,44.6,38394,21318,6903,7505
26250,5218,43.3,38560,15944,2402,2816
26253,3079,36.6,45131,21358,1721,1358
26254,523,50.8,36484,43489,288,235
26257,914,44.4,30857,15958,410,504
26259,150,25.4,25833,11025,109,41
26260,1351,48.8,40954,25856,731,620
26261,3068,49.6,24756,14925,1328,1740
26263,152,49.3,32045,15784,75,77
26264,756,38.9,31845,16208,414,342
26266,101,22.8,-666666666,53869,61,40
26267,355,40,24722,23659,197,158
26268,64,41.7,30455,15602,22,42
26269,1006,38.1,50408,18805,527,479
26270,719,54.8,31193,18334,352,367
26271,364,45.5,46563,23409,191,173
26273,1952,38.4,37500,9374,1489,463
26275,797,36.5,28813,16053,459,338
26276,390,45,57381,20168,194,196
26278,668,45.2,55278,24024,337,331
26280,1882,44.2,29112,14507,989,893
26282,46,32.2,-666666666,,33,13
26283,2201,41.1,45064,19384,1074,1127
26285,223,61.8,33542,20130,116,107
26287,3000,48.1,32072,20826,1431,1569
26288,3829,50.5,24725,14811,1928,1901
26291,77,56.3,45208,24518,51,26
26292,767,51.6,31875,18613,352,415
26293,830,31,47981,16657,394,436
26294,1009,42.2,30357,16515,554,455
26296,326,52.2,52875,12880,162,164
26298,43,65.3,49844,32095,20,23
26301,30048,40.1,34802,20453,14445,15603
26320,746,51.2,32841,27754,407,339
26321,643,39.9,28721,19560,380,263
26323,699,34.7,36875,14349,349,350
26325,374,51.3,18875,12082,179,195
26327,141,10.5,-666666666,12405,62,79
26330,13886,43.4,63675,34170,6720,7166
26335,1191,43.8,27917,20892,581,610
26337,1276,35.2,37083,19733,682,594
26338,587,52.7,28125,17332,335,252
26339,200,64.3,48036,18410,154,46
26342,460,42.6,42563,17827,228,232
26343,403,43.9,40223,14272,173,230
26346,811,46.3,39570,19120,432,379
26347,2167,45.4,53125,23218,986,1181
26348,121,46.6,29375,16324,56,65
26349,145,53.5,60938,22305,90,55
26351,4761,34.2,34293,17216,3121,1640
26354,10951,42,37479,18918,5600,5351
26361,115,56.4,35000,24070,39,76
26362,3527,43.1,34508,18062,1858,1669
26366,281,16.4,26750,11075,133,148
26369,547,41.8,44375,22247,207,340
26372,763,42.6,45542,19090,460,303
26374,1608,38.2,50282,21818,798,810
26376,556,43.2,35871,19626,282,274
26377,812,36.1,26500,11382,371,441
26378,4435,40,44942,24956,2200,2235
26384,883,39,53031,17240,433,450
26385,3768,48.6,45577,20815,1843,1925
26386,2772,42.5,48160,23164,1536,1236
26404,450,32,21563,12198,137,313
26405,1393,36,35893,15098,791,602
26408,2652,48.3,59199,32397,1259,1393
26410,1207,42,30820,14290,623,584
26411,743,52.2,35737,19643,469,274
26412,441,54.5,29375,23934,180,261
26415,4226,43,35367,16493,2026,2200
26416,7081,41.4,35843,18533,3497,3584
26419,1157,34.5,30398,13548,526,631
26421,267,33,14327,14959,119,148
26422,536,36.9,39904,18782,200,336
26424,556,42.3,26531,14277,264,292
26425,1322,49.9,45327,17614,635,687
26426,6728,45.3,40090,18154,3417,3311
26430,665,40.1,34107,13360,381,284
26431,6107,41.4,33733,19849,3057,3050
26435,131,38.5,34643,14933,64,67
26436,95,54.8,51500,21911,39,56
26437,595,55.1,27528,17764,316,279
26438,161,41.3,33796,16224,105,56
26440,965,43,58125,20020,452,513
26443,162,47.6,48810,28792,71,91
26444,4015,44.2,42961,19590,2164,1851
26447,953,52.1,40556,25761,452,501
26448,1646,35.3,33500,13470,870,776
26451,835,43,43333,27587,430,405
26452,9487,42.9,35253,19278,4584,4903
26456,4247,38.8,32375,17054,2125,2122
26501,19782,37.2,42127,24654,10770,9012
26505,37712,23.4,27264,21586,19919,17793
26508,32029,34,64144,32586,15594,16435
26519,1654,51.8,41357,26490,799,855
26520,771,45.7,44833,22488,341,430
26521,263,38.8,46875,18822,131,132
26525,6782,38.4,60366,21250,3927,2855
26534,1264,43.1,30801,17684,663,601
26537,5635,43.4,39792,24463,2788,2847
26541,3156,40.8,48834,24074,1469,1687
26542,2804,41.8,44103,22982,1328,1476
26543,156,40.5,25625,10369,82,74
26547,2585,30.1,50459,20002,1293,1292
26554,41611,40.8,42489,24219,20167,21444
26559,1261,41.2,38661,21548,612,649
26560,91,52.3,18641,14277,56,35
26562,529,55.2,39286,62326,227,302
26563,318,49,35729,14939,161,157
26568,702,45.4,56875,21725,325,377
26570,3285,44.7,50742,25449,1748,1537
26571,2112,41,34375,20717,1196,916
26572,238,53.7,38971,21682,115,123
26574,553,40.9,44038,21078,252,301
26575,934,41,38542,23228,488,446
26576,235,36.8,72917,27638,99,136
26581,1078,37.4,31080,14156,582,496
26582,4930,44.3,43682,19959,2341,2589
26585,448,51,28625,18379,291,157
26586,0,-666666666,-666666666,-666666666,0,0
26587,447,43.8,65556,22260,226,221
26588,2937,43.1,45375,23817,1467,1470
26590,893,31.5,35433,17023,508,385
26591,1615,47.4,44659,21834,799,816
26601,5509,40.6,35943,18488,2928,2581
26610,902,44.4,32614,16223,479,423
26611,106,56.3,45227,16466,42,64
26615,342,37.8,21912,9356,120,222
26617,110,47.8,54444,25080,69,41
26619,627,29.1,73229,19407,251,376
26621,671,43.3,32364,18841,420,251
26623,1350,38.3,28839,13594,729,621
26624,2792,49.1,35363,23016,1340,1452
26627,280,47.9,22586,12960,131,149
26629,367,40.3,55859,15652,189,178
26631,365,48,24708,14068,156,209
26636,467,36.4,19648,22140,270,197
26638,139,60.9,34107,18428,52,87
26651,10286,45.3,43721,27901,5264,5022
26656,335,38.6,39688,17849,170,165
26660,302,32.2,71989,25035,123,179
26662,986,49.9,59583,36358,333,653
26676,586,36.8,44167,18570,375,211
26678,1352,45.1,47910,17559,695,657
26679,1707,45.2,46750,28281,917,790
26680,154,57,17353,25823,88,66
26681,1443,41,46042,25543,645,798
26684,89,11.4,-666666666,,17,72
26690,487,36.5,33750,16176,223,264
26691,431,37.2,30536,12106,189,242
26704,6337,37.2,30660,16904,3413,2924
26705,1085,43.1,57917,20027,610,475
26707,404,38.8,32500,18146,233,171
26710,2182,46.1,24022,17672,1066,1116
26711,2166,41.6,29960,19971,1081,1085
26714,347,59.7,8333,9954,240,107
26716,648,55.8,55448,21231,319,329
26717,1173,51.3,29310,21553,593,580
26719,2656,42,42813,23360,1195,1461
26720,155,23,-666666666,14316,26,129
26722,821,45,31333,21184,439,382
26726,12947,42.8,28360,18876,6436,6511
26731,198,51.6,68077,32462,96,102
26739,1019,40.8,46250,17894,554,465
26743,1895,35.4,47955,16045,842,1053
26750,1012,35,25000,13331,532,480
26753,6315,40.3,38613,22995,3109,3206
26755,975,36.9,30960,17031,542,433
26757,6851,42.4,30580,16580,3286,3565
26761,408,58.2,14792,16867,154,254
26763,1657,44.3,30139,19582,764,893
26764,4038,43.4,39181,21789,1958,2080
26767,466,55.8,19087,24589,309,157
26801,899,64.3,30029,34830,488,411
26802,1382,37,32308,21350,655,727
26804,582,58.5,26064,16408,298,284
26807,2886,45.6,36550,20860,1491,1395
26808,765,49,21489,17465,378,387
26810,205,59.7,72639,34557,117,88
26812,1537,51.7,39444,23121,880,657
26814,396,54.8,24044,20845,200,196
26815,702,55.5,28571,21326,349,353
26817,422,45.6,66181,23364,215,207
26818,1061,21.2,32250,12741,466,595
26823,159,63.3,41375,26301,115,44
26833,2411,40.9,49500,18432,1219,1192
26836,6659,39.7,30988,17426,3240,3419
26845,731,45.3,42143,15856,319,412
26847,6476,46.1,38665,20085,3158,3318
26851,2500,42.7,28862,16631,1355,1145
26852,817,48.3,32316,19872,501,316
26855,694,51.7,47784,22655,375,319
26865,145,64.3,18631,14432,51,94
26866,923,50,39688,23070,447,476
26884,621,48,48125,24537,322,299
27006,14162,44.7,72739,37170,6937,7225
27007,2192,36.9,58194,22961,993,1199
27009,2884,42,55068,25705,1435,1449
27011,5242,43.9,35500,25147,2486,2756
27012,25998,43.3,74741,34506,12485,13513
27013,6605,39.4,46834,20679,3427,3178
27014,716,41.6,28125,13915,310,406
27016,1936,47,53860,22191,1018,918
27017,9221,40.1,35711,19569,4637,4584
27018,7997,41.5,43724,20980,4108,3889
27019,3676,47.9,43954,24923,1933,1743
27020,6147,40.1,36770,24777,3014,3133
27021,16866,41.1,43454,22380,8169,8697
27022,1878,45.9,44965,19279,959,919
27023,11191,46.4,77654,38845,5240,5951
27024,2770,38.9,23750,15836,1489,1281
27025,11722,42.5,41777,22171,5801,5921
32147,69,4.8,-666666666,,11,58
32148,10630,46.3,31064,17123,5468,5162
32157,450,41.8,57708,14379,226,224
32159,29313,68.1,41070,26285,13870,15443
32162,49812,68.6,56133,37243,23308,26504
32164,44960,43,46405,20520,21372,23588
32168,24369,49.4,46200,28604,12385,11984
32169,9914,59.1,55101,37840,4900,5014
32174,46686,51.3,48544,30010,22413,24273
32176,13991,55.9,43166,36179,6790,7201
32177,26650,38.4,32357,18458,12453,14197
32179,6871,50,34358,19115,3629,3242
32180,4104,39.2,34464,20154,2188,1916
32181,2186,50.2,27585,16196,1065,1121
32187,1996,46.5,30300,18933,1163,833
32189,6043,53,33739,18639,3004,3039
32190,550,43.5,39507,22498,338,212
32193,1191,57.4,32011,17436,602,589
32195,3060,52.6,52368,25613,1716,1344
32202,6271,37.7,15000,11099,4203,2068
32204,6340,38.4,34101,28349,3063,3277
32205,29730,36.6,41444,25374,14130,15600
32206,17197,36.7,24419,15061,8528,8669
32207,32511,39,39263,31694,15915,16596
32208,29677,41.2,32925,17661,14351,15326
32209,35279,34.6,21273,12550,15679,19600
32210,58455,36.3,42365,22876,26986,31469
32211,30944,34.2,39061,20384,15175,15769
32212,1856,23.1,61250,20548,1319,537
32216,34407,35.8,48276,25759,17184,17223
32217,19662,38.2,46157,30246,10141,9521
32218,56025,33.6,46863,21815,27334,28691
32219,11033,42.9,43469,20242,5214,5819
32220,14620,35.2,53255,21493,7291,7329
32221,28687,37,58990,24903,13753,14934
32222,9902,36.3,62106,23415,5161,4741
32223,24533,44.3,77031,40881,11563,12970
32224,35939,33.2,60704,33142,16700,19239
32225,53130,36.9,61723,30353,26002,27128
32226,16439,37.3,70284,28327,7767,8672
32227,2800,23.4,36616,19883,1869,931
32228,187,23,-666666666,21267,149,38
32233,23240,36.8,50338,33172,11964,11276
32234,5929,38.9,50159,20239,3006,2923
32244,61482,31.9,48290,20777,29761,31721
32246,49747,32.9,51371,24538,24169,25578
32250,25894,42.3,56466,37237,13072,12822
32254,13133,33.5,26457,13429,6059,7074
32256,40024,32.7,54160,35244,18865,21159
32257,36113,39.9,54113,32582,16694,19419
32258,27455,34.9,83023,35550,13495,13960
32259,39063,38.7,96166,40881,19163,19900
32266,6702,41.5,67045,50582,3196,3506
32277,28884,34.9,44283,21981,14265,14619
32301,28465,27,39083,21156,12745,15720
32303,46671,28,44722,23970,22617,24054
32304,47417,21.6,16521,10072,24082,23335
32305,20448,32.7,35515,17402,9358,11090
32308,22326,39.9,53483,32932,9762,12564
32309,31679,42.3,83765,38938,15058,16621
32310,16980,30,31383,16121,9068,7912
32311,19400,37.6,61061,32241,8622,10778
32312,31913,42.5,92809,43646,14909,17004
32317,13325,40.4,87761,36290,6387,6938
32320,3428,39.1,31806,17336,1881,1547
32321,6577,36.7,39776,15203,4280,2297
32322,4352,38.8,36014,13920,2914,1438
32323,190,51.7,22237,25250,92,98
32324,4843,46.4,34744,14869,2670,2173
32327,27457,39.1,53396,21581,15230,12227
32328,3245,49.4,46875,26828,1696,1549
32330,863,33.2,22150,14308,428,435
32331,4947,44.6,37571,16602,2486,2461
32332,1656,34.2,24342,10957,810,846
32333,10284,49.2,46440,24809,5174,5110
32334,1731,41.5,39063,20304,902,829
32336,1548,42.5,37823,17287,730,818
32340,11205,40.6,31940,15113,6239,4966
32343,3107,33.9,47933,19778,1411,1696
32344,12785,45.2,44784,21337,6825,5960
32346,1435,53.4,35000,25106,708,727
32347,8101,41.1,39441,19638,4132,3969
32348,12252,38,34017,14518,7479,4773
32350,1832,42.6,34601,15333,824,1008
32351,19337,35.8,30576,15050,9624,9713
32352,6770,36.6,39896,17038,3040,3730
32355,246,52.8,58750,28348,119,127
32356,78,59.5,68684,34372,45,33
32358,2025,38,45806,26517,1025,1000
32359,1565,62.3,33359,21434,680,885
32361,85,51.2,22330,43191,27,58
32399,0,-666666666,-666666666,-666666666,0,0
32401,23577,40.2,35186,19746,11127,12450
32403,3425,21.1,45000,16819,1924,1501
32404,36940,40,50665,22001,18642,18298
32405,30995,37,43976,24299,14799,16196
32407,9164,37.7,51328,26615,4638,4526
32408,16244,43.2,49092,30987,8662,7582
32409,8635,41.4,50461,24300,4388,4247
32410,1065,50.7,51357,32442,495,570
32413,12419,45,52236,31362,6065,6354
32420,2033,46.1,36583,20706,949,1084
32421,4776,38.4,32223,14096,2476,2300
32423,1083,43.4,44375,20806,531,552
32424,7892,40.5,29770,12633,4449,3443
32425,14083,40.7,38923,16596,7852,6231
32426,752,51.1,24776,16721,340,412
32427,1333,40.9,36985,16317,618,715
32428,17119,40.8,38016,17381,9326,7793
32430,879,48.3,38561,20779,377,502
32431,4086,40.6,30625,15707,1946,2140
32432,53,-666666666,-666666666,,0,53
32433,16321,37.8,35378,17526,8837,7484
32435,7515,46.6,28740,19838,3730,3785
32437,838,33.7,39324,13738,391,447
32438,4068,36.6,40234,17988,2217,1851
32439,7853,40.5,46206,23630,3852,4001
32440,7961,36.3,30855,13662,4876,3085
32442,4132,41.3,40515,17693,2032,2100
32443,2760,46,42407,21007,1335,1425
32444,19205,40.2,61233,28643,9527,9678
32445,2995,37,32121,10692,2153,842
32446,11041,40.4,47861,23652,5826,5215
32447,293,17.4,-666666666,439,279,14
32448,8530,43.8,25676,16384,4503,4027
32449,722,38.1,45556,17638,392,330
32455,4361,40.1,27052,14271,2318,2043
32456,7404,48.5,41521,23790,3675,3729
32459,12372,42.8,58800,34106,6120,6252
32460,5805,39.4,33241,15368,3719,2086
32461,28,-666666666,-666666666,,13,15
32462,3800,36.4,40560,17983,2095,1705
32463,101,49.3,30313,20634,41,60
32464,3877,44.3,38008,17999,1714,2163
32465,8723,40.2,39556,15346,5444,3279
32466,6089,39.5,45789,19663,2619,3470
32501,11768,37.6,27677,18407,6372,5396
32502,2962,45.1,34981,25715,1556,1406
32503,34382,34.1,44579,23922,16275,18107
32504,21859,41.3,44837,26934,10425,11434
32505,25408,36.2,31133,16346,12003,13405
32506,35694,35.1,42776,20157,16846,18848
32507,27787,38.8,42148,25171,14190,13597
32508,6950,20.5,52663,18175,5448,1502
32509,687,43.3,-666666666,7310,687,0
32511,1106,20.8,-666666666,15202,878,228
32514,38689,36,43992,26340,18095,20594
32526,35457,41.4,52333,25052,17755,17702
32530,98,-666666666,-666666666,,0,98
32531,5472,41.4,53581,27274,2570,2902
32533,27434,41,56388,24970,13205,14229
32534,14199,40,42513,21801,6447,7752
32535,6015,37.8,34107,13066,3616,2399
32536,20663,32.6,56720,24551,10317,10346
32539,25243,35.6,51750,21687,12803,12440
32541,16158,40,62577,38204,8125,8033
32542,3245,21.7,35197,15541,2076,1169
32544,1717,21.1,35563,24765,1184,533
32547,34365,35,46377,25692,17358,17007
32548,19868,39.6,47506,27368,10433,9435
32550,6092,55.2,58095,48446,2842,3250
32561,8843,46,83182,51583,4797,4046
32563,23985,42.8,65583,31504,11565,12420
32564,2807,44.2,36173,24208,1517,1290
32565,5530,44.1,47431,22677,2642,2888
32566,35373,35.7,65064,29432,17766,17607
32567,3285,49.1,40821,20679,1602,1683
32568,2981,45.1,51786,22369,1489,1492
32569,10869,44.6,51695,32825,5350,5519
32570,28021,39.3,47649,22676,14103,13918
32571,30346,38.4,62570,26520,14831,15515
32577,4487,46,52658,24473,2234,2253
32578,30428,42.8,73218,34747,14702,15726
32579,10160,45.2,62766,34793,4644,5516
32580,4244,32.5,58794,28673,2296,1948
32583,25870,39.3,51898,21649,14364,11506
32601,19360,24,23494,16027,9070,10290
32603,8714,21.3,17857,9234,4448,4266
32605,22701,38.9,65651,38542,11092,11609
32606,23244,36.8,53570,29447,11469,11775
32607,30504,24.4,35135,23872,14827,15677
32608,43916,27.4,39608,27445,20946,22970
32609,17768,35.9,33504,17401,9134,8634
32612,6564,19.1,-666666666,1524,2592,3972
32615,14997,43.5,54899,28621,6981,8016
32616,430,50.5,14412,12226,134,296
32617,4351,46.5,41131,21505,2151,2200
32618,7648,45.2,43440,24779,3974,3674
32619,4566,44.2,38025,25233,2316,2250
32621,5697,42.1,27910,14085,2767,2930
32622,1272,44,52917,22760,620,652
32625,1671,47.2,42969,20025,806,865
32626,8440,46.9,33439,19536,4036,4404
32628,5415,37.9,38841,15557,3001,2414
32631,275,64.3,48966,27600,138,137
32639,50,64.2,36375,21166,20,30
32640,11102,47.2,35579,19201,5377,5725
32641,12691,34.9,27035,13599,6192,6499
32643,10443,42.5,50561,23725,5082,5361
32648,337,52.5,33250,18531,150,187
32653,14122,42.9,69574,36104,6947,7175
32656,13565,46.1,45464,22362,6915,6650
32658,182,50.6,36500,18238,87,95
32664,373,61.7,46250,30436,155,218
32666,6527,50.1,47431,25207,3520,3007
32667,3546,55.1,44498,33877,1742,1804
32668,4799,45.4,42284,21661,2428,2371
32669,11190,39.2,56551,26696,5449,5741
32680,9765,48.4,31466,17190,4977,4788
32681,138,47.2,-666666666,13893,138,0
32683,337,45.9,36563,13575,151,186
32686,6106,38.6,40162,17562,3185,2921
32692,263,69.2,61250,32818,138,125
32693,12770,36.2,37212,17424,6581,6189
32694,2766,33.2,39375,19142,1292,1474
32696,10904,45.7,38805,20890,5351,5553
32697,249,26.4,30580,8125,32,217
32701,21426,42.7,48745,26638,9836,11590
32702,2448,52.8,33750,39101,1129,1319
32703,47824,34.7,47355,22386,23468,24356
32707,34681,38.7,48043,25235,17148,17533
32708,43157,39.1,65751,31083,21145,22012
32709,2271,42.8,48705,19113,1057,1214
32712,42401,39.1,63347,27859,20465,21936
32713,19506,48.3,54098,26927,10399,9107
32714,35085,36.8,49257,26569,16763,18322
32720,31190,44.1,41455,21274,15000,16190
32724,31623,41.9,44181,22764,14682,16941
32725,45736,40.2,45059,19880,21645,24091
32726,19962,43.1,36376,21381,9435,10527
32730,5485,43.3,42581,25116,2635,2850
32732,3799,50.3,45250,26439,2042,1757
32735,3384,50.3,43321,25643,1668,1716
32736,9617,44.9,54483,24538,4751,4866
32738,43347,36.1,50346,20302,22042,21305
32744,3333,47.2,54336,23486,1656,1677
32746,41032,40.6,75344,36117,19297,21735
32750,23173,42.7,61630,27056,11307,11866
32751,20666,43,71561,37416,9597,11069
32754,10156,48,48786,25047,5367,4789
32757,23380,44.8,49912,28457,10835,12545
32759,2797,53.2,32083,20092,1428,1369
32763,21188,43.9,34672,19227,10232,10956
32764,3576,48.1,44057,23259,1730,1846
32765,58153,33.4,68995,30010,28064,30089
32766,15355,37.4,86301,30940,7976,7379
32767,2799,42.1,32407,14529,1695,1104
32771,47609,35.5,50147,24907,22630,24979
32773,28698,35.9,41207,18690,14582,14116
32776,9902,41.3,60873,28923,5000,4902
32778,19468,51.8,40578,23210,9572,9896
32779,28555,45,81186,41183,13898,14657
32780,34562,45.7,42472,25171,16624,17938
32784,11335,45.5,44250,19963,5939,5396
32789,24635,41.3,63398,51443,12002,12633
32792,49308,33.2,40137,23646,24685,24623
32796,21099,46.6,45507,22985,10358,10741
32798,2623,67.3,34367,21656,1287,1336
32801,11237,37.4,47151,40726,6090,5147
32803,17680,39.4,53101,40884,8580,9100
32804,16826,40.4,58548,42558,8213,8613
32805,22001,36.2,23950,14649,10248,11753
32806,25598,38.9,51996,32396,12708,12890
32807,32604,33.6,35980,17077,17666,14938
32808,50146,31.3,33511,14303,24193,25953
32809,25126,35.8,31966,18829,12045,13081
32810,33503,33.9,42580,21716,16015,17488
32811,38301,29.8,34189,15654,18150,20151
32812,36753,35.6,45934,25011,18107,18646
32814,6061,33.1,96766,59903,2915,3146
32817,33015,28.6,44823,21243,17210,15805
32818,45957,33.3,39913,17911,21730,24227
32819,25461,39.1,66330,34133,12710,12751
32820,8767,33,69861,25629,4416,4351
32821,16355,35.7,43163,22830,7923,8432
32822,56111,32.4,32903,16493,27739,28372
32824,36515,34.6,48110,18449,17699,18816
32825,59099,32.6,52684,22333,27671,31428
32826,29990,22.1,40966,14890,15169,14821
32827,6576,36.7,85880,40104,3280,3296
32828,58491,30.4,62054,27670,28636,29855
32829,20542,31.3,67947,24976,9780,10762
32830,7,76.8,-666666666,26371,2,5
32831,2768,36.8,32315,4068,2669,99
32832,16194,31.7,75331,29534,7722,8472
32833,9014,36,59000,24679,4434,4580
32835,43477,32.7,49448,26833,22000,21477
32836,17137,37.9,80270,46469,8790,8347
32837,53184,35.3,55443,23371,26254,26930
32839,46052,31,32248,16532,23823,22229
32901,24700,45.9,29818,19903,12332,12368
32903,12954,48.8,64458,42036,6592,6362
32904,27160,44,53205,26231,13211,13949
32905,22301,42.7,32310,20569,10198,12103
32907,41735,42.3,49009,22428,20646,21089
32908,11068,36.2,46466,17395,4941,6127
32909,30393,39.5,45536,19553,13641,16752
32920,9868,54.2,41060,35506,5093,4775
32922,14945,40.4,25797,17447,7247,7698
32925,1293,25,46571,20126,722,571
32926,23047,43.2,47314,22892,12287,10760
32927,25480,41.1,53633,23439,13166,12314
32931,13958,53.6,47952,34327,6346,7612
32934,17723,48.6,64327,33002,8677,9046
32935,39920,44.5,40828,23658,19681,20239
32937,25312,47.5,60313,36070,12733,12579
32940,33752,46.6,73084,34874,16660,17092
32948,7449,30.4,32234,13777,3743,3706
32949,2513,55,58125,35126,1326,1187
32950,3917,51.6,59722,31976,2029,1888
32951,11329,53.9,59604,38862,5621,5708
32952,20289,48.5,64256,36644,10105,10184
32953,22097,48.6,51470,28451,10946,11151
32955,35927,44.6,59803,31679,16736,19191
32958,25752,51.5,42633,24071,12439,13313
32960,20097,46.9,30832,21580,9853,10244
32962,21484,46.5,39612,23156,10628,10856
32963,14894,65.7,92137,86330,6668,8226
32966,15510,60.3,43825,29683,6962,8548
32967,19901,40.2,44667,23754,9898,10003
32968,13812,42.5,63007,27387,6793,7019
32970,570,33.9,16615,9429,269,301
32976,8804,66,31865,21743,4217,4587
33001,211,64.3,50313,31711,121,90
33004,15570,41.5,37020,24159,7335,8235
33009,39889,47.1,33157,24587,19256,20633
33010,46108,43.9,22523,12318,22572,23536
33012,73805,44.6,32273,15832,34817,38988
33013,32382,44.4,29269,14389,15483,16899
33014,40517,40.6,38332,18696,18850,21667
33015,65038,34.6,51076,19659,30022,35016
33016,48450,37.9,39085,16569,22904,25546
33018,46903,39.7,49769,18035,22212,24691
33019,14195,49.8,70388,49746,6812,7383
33020,41219,39.8,34473,20543,21040,20179
33021,47400,43,49966,28419,22545,24855
33023,64849,35.8,43830,16964,30409,34440
33024,69630,37.5,50417,22102,34385,35245
33025,57766,32.9,51822,23660,27852,29914
33026,29747,43.1,69313,33569,14144,15603
33027,57479,40.4,61464,29817,25614,31865
33028,27547,37.5,92588,33616,13146,14401
33029,47086,36.6,88264,30976,23121,23965
33030,33500,30.3,29994,14003,17467,16033
33031,6411,41.6,62609,27902,3268,3143
33032,37028,30.8,41469,18009,17828,19200
33033,51131,30.9,44817,17177,25803,25328
33034,26083,36,27996,7505,16145,9938
33035,14123,32.2,58913,22280,6727,7396
33036,3849,54.9,49375,47153,2119,1730
33037,12226,51.6,55944,42077,6159,6067
33039,307,29.5,31591,8321,137,170
33040,33254,41.6,53050,29371,17948,15306
33042,6339,51.2,69495,38302,3509,2830
33043,4026,53.3,63100,37096,2156,1870
33050,8901,42.4,47373,29475,4907,3994
33051,629,68.5,61027,47580,288,341
33054,29662,30.9,24966,12383,13462,16200
33055,46013,38.2,42841,15339,21521,24492
33056,34550,33,41291,15898,15823,18727
33060,34330,37.6,38093,21021,17551,16779
33062,22329,57.4,55938,52740,10927,11402
33063,52564,42.7,43756,24230,24775,27789
33064,54879,38.6,42407,24364,27132,27747
33065,53614,35.1,46993,21749,26056,27558
33066,16200,57.5,42958,28059,7251,8949
33067,25288,37.8,95621,43433,12148,13140
33068,50207,31.2,43606,16194,24041,26166
33069,26013,43.9,35415,21327,13701,12312
33070,4739,47.2,49239,32989,2364,2375
33071,38355,37.5,75714,31046,18504,19851
33073,29678,34.5,63687,27953,14470,15208
33076,31107,38.2,107318,43408,15393,15714
33101,0,-666666666,-666666666,-666666666,0,0
33109,508,49.4,166976,116586,177,331
33122,0,-666666666,-666666666,-666666666,0,0
33125,53435,43,24296,13406,25806,27629
33126,47311,41,32221,16656,22427,24884
33127,30131,33.7,22633,11102,14949,15182
33128,7458,40.7,21003,13775,3971,3487
33129,14198,38.9,54127,41352,6743,7455
33130,24338,34,22813,19126,12630,11708
33131,14540,31.9,78094,60035,7094,7446
33132,9976,34.8,57843,43323,6073,3903
33133,33141,39.9,55134,43926,16686,16455
33134,39367,45.2,52316,36589,18020,21347
33135,35470,44.4,21576,13968,17263,18207
33136,13248,33.8,19129,13387,6677,6571
33137,20221,36,48959,30012,10631,9590
33138,29292,39.2,39949,26653,14856,14436
33139,38066,38.1,46612,47650,22090,15976
33140,22197,40,53699,51378,11094,11103
33141,36953,40.3,37317,28096,18471,18482
33142,54178,36.6,22260,11074,27104,27074
33143,31129,39.8,63268,46739,15118,16011
33144,26009,45.1,35968,16975,12507,13502
33145,30774,44.3,37167,22055,15014,15760
33146,15383,22.7,111838,38959,7794,7589
33147,43414,36.4,28258,13152,20430,22984
33149,12560,40.9,121624,78948,5936,6624
33150,27227,33.3,25069,12865,12527,14700
33154,14209,42.6,60347,45325,6859,7350
33155,46977,42.1,54725,25748,22902,24075
33156,32114,40.1,91353,61505,15659,16455
33157,67553,37.7,59768,24941,33051,34502
33158,6777,43.3,135833,50248,3433,3344
33160,37674,49.6,45627,45536,18472,19202
33161,54036,34,33056,15097,25423,28613
33162,45773,33.3,39191,15750,21762,24011
33165,56275,45.2,43344,19379,26622,29653
33166,22899,38.9,50180,23659,11833,11066
33167,19766,34.3,36942,14501,9165,10601
33168,27990,35.3,42605,14510,13022,14968
33169,38545,33.3,42860,18831,17761,20784
33170,12034,33.1,43636,15981,5809,6225
33172,38958,38.3,41410,19177,18121,20837
33173,35354,41.2,54300,26598,16014,19340
33174,29409,41.5,35776,16611,13266,16143
33175,52348,42.8,49729,20789,25389,26959
33176,51207,40.5,60472,32269,24746,26461
33177,56355,38.6,55559,18186,28860,27495
33178,42701,33.8,72704,27088,21700,21001
33179,41977,39.2,44325,22869,18552,23425
33180,32972,43.9,68317,44779,15212,17760
33181,17665,35.8,37718,27662,8599,9066
33182,16264,40.6,66422,22014,8955,7309
33183,37166,41.2,52571,22768,17353,19813
33184,21229,42.2,50268,20677,9759,11470
33185,29029,36.1,76293,25355,14253,14776
33186,71426,36,63834,26041,33703,37723
33187,17159,39.2,68571,23714,7962,9197
33189,23110,35.5,47695,21000,11339,11771
33190,11878,29.5,49118,22711,5848,6030
33193,45852,39.3,50329,19961,22229,23623
33194,7438,36.1,68521,16178,4384,3054
33196,44429,35.1,63773,23687,21358,23071
33301,13536,43.2,80044,68603,7877,5659
33304,18562,41.9,45020,40343,10694,7868
33305,12155,48.6,52758,47364,7162,4993
33306,3403,51.4,81898,62013,2037,1366
33308,26616,56,60341,53897,13949,12667
33309,35279,37.2,45968,22082,18244,17035
33311,65304,35.4,30738,14986,30282,35022
33312,52915,38.4,47112,24806,27121,25794
33313,56934,34.1,34431,16218,26420,30514
33314,22150,34.8,39590,19024,11134,11016
33315,12206,41.1,54298,34284,6523,5683
33316,10854,49.7,59833,54371,5755,5099
33317,35414,40.8,61383,28536,17927,17487
33319,46473,40.9,37668,22003,20727,25746
33321,44326,47.3,43689,25763,19350,24976
33322,37226,49.7,46006,28675,16390,20836
33323,19696,37.4,75945,31952,9271,10425
33324,44952,39.2,58270,34347,21107,23845
33325,29796,38.9,76623,32333,14613,15183
33326,32073,39.1,77813,34293,15160,16913
33327,21627,37.5,120479,46617,10889,10738
33328,28789,37.9,78566,36427,13846,14943
33330,13595,42,98285,46243,6623,6972
33331,23769,40.4,92063,39724,11649,12120
33332,11791,36.1,109689,42313,5653,6138
33334,28709,39.6,48025,28940,15349,13360
33351,34570,34.7,54688,22743,16424,18146
33401,24979,41.3,42337,29592,11726,13253
33403,11726,37.8,40702,21251,5806,5920
33404,26909,40.4,35723,22600,12914,13995
33405,21058,37.4,43311,27323,10893,10165
33406,26057,35.9,47685,22930,13681,12376
33407,28165,34.7,34783,19230,14218,13947
33408,17578,53.9,54952,47459,8551,9027
33409,30467,33.4,41900,21072,15523,14944
33410,33249,44.1,58876,41477,15131,18118
33411,64015,40.8,63385,30163,30572,33443
33412,13395,46,91707,49047,6444,6951
33413,14661,35.3,49881,19992,7277,7384
33414,54474,38.3,75632,33654,26177,28297
33415,44429,35.1,35248,16799,20995,23434
33417,30642,44.1,31881,19510,13638,17004
33418,36588,50.4,75072,52999,16799,19789
33426,20211,43.4,48968,28577,9830,10381
33428,38943,40.6,59152,28842,19304,19639
33430,21359,33.4,30678,14391,11468,9891
33431,18026,39.5,67500,38708,8988,9038
33432,18972,49.8,55150,54603,9476,9496
33433,42991,49.3,53801,37883,18727,24264
33434,19728,60.4,48713,47002,9019,10709
33435,33336,43.1,38296,25078,15205,18131
33436,42616,48.2,51505,31399,19649,22967
33437,36952,66.9,53745,37441,17226,19726
33438,436,49.6,25333,13492,234,202
33440,19359,33.2,35964,16525,10249,9110
33441,26505,41.9,36724,24297,13081,13424
33442,28723,52.5,40537,28731,13412,15311
33444,21377,37.5,45173,24408,11112,10265
33445,30135,49.3,49810,33427,14039,16096
33446,22184,69.2,47124,49082,10245,11939
33449,10223,42.9,99375,45671,4940,5283
33455,20131,56.7,48614,40134,9582,10549
33458,50580,40.7,67798,38511,24686,25894
33460,31330,34.8,36502,18366,18019,13311
33461,41250,32.7,32319,15232,20641,20609
33462,32180,39.3,45848,26566,15583,16597
33463,56864,34.1,51792,19709,27832,29032
33467,51606,47.5,63891,32710,24668,26938
33469,13915,54.1,66025,45806,6796,7119
33470,25566,40.3,73710,29201,12870,12696
33471,7443,39.6,32078,13568,4228,3215
33472,19627,53.1,63419,34423,9370,10257
33473,6098,34.4,124853,50911,3273,2825
33476,7879,29.9,25134,11456,3825,4054
33477,12414,65.5,75428,70734,5723,6691
33478,12370,44.8,93725,35226,6420,5950
33480,9559,68.3,97208,117439,4348,5211
33483,12131,54,62604,66120,5910,6221
33484,24028,69.8,36832,32873,10222,13806
33486,22200,41.5,76772,39982,11199,11001
33487,17412,51.7,66439,48650,8727,8685
33493,5028,35.5,28750,6024,3589,1439
33496,22354,54.2,83138,64715,10607,11747
33498,14582,45,82541,47941,6861,7721
33503,64,33.7,-666666666,7408,39,25
33510,26703,37.2,53504,25285,12618,14085
33511,51807,35.3,52511,25802,25016,26791
33513,11889,45.4,36217,16783,6967,4922
33514,1980,35.7,38510,18069,959,1021
33521,517,53.3,22321,17348,202,315
33523,18455,39.4,35340,19212,9303,9152
33525,17728,46,45579,26368,8889,8839
33527,15281,31.9,49302,19945,8182,7099
33534,14214,30,43793,16275,6997,7217
33538,4890,48.9,32056,21172,2460,2430
33540,9473,52.4,43203,22686,4180,5293
33541,20971,59.1,39377,21646,10794,10177
33542,21178,54.2,32174,20291,10128,11050
33543,22234,36.1,71357,29432,10878,11356
33544,23914,35.5,75120,29804,11335,12579
33545,13599,32.2,66115,22823,6811,6788
33547,21061,36.3,93838,33756,10055,11006
33548,5797,45.1,81213,39473,2762,3035
33549,15276,43.5,55614,32664,7483,7793
33556,20628,42.9,87326,42693,10380,10248
33558,20550,40.6,71935,36146,10002,10548
33559,16952,34.4,55643,27345,7771,9181
33563,26297,32.3,38297,17399,12828,13469
33565,18477,43.4,49680,23285,9276,9201
33566,20488,35.6,57884,27698,10103,10385
33567,10787,35.9,53055,20342,5576,5211
33569,23894,39.3,71132,27839,11568,12326
33570,21066,35.3,42168,20392,10295,10771
33572,15317,41.9,70671,35973,7726,7591
33573,19566,73.1,41667,30912,8458,11108
33576,3845,61.1,47431,30048,1647,2198
33578,39691,32.4,54631,27191,19201,20490
33579,26188,33.6,76333,26699,13468,12720
33584,25274,37.3,54377,24126,12524,12750
33585,1392,35.6,37061,17316,808,584
33592,10876,41.9,40000,22537,5520,5356
33594,33482,38.3,62546,27893,16526,16956
33596,29771,40.8,88844,35990,14900,14871
33597,7931,46.2,32809,18355,3716,4215
33598,13285,32.9,41806,18358,6468,6817
33602,11524,36.6,63292,53397,5904,5620
33603,20095,36.3,34565,21090,10236,9859
33604,37907,35.1,32091,18162,18091,19816
33605,16468,36,26313,14161,8114,8354
33606,17690,29.5,61278,42874,8983,8707
33607,24289,35.1,31831,19771,10975,13314
33609,16963,39.5,57086,43643,8552,8411
33610,40469,31.7,29130,14656,18784,21685
33611,31187,40.8,54021,42397,15470,15717
33612,46167,32.8,28474,16588,22844,23323
33613,31066,30.3,26486,20656,13952,17114
33614,48125,35.5,35098,18039,24147,23978
33615,45317,38,47903,24706,22398,22919
33616,13673,33.1,46548,29971,6857,6816
33617,43738,31.7,37323,20213,20644,23094
33618,24843,42,58609,36966,11976,12867
33619,34486,34.8,32481,15237,17789,16697
33620,4282,19.3,-666666666,1937,1867,2415
33621,2130,23.1,61850,22997,1189,941
33624,38931,39.7,57872,29228,18603,20328
33625,25164,36.6,56635,26034,12071,13093
33626,27623,36.7,98303,43444,14023,13600
33629,23700,40.8,96661,56925,11686,12014
33634,19659,35.7,49315,24594,9850,9809
33635,15937,38.2,54340,28469,7583,8354
33637,15532,32,44291,22871,7275,8257
33647,59375,32.6,72131,36538,28354,31021
33701,14168,47.2,33278,34826,7669,6499
33702,30219,44.8,46656,28375,14662,15557
33703,23571,44.6,58970,37144,11293,12278
33704,16752,43.9,62665,40862,8024,8728
33705,26400,40.8,35349,21893,12389,14011
33706,16030,53.5,61364,46689,7794,8236
33707,24718,52.1,41407,33126,11363,13355
33708,14910,57.1,51489,40338,7258,7652
33709,25210,48.4,33681,21319,12082,13128
33710,32494,44.2,48360,25794,15342,17152
33711,18910,38.2,36154,21650,8782,10128
33712,25353,37.4,35354,19497,10955,14398
33713,30668,40,45902,23891,15666,15002
33714,19039,43.6,32160,18153,9558,9481
33715,6561,60.8,73622,52413,3153,3408
33716,15138,33.2,47206,31621,6824,8314
33744,131,75.2,-666666666,10892,100,31
33755,24324,39.7,35971,19438,11773,12551
33756,30048,44.9,36609,24659,14654,15394
33759,17294,41.8,43597,26383,8390,8904
33760,16039,37,41770,22245,8238,7801
33761,19000,52,52584,34921,8885,10115
33762,7295,43.6,58714,32450,3957,3338
33763,19083,52.7,39175,26989,8934,10149
33764,25311,50.2,48276,32374,12221,13090
33765,13409,38.6,39816,25269,6454,6955
33767,8705,62.1,58780,55972,4239,4466
33770,25740,45.1,40522,28152,12679,13061
33771,27470,50.8,36140,23189,12735,14735
33772,22669,48.9,46979,28276,10933,11736
33773,18003,44.6,48183,27054,8679,9324
33774,18407,48.4,49779,27889,8863,9544
33776,12943,47.5,67557,30916,6413,6530
33777,16835,46,49230,29598,8065,8770
33778,14507,50.7,41549,24523,7043,7464
33781,25515,42,40594,21151,12691,12824
33782,21928,47,48615,26678,10775,11153
33785,5570,53.9,61506,50896,2820,2750
33786,1538,59.7,79271,63440,744,794
33801,33614,34,33255,16059,16864,16750
33803,26976,42.9,44027,30276,12450,14526
33805,24060,34.2,32891,15483,11859,12201
33809,28934,44.4,47027,24172,13676,15258
33810,47995,40.5,51909,22716,22966,25029
33811,20011,39,55000,25472,9906,10105
33812,13896,36,66860,26701,6810,7086
33813,31118,42.5,74651,33602,14785,16333
33815,14389,40.8,29417,13545,7057,7332
33823,28428,39.9,39311,18512,13891,14537
33825,25908,45.7,34377,16441,12610,13298
33827,2771,38.8,43068,21239,1291,1480
33830,26635,36.6,43503,19055,13182,13453
33834,7841,33,33250,10792,4985,2856
33837,19842,41.7,48649,21108,9766,10076
33838,3611,44.1,40274,17843,1738,1873
33839,2880,34.5,40274,19063,1523,1357
33841,8819,40.6,44029,17944,4616,4203
33843,12726,42,37920,14681,7497,5229
33844,34536,36.8,33055,16549,17361,17175
33847,212,22.2,33365,13206,98,114
33848,1727,30,24846,16528,831,896
33849,797,42.1,64500,20739,347,450
33850,7279,44.1,30339,18329,3694,3585
33851,863,34.8,59083,23332,430,433
33852,20050,52.1,36180,20439,10135,9915
33853,11044,34.8,29634,15067,5143,5901
33854,108,55.4,31739,23706,58,50
33855,16,-666666666,-666666666,,8,8
33856,465,73.2,24904,21613,229,236
33857,1796,50,32069,17063,974,822
33859,10807,45.2,39727,20643,4885,5922
33860,22487,34.6,45597,19823,11581,10906
33865,692,43.1,34864,13007,333,359
33867,373,66.3,41406,25970,211,162
33868,12596,43.2,46856,20281,7152,5444
33870,21626,46.8,29213,18504,11327,10299
33872,14204,61,41002,24449,6606,7598
33873,13421,33.5,41307,18883,7088,6333
33875,10621,52.4,41011,23053,5026,5595
33876,4916,55.9,42360,20360,2255,2661
33877,317,35,21104,11373,91,226
33880,36076,37.2,37654,18627,16991,19085
33881,30224,47.3,36116,20365,14127,16097
33884,28995,46.8,53895,29483,13778,15217
33890,5449,33.8,35561,13870,2567,2882
33896,8746,36.5,50162,23939,4058,4688
33897,15846,39.2,51424,21871,7981,7865
33898,15409,48.4,38984,22585,7487,7922
33901,18928,43.3,30756,21478,9366,9562
33903,19222,61.9,36193,25546,8893,10329
33904,29636,51.7,45780,27493,14406,15230
33905,30339,37.9,40781,20728,16752,13587
33907,20032,40.4,37676,23443,9865,10167
33908,33418,62.1,52268,41826,15383,18035
33909,24072,34.4,45232,18518,11779,12293
33912,16418,57.3,60433,40259,7714,8704
33913,17529,41.3,74763,37814,8211,9318
33914,37707,46,56118,26733,18963,18744
33916,23037,32.3,28235,14249,11229,11808
33917,29694,57.6,39498,24633,14531,15163
33919,28364,53.2,51717,35868,13001,15363
33920,5281,47,57700,26717,2586,2695
33921,1172,67.1,67132,57683,624,548
33922,4231,58.2,38431,24180,2253,1978
33924,180,46.3,133750,34034,110,70
33928,20312,56.7,59383,39333,10120,10192
33930,1022,17.4,28750,9066,562,460
33931,10156,65.1,48725,43023,4862,5294
33935,18303,35.3,35949,17346,9346,8957
33936,22185,43.5,36845,18833,10822,11363
33944,359,20.8,30583,8491,237,122
33945,36,-666666666,-666666666,,36,0
33946,1676,63.7,68977,34140,719,957
33947,8183,63.5,46974,26574,4016,4167
33948,15860,52.2,42202,23429,7370,8490
33950,19723,64.7,51136,39457,9470,10253
33952,29083,49.3,37318,21371,14105,14978
33953,5058,62.9,56492,30027,2598,2460
33954,10199,47.7,53865,24139,5039,5160
33955,9824,57.5,50983,29603,5305,4519
33956,3451,65.8,48344,30333,1817,1634
33957,6655,66,97849,76580,3252,3403
33960,1077,51.4,24205,14650,595,482
33965,1011,19.4,-666666666,1757,484,527
33966,8622,46.3,70990,35333,4220,4402
33967,23778,37.9,51237,23870,12787,10991
33971,23443,31.5,48445,15571,11719,11724
33972,12502,39.6,51286,20118,6318,6184
33973,12837,24.5,32323,11423,5745,7092
33974,13826,31.5,37890,14500,6766,7060
33976,14885,29.9,42805,14110,7568,7317
33980,10701,62.2,41543,26270,5391,5310
33981,9641,57.3,47334,27268,4866,4775
33982,10095,53.5,44125,22517,5259,4836
33983,14625,50.8,49028,24131,6509,8116
33990,30027,42.1,48430,21867,14518,15509
33991,16711,41.7,52633,22616,8187,8524
33993,22250,36.1,49706,20632,11000,11250
34101,0,-666666666,-666666666,-666666666,0,0
34102,10647,60.3,67466,78178,5082,5565
34103,12412,61.3,75917,63011,5865,6547
34104,24638,47.2,48228,25273,12082,12556
34105,15381,55.2,68539,56596,7335,8046
34108,17098,59.9,72415,60244,8504,8594
34109,24496,50.1,55052,42480,11311,13185
34110,21430,61.3,66935,51603,9705,11725
34112,26141,54.4,44432,26494,12290,13851
34113,17948,48.4,48281,28990,9562,8386
34114,14325,57.5,53781,32842,7130,7195
34116,33537,31.6,42467,16812,17087,16450
34117,14983,40.8,59763,21149,7718,7265
34119,24351,49.2,73875,45554,11796,12555
34120,26567,36.8,59993,26895,12820,13747
34134,13629,65.9,68827,66261,6374,7255
34135,38434,50.2,51818,31921,19000,19434
34137,223,72,18750,14458,113,110
34138,472,35.3,38611,14273,322,150
34139,424,59.2,28750,20379,203,221
34140,297,69.7,23820,16747,207,90
34141,122,44.1,-666666666,10559,122,0
34142,26130,25.7,27760,9400,15096,11034
34145,16702,63.1,69676,56773,8394,8308
34201,3960,62.9,88295,59305,1782,2178
34202,20918,44.4,89756,44420,10189,10729
34203,36806,42.4,45583,23816,17801,19005
34205,29687,41.1,36673,21374,14891,14796
34207,30082,45.4,32898,19421,14349,15733
34208,34315,34.2,38325,17595,16764,17551
34209,33008,54.1,51572,28711,15234,17774
34210,14925,52.8,47490,28006,7202,7723
34211,3070,53,82083,39548,1559,1511
34212,15213,42.9,87415,36924,7575,7638
34215,657,68.4,65346,39018,351,306
34216,1559,58.1,53021,37575,666,893
34217,5079,59.6,47231,50147,2523,2556
34219,18073,43.3,72158,30074,8964,9109
34221,41287,44.5,44571,22388,20161,21126
34222,11055,58.4,35750,24459,5193,5862
34223,17231,63.2,45507,33585,8196,9035
34224,15432,60.1,39645,24929,7357,8075
34228,6658,71.4,92560,92609,2954,3704
34229,6970,57.9,73836,46770,3579,3391
34231,28730,50.3,43312,32458,13502,15228
34232,33171,44.9,50249,26159,15967,17204
34233,17556,50.4,54233,32321,8190,9366
34234,20296,42.9,30479,19658,9622,10674
34235,13462,53.6,48750,33455,6357,7105
34236,10571,61.5,54877,58036,4807,5764
34237,17390,41.2,39390,20681,9428,7962
34238,17205,65.4,56473,40892,7262,9943
34239,15615,48,47374,30528,7489,8126
34240,11835,47.9,80184,36740,6207,5628
34241,13781,49.1,66035,38313,6520,7261
34242,8534,62.1,79833,59854,4167,4367
34243,26018,51.1,58560,32710,12266,13752
34251,5819,42.4,63304,25302,2912,2907
34266,30842,36.1,34141,14408,17543,13299
34268,187,29.5,-666666666,11036,102,85
34269,3683,62.6,38852,20889,1763,1920
34275,16309,59.4,50884,34916,7670,8639
34285,18019,68.4,45029,37613,8522,9497
34286,20700,36.7,57520,21591,9895,10805
34287,24627,57.1,40601,22240,11670,12957
34288,11039,38.7,42885,26043,5205,5834
34289,1459,62,42778,29245,808,651
34291,4678,36.7,37264,16792,2250,2428
34292,14368,64.3,54367,35941,6731,7637
34293,33236,57.8,48768,28500,15766,17470
34420,16322,40.7,35179,21065,7810,8512
34428,9988,45.5,33488,20254,4751,5237
34429,7569,57.9,47942,28164,3750,3819
34431,7738,52.6,31926,18047,3753,3985
34432,12975,54.1,38935,20068,6092,6883
34433,5947,49.8,43464,20562,3132,2815
34434,8520,47.3,50213,21517,4147,4373
34436,7124,56,31901,20335,3433,3691
34442,15068,57.1,45702,26226,7421,7647
34445,0,-666666666,-666666666,-666666666,0,0
34446,16921,61.8,36599,23320,8242,8679
34448,10944,48.8,32649,18718,5385,5559
34449,2803,51.9,24341,15869,1391,1412
34450,10092,56,38611,28670,4613,5479
34452,11255,50.7,38600,21178,5259,5996
34453,10829,48.5,37456,20627,4939,5890
34461,9863,57.2,42170,22395,5291,4572
34465,15807,58.7,39441,25974,7366,8441
34470,18722,42.2,31553,18348,8409,10313
34471,24689,43.2,50913,30429,11384,13305
34472,25861,40.7,34009,17459,12059,13802
34473,17895,39.5,41749,16907,8972,8923
34474,15100,35.9,40304,26589,7107,7993
34475,13564,34.8,26386,13330,7015,6549
34476,22582,56.2,45149,24091,10628,11954
34479,13241,42.6,41182,19785,6741,6500
34480,18785,39.9,50296,29981,8975,9810
34481,17390,66.9,39165,25754,7790,9600
34482,23041,40.6,38831,17058,11009,12032
34484,3176,44.9,48946,26601,1509,1667
34488,10429,52,33405,18989,4944,5485
34491,26684,60.9,42059,24923,12750,13934
34498,572,59.4,37500,23900,293,279
34601,20986,47.1,35704,19590,9847,11139
34602,7654,46.2,40915,22919,3959,3695
34604,10495,39.5,47987,21392,5292,5203
34606,25903,54.6,35905,20695,11953,13950
34607,7668,55.7,43522,28054,3635,4033
34608,31874,45.1,37228,18467,14896,16978
34609,37643,44.6,48382,23296,18042,19601
34610,11708,45.4,37357,18988,5585,6123
34613,18136,57.3,39271,23325,9010,9126
34614,6835,40.6,50732,18608,3319,3516
34637,6410,44.3,71289,35841,3324,3086
34638,22234,33.7,75617,29291,10894,11340
34639,24985,39.4,64302,27554,11663,13322
34652,22541,47.6,31164,23635,11114,11427
34653,30502,46.4,34283,19057,14393,16109
34654,21772,43.6,43483,22232,11313,10459
34655,38613,46,55651,29611,18691,19922
34661,278,48.5,95156,34679,168,110
34667,33097,55.5,35055,22105,15443,17654
34668,43069,47.1,31704,18266,20798,22271
34669,12585,44.4,39272,19188,6225,6360
34677,21268,41.9,58920,34354,9874,11394
34679,10,-666666666,-666666666,,5,5
34681,1471,39,72279,31520,812,659
34683,31822,46.8,66711,34731,15481,16341
34684,27046,53.2,45071,31051,11962,15084
34685,17169,47.3,70798,42148,8298,8871
34688,8628,48.4,72809,42164,4239,4389
34689,25660,51.3,42067,27480,12353,13307
34690,12557,45.2,34206,18583,6171,6386
34691,19479,43.5,36519,19166,9608,9871
34695,17466,50.2,58750,35081,8593,8873
34698,37580,52.4,47676,29382,16810,20770
34705,2873,42.8,43783,18905,1440,1433
34711,54609,41.2,60312,27251,26850,27759
34714,14766,33.9,44531,19518,6860,7906
34715,15266,36.1,58246,22103,7258,8008
34731,11033,49.4,42074,22046,5246,5787
34734,4001,39.1,59632,27960,1929,2072
34736,14748,37.7,43459,16866,7937,6811
34737,2384,52.2,65054,35508,1188,1196
34739,763,52.1,48077,24721,434,329
34741,43203,31.5,32822,16389,21033,22170
34743,37575,34.2,39984,15709,18667,18908
34744,44675,36.2,45589,19455,21720,22955
34746,34727,38.4,47608,19980,16767,17960
34747,13372,36.8,64823,33377,6427,6945
34748,38524,61.3,40364,24109,17684,20840
34753,5248,29.3,42074,13241,2645,2603
34756,3253,44.3,78750,35839,1583,1670
34758,33208,33.3,41339,14795,16359,16849
34759,32221,35.9,42163,17281,15527,16694
34760,809,48.2,74808,33569,426,383
34761,39269,35.4,60373,25849,18740,20529
34762,373,49.3,50889,28986,197,176
34769,21141,38.4,40793,18754,10022,11119
34771,13632,41.1,59272,26151,6869,6763
34772,23642,36.5,56219,22836,12061,11581
34773,3379,40.1,45282,18150,1764,1615
34785,17903,44.2,40925,16667,11429,6474
34786,30904,37.2,95871,45847,15118,15786
34787,47990,35.4,55875,26222,23506,24484
34788,18002,56.8,37846,24661,8576,9426
34797,1092,60.2,73750,44392,537,555
34945,5003,43.1,45640,22147,2917,2086
34946,6108,44.3,26250,17219,2915,3193
34947,11922,29.1,21472,11665,5606,6316
34949,6435,65.1,53591,47911,3041,3394
34950,14888,36.8,18117,11712,6801,8087
34951,14087,55,40659,28270,6957,7130
34952,37958,51.7,40179,23455,17962,19996
34953,61457,34.6,51167,21842,30234,31223
34956,10781,31.2,37014,12712,6508,4273
34957,21616,55.9,44487,33003,11005,10611
34972,20461,33.8,30862,13341,11734,8727
34974,23317,45.7,36990,22104,11664,11653
34981,5100,39.5,44744,23465,2793,2307
34982,25949,40.5,35993,19590,12773,13176
34983,39681,40,47978,19992,19654,20027
34984,14196,40.6,49316,24323,6825,7371
34986,24754,52.2,56167,33008,11860,12894
34987,6439,38.5,61276,26781,3283,3156
34990,27793,50,76203,40457,13064,14729
34994,17083,48,35000,25260,8420,8663
34996,10099,62.9,52533,56283,4817,5282
34997,41169,48,50716,30064,20306,20863
35004,9542,37.7,58832,28704,4623,4919
35005,8150,38.2,46059,21273,4305,3845
35006,3104,42.9,51929,22270,1680,1424
35007,26722,36.6,64299,26031,12656,14066
35010,21050,39.7,37380,20191,10001,11049
35013,42,27.5,30375,19690,30,12
35014,4767,41.4,36286,19024,3163,1604
35016,17245,40,42771,22469,8811,8434
35019,1612,42.7,54342,22934,864,748
35020,26675,37.8,24570,14458,12331,14344
35022,19431,41.6,57765,29216,9295,10136
35023,24959,40.7,46460,20740,12826,12133
35031,7764,39.2,32492,16626,3973,3791
35032,68,28.5,52083,13860,33,35
35033,3540,41,45137,20560,1963,1577
35034,4839,37.1,23085,12067,3339,1500
35035,1468,44.6,55586,21373,731,737
35036,208,25.3,13125,8863,82,126
35040,15679,32.5,60838,24642,7749,7930
35042,6139,39.3,33603,20183,3073,3066
35043,9346,34.9,90106,32310,4735,4611
35044,7794,37.9,29883,18546,3745,4049
35045,14358,37.6,38011,19826,7008,7350
35046,4908,44.1,45410,24924,2530,2378
35049,4270,37.1,42005,19486,2132,2138
35051,9383,37.9,36601,20026,4670,4713
35052,163,82.4,-666666666,23569,43,120
35053,2726,44,38885,23181,1263,1463
35054,4297,50.5,46148,27338,2003,2294
35055,20244,38,35726,20134,9651,10593
35057,12434,42.5,41938,22625,6367,6067
35058,9180,41.7,37292,20076,4702,4478
35060,303,51.4,42321,19656,135,168
35061,1499,38.1,39272,18197,734,765
35062,7236,44.5,51653,25931,3486,3750
35063,3793,43.3,31182,17062,2004,1789
35064,11628,32.9,34938,17697,4884,6744
35068,7764,39,46170,26223,3830,3934
35070,328,55.7,20114,20850,146,182
35071,15968,43.3,58875,29448,7589,8379
35072,5009,43.1,28546,16723,2503,2506
35073,2488,40.6,39954,16939,1204,1284
35074,103,40.7,-666666666,,44,59
35077,12525,41.6,35091,18877,5960,6565
35078,2355,40.5,34525,22723,1023,1332
35079,9478,38.3,47599,20252,4791,4687
35080,15821,33.4,79570,30279,7587,8234
35082,0,-666666666,-666666666,-666666666,0,0
35083,3608,32.4,36966,16832,1601,2007
35085,7906,40,42779,20657,3794,4112
35087,1448,45.9,39375,17454,670,778
35089,2098,42.4,26155,15014,1079,1019
35091,2793,35.6,78194,25928,1241,1552
35094,14953,37.5,51912,24185,7047,7906
35096,8234,41.7,45233,23176,3876,4358
35097,1798,46.1,40317,17689,895,903
35098,1652,37,30500,15999,952,700
35111,16691,38.5,79311,30640,8251,8440
35112,732,32.2,54870,20434,405,327
35114,6906,38.1,83658,34486,3626,3280
35115,14676,31.9,40032,20705,7004,7672
35116,4204,43.3,68222,30132,2119,2085
35117,5550,37.5,72500,29385,2818,2732
35118,3239,42.3,50063,24471,1524,1715
35119,71,59.8,-666666666,27362,31,40
35120,14674,35.9,52939,20681,7092,7582
35121,14918,37.6,41418,19659,7419,7499
35124,23188,38.9,71871,34462,11436,11752
35125,10332,33.8,38146,19038,5220,5112
35126,21741,41.4,62154,26870,10299,11442
35127,10315,43.1,62381,26124,4824,5491
35128,9527,38.3,45331,29525,4971,4556
35130,2981,48.3,39556,22214,1391,1590
35131,4196,44.5,32748,18027,2035,2161
35133,3490,41.9,54263,26127,1658,1832
35135,1734,47.2,60353,29966,870,864
35136,1695,42.5,36645,22477,1020,675
35139,182,45.5,28333,9524,54,128
35143,3131,49.3,44340,27837,1598,1533
35146,12120,37.2,68036,24825,6550,5570
35147,5961,33.3,74150,29517,3045,2916
35148,3123,40.4,38704,18432,1513,1610
35149,630,21.7,25475,7553,186,444
27027,4313,40.1,35952,19933,2024,2289
27028,25891,42.2,42109,21085,12694,13197
27030,37923,41.8,33922,19448,18429,19494
27040,11848,44.6,62197,29005,5808,6040
27041,8139,43,42146,21417,3806,4333
27042,641,45.2,50658,22433,330,311
27043,6225,46,48410,24449,3193,3032
27045,8664,42.8,51620,26092,4436,4228
27046,2140,46.8,52992,21176,1128,1012
27047,1099,38.6,41098,17944,577,522
27048,8679,41,40998,20796,4211,4468
27050,4365,40,55016,23241,2151,2214
27051,7979,39.9,46473,22374,3992,3987
27052,10646,42.8,41237,21312,4950,5696
27053,3481,44.1,33475,18172,1625,1856
27054,2059,48.1,45114,18364,1040,1019
27055,13858,43,43098,22733,6911,6947
27101,17454,38.7,24350,19104,8762,8692
27103,36396,34,42289,24198,17211,19185
27104,28466,42.4,52480,43947,13086,15380
27105,40544,34.2,30308,15672,18792,21752
27106,44932,36.9,48892,33445,21816,23116
27107,46649,34.6,38265,19038,22565,24084
27109,2470,19.7,-666666666,2435,1039,1431
27110,1729,19.8,-666666666,3506,598,1131
27127,35007,36.5,46103,23708,16491,18516
27201,37,58.1,103333,50351,18,19
27203,21009,35.2,29582,16062,9833,11176
27205,33782,39.1,45939,21429,17140,16642
27207,3583,48.4,46866,25992,1721,1862
27208,1797,42.6,37065,20258,979,818
27209,3865,31.6,27986,13306,1912,1953
27212,2094,39.2,32727,13207,1367,727
27214,11376,35.2,49688,22146,5677,5699
27215,40894,40.8,43635,26473,19156,21738
27217,34354,39.1,32980,18419,15897,18457
27229,4455,30,30279,13706,2139,2316
27231,1738,45.9,39712,25798,821,917
27233,3424,43.2,48250,23199,1758,1666
27235,4456,47.7,71439,34150,2116,2340
27239,9255,43.5,41250,21519,4612,4643
27242,1607,38.3,35174,15832,741,866
27243,4186,42.1,64841,32998,1856,2330
27244,13976,25,47077,21252,7162,6814
27248,4806,36.9,41366,18214,2373,2433
27249,12596,42.1,50095,25651,6502,6094
27252,2324,41,47895,20872,1102,1222
27253,28303,39.8,42297,22250,13953,14350
27258,6697,37.1,43730,20653,3130,3567
27260,23524,31.2,21528,11367,10928,12596
27262,24635,38.5,39867,22889,11752,12883
27263,22058,38.8,39681,19829,10628,11430
27265,46659,37.7,53386,28470,22152,24507
27278,23690,40.6,57627,32376,11872,11818
27281,2361,42.8,42169,20453,1182,1179
27282,16342,42,70463,32905,7492,8850
27283,3124,43.4,52015,27215,1592,1532
27284,51849,40.5,56602,29648,24544,27305
27288,23445,42.5,33800,18470,11050,12395
27291,1706,46,38816,18859,855,851
27292,38451,40.6,37244,20101,19202,19249
27295,38122,41.1,45563,23035,18720,19402
27298,8969,45.4,43097,23966,4355,4614
27299,5089,39.5,41875,18531,2597,2492
27301,9065,38.7,57248,24809,4239,4826
27302,28030,37.8,53166,26812,12928,15102
27305,1668,47,23000,17651,796,872
27306,6573,47.4,33595,20336,2944,3629
27310,6635,41,96106,38123,3515,3120
27311,3588,41.2,37213,18734,1720,1868
27312,18415,48.9,62474,33632,8394,10021
27313,6793,44.4,59713,27969,3298,3495
27314,1495,53.4,57736,25061,798,697
27315,2273,47.8,40724,21142,1172,1101
27316,6863,39.9,40106,18809,3364,3499
27317,16383,40.5,42295,22432,7807,8576
27320,38920,42.7,40542,21907,18738,20182
27325,6902,35.1,31029,16007,3157,3745
27326,3732,44.2,38147,19003,1876,1856
27330,39824,36.5,45766,22044,19602,20222
27332,29972,35.6,52204,22704,14868,15104
27340,33,-666666666,-666666666,,0,33
27341,6324,38.7,42992,17480,3228,3096
27343,1615,42.8,41750,18447,831,784
27344,18409,36.4,37797,18062,9217,9192
27349,6589,39.6,48831,21744,3040,3549
27350,6936,42.4,43957,20731,3343,3593
27355,2583,36.5,36436,14925,1218,1365
27356,2903,40.6,26343,19404,1362,1541
27357,7120,38.8,47329,25270,3286,3834
27358,14998,43,88382,40210,7393,7605
27360,46756,37.8,39503,19888,22661,24095
27370,14002,45,47948,23720,7027,6975
27371,7996,42.8,33141,18493,3934,4062
27376,9810,46.5,53877,29590,4622,5188
27377,7777,37.2,60718,30297,3852,3925
27379,4999,42.2,27987,15052,2386,2613
27401,20668,28.1,26460,14632,9690,10978
27403,21680,26.3,36664,23336,10683,10997
27405,45319,33.5,28677,15781,21247,24072
27406,55645,36.7,37548,20205,26251,29394
27407,48545,32.7,42270,24792,23312,25233
27408,18279,41.5,60938,48607,8506,9773
27409,15889,31.5,42831,26995,7517,8372
27410,52812,41,60097,36260,25184,27628
27455,29384,40.5,60818,37929,13585,15799
27501,17425,38.6,43289,21106,8103,9322
27502,32139,36.5,95816,35341,15688,16451
27503,6597,42.7,89180,30769,4826,1771
27504,15230,36.6,45724,20237,7172,8058
27505,5636,36.8,43012,21714,2827,2809
27507,1114,56.5,47533,25911,662,452
27508,2230,34.1,33935,13785,1426,804
27509,5049,34.5,42169,16501,3017,2032
27510,15008,30.2,40658,27193,7200,7808
27511,33613,37.4,67310,33843,17026,16587
27513,40929,37.1,85546,40712,20054,20875
27514,31746,24.3,56333,35309,15225,16521
27516,38026,31.2,69349,36494,17899,20127
27517,23853,43.2,86540,54854,11029,12824
27518,20896,39.2,102038,49592,10044,10852
27519,41366,35.5,120679,45151,20164,21202
27520,37689,35.9,57581,25479,17824,19865
27521,6587,34.7,44092,20087,3324,3263
27522,12001,40.6,52468,24335,6335,5666
27523,9901,41.2,73507,37258,5020,4881
27524,11674,39.2,37672,19128,5813,5861
27525,12918,40.2,43090,21928,6176,6742
27526,41460,36.5,66512,27673,19854,21606
27527,18291,37.3,77846,29775,9551,8740
27529,43259,38.2,60944,26435,20388,22871
27530,40861,37.9,36939,21754,20213,20648
27531,479,21.5,-666666666,21037,449,30
27534,32121,34.9,45745,23708,15690,16431
27536,16032,38.9,25644,16129,7289,8743
27537,25943,38.5,39033,18195,12318,13625
27539,19282,38.7,82524,34136,9480,9802
27540,30415,34.3,86066,32422,15240,15175
27541,4295,45.1,56346,27996,2213,2082
27542,8701,39.5,44975,20174,4071,4630
27544,4067,43,33581,19188,1962,2105
27545,24266,33.6,61258,26914,10950,13316
27546,19613,32.9,40198,17540,9834,9779
27549,24784,40.3,36969,20001,12166,12618
27551,2299,41.8,49053,27454,1187,1112
27553,2134,48.4,42500,18671,1246,888
27555,365,51.6,23365,17839,159,206
27556,261,52.6,40833,43671,133,128
27557,5921,40,43398,24475,2656,3265
27559,2466,40.9,56618,27164,1253,1213
27560,23491,33,77631,39217,11675,11816
27562,1722,42.6,59543,29726,979,743
27563,4968,38.1,29697,15190,2612,2356
27565,27392,40.9,43507,21520,12868,14524
27568,459,39.2,30938,22480,186,273
27569,7494,36.8,47481,18447,3866,3628
27571,4291,38.1,78972,27526,2318,1973
27572,6818,43.7,70922,34176,3814,3004
27573,10821,40.5,23721,14877,5045,5776
27574,15048,41.3,44809,21541,6977,8071
27576,16250,38.8,33461,17817,8246,8004
27577,25260,37,41386,19222,12808,12452
27581,4887,40.2,52560,18326,3145,1742
27582,130,39.7,55000,23736,78,52
27583,6829,42.9,53231,25842,3317,3512
27587,53860,37.8,81287,33457,26918,26942
27589,8734,44.7,32521,16128,4183,4551
27591,21064,37.4,50998,23773,10915,10149
27592,16151,33.1,56967,22530,7926,8225
27596,16242,37.2,57863,26109,8147,8095
27597,24140,37.1,52552,22070,11953,12187
27601,9766,29.3,23554,15592,5438,4328
27603,46175,33.3,54904,27950,23611,22564
27604,41400,34.3,50373,26231,20004,21396
27605,4628,37.2,45868,41351,2457,2171
27606,44261,26.9,44123,25126,23697,20564
27607,28324,22.4,53976,25822,14443,13881
27608,10644,39.2,81351,57716,5070,5574
27609,32097,37.2,51090,36803,14779,17318
27610,68776,32,43520,18096,31758,37018
27612,35127,36.1,69237,45308,17010,18117
27613,43216,36.8,81187,43073,20267,22949
27614,32764,37.4,91365,43342,16195,16569
27615,42364,43,78335,43621,19810,22554
27616,46074,31.6,58311,23626,22210,23864
27617,15312,34.1,78902,44830,6837,8475
27701,20762,32.8,26690,21319,10249,10513
27703,45204,32.3,54767,24003,22103,23101
27704,34517,33.2,41091,20571,15394,19123
27705,48684,32.1,46597,28485,24152,24532
27707,46299,32.5,45831,29801,22083,24216
27709,822,31.8,71250,29098,364,458
27712,20804,43.8,77440,35952,9981,10823
27713,46824,33.6,66254,37487,20987,25837
27801,21860,38,31114,15156,10117,11743
27803,20729,41.4,40047,23448,9874,10855
27804,29397,41,44282,25332,13849,15548
27805,3722,45.5,36203,17334,1803,1919
27806,2528,48.8,45500,21693,1092,1436
27807,7205,34.4,38532,17903,3534,3671
27808,1975,54.6,46638,27975,958,1017
27809,3870,44.9,40400,25372,1826,2044
27810,4175,50.2,34414,20582,1827,2348
27812,2929,46.3,30121,17446,1269,1660
27813,703,31.5,38833,17991,340,363
27814,1523,51,41989,26154,798,725
27816,2198,48.8,40263,17793,1108,1090
27817,6917,44.1,45565,22596,3621,3296
27818,1651,42,26250,17977,803,848
27819,371,50.8,18750,13222,198,173
27820,2960,44.2,38323,19795,1554,1406
27821,205,56.3,51429,17511,93,112
27822,8082,43.6,46250,21943,3830,4252
27823,7472,42.4,30226,14804,3522,3950
27824,2064,33.9,37857,18007,1018,1046
27825,85,54.1,42708,12166,46,39
27826,963,49.4,38362,16651,679,284
27827,52,53.3,7132,16163,38,14
27828,8807,38.6,36736,18972,4086,4721
27829,1934,50.3,40167,22681,979,955
27830,4708,42.6,38822,21589,2247,2461
27831,3871,38.6,24018,16113,1576,2295
27832,2428,44.5,28422,15757,1058,1370
27834,54699,30.1,31265,18529,24828,29871
27837,5928,37,59250,26541,3025,2903
27839,4145,44.5,32353,15979,2482,1663
27840,400,50.4,25250,16381,168,232
27841,50,46.7,20625,23022,28,22
27842,1559,59.6,52857,28447,801,758
27843,1389,41.7,31801,15611,604,785
27844,3199,34.5,20583,16110,1605,1594
27845,2712,46.5,41905,19301,1559,1153
27846,3228,42.1,38950,16804,1612,1616
27847,1003,38.9,25524,12076,506,497
27849,1525,46.4,31442,16003,738,787
27850,7222,51.2,39581,27639,3390,3832
27851,5456,41.9,39498,18829,2805,2651
27852,2712,42.8,44054,21455,1308,1404
27853,659,42.8,25966,11178,348,311
27855,5717,42.4,40467,20577,2619,3098
27856,16898,40.6,46719,21828,8897,8001
27857,1243,49.4,24453,16782,679,564
27858,56930,25.6,44554,26022,27469,29461
27860,3001,35.6,41897,16256,1567,1434
27861,88,45.8,18906,9927,39,49
27862,738,54.6,58200,26210,377,361
27863,12174,37.6,55596,22175,5903,6271
27864,4783,41.2,32757,17441,2359,2424
27865,1828,47.8,45263,19226,899,929
27866,701,57,36313,20289,334,367
27869,2251,47.6,27337,13226,1037,1214
27870,27436,39.9,34652,18527,12795,14641
27871,4416,46.3,31173,18703,2003,2413
27872,324,51.4,36250,17863,148,176
27873,331,46.4,33125,16724,151,180
27874,4556,43.8,22936,15536,2146,2410
27875,543,52.7,33750,21070,278,265
27876,1596,43,30208,20691,739,857
27878,1685,33.8,26622,13687,880,805
27879,289,30.5,32500,16403,139,150
27880,3232,39.5,38990,19076,1780,1452
27881,79,53.3,41875,16356,35,44
27882,7120,41.5,42500,19469,3297,3823
27883,3365,40.5,42845,21437,1673,1692
27884,792,55.9,57679,26642,442,350
27885,1255,45.7,39375,15179,712,543
27886,22146,41.4,35030,18038,10107,12039
27888,2619,30.8,32139,21153,1276,1343
27889,27250,42.6,38502,21401,12936,14314
27890,2514,44.9,26908,16327,1284,1230
27891,5228,43.7,42038,20327,2422,2806
27892,14575,45,37071,19899,6694,7881
27893,40788,37.1,31942,16807,18845,21943
27896,20323,38.7,57331,30331,9813,10510
27897,2018,44.5,19375,12298,921,1097
27909,40468,36.7,46110,22766,19619,20849
27910,11945,41.2,31882,19060,5557,6388
27915,839,52.1,63542,39745,499,340
27916,555,52.4,57361,31374,290,265
27917,1063,40.1,40819,16966,560,503
27919,908,50.9,68750,32100,367,541
27920,1339,38.9,36964,24302,636,703
27921,4592,38.8,52784,26065,2343,2249
27922,969,49.2,37813,17633,437,532
27923,362,47.5,43194,31073,150,212
27924,2633,47,31786,22095,1192,1441
27925,4096,42.3,34627,16809,2264,1832
27926,1570,47.6,56657,26509,749,821
27927,857,52,72169,60189,491,366
27928,2368,42.2,38750,17176,1060,1308
27929,1300,52,86346,39252,687,613
27932,12535,46.3,33333,18718,5971,6564
27935,1494,41.4,44676,22982,692,802
27936,1073,37.7,57679,22430,546,527
27937,4051,42.4,45099,19613,1990,2061
27938,1490,49,42350,21569,706,784
27939,2667,37.4,54191,22769,1268,1399
27941,531,51.3,74286,28904,287,244
27942,644,51.4,41618,19266,283,361
27943,264,57.4,56602,33472,157,107
27944,12235,46.9,43591,23506,5857,6378
27946,1760,35.7,36099,16391,889,871
27947,1324,47.3,36250,19637,702,622
27948,10795,42,53864,28795,5435,5360
27949,6995,50.1,66582,40407,3484,3511
27950,2298,36.6,51442,21224,1075,1223
27953,1052,43,38924,19142,488,564
27954,6358,41.2,53588,25939,3125,3233
27956,178,49.1,74318,34683,100,78
27957,1569,46,30556,18195,879,690
27958,9800,40,59888,23837,4736,5064
27959,2802,44,52355,36914,1527,1275
27960,594,53.2,48644,24899,288,306
27962,7055,48,28918,18916,3206,3849
27964,468,40.3,53143,31224,220,248
27965,528,38,31250,19644,295,233
27966,1105,43.8,54865,23776,595,510
27967,219,24.8,47656,14602,95,124
27968,287,51,14649,11333,114,173
27970,3497,41.9,34928,18926,1599,1898
27972,251,38.3,45673,20398,102,149
27973,1310,45.1,66172,25919,699,611
27974,1513,46.6,56995,22407,824,689
27976,3417,40.2,67014,27467,1642,1775
27978,274,52.1,82321,32494,144,130
27979,1776,38.4,52250,23455,962,814
27980,2065,34.7,41212,20728,1130,935
27981,1864,42,51910,24944,815,1049
27982,96,44.7,36477,23758,57,39
27983,10545,41.9,30029,16248,5215,5330
27985,343,27.7,27045,19187,155,188
27986,3274,41.3,28143,9757,2523,751
28001,26386,40.8,38498,20551,12479,13907
28006,1273,41.6,37000,19788,597,676
28007,644,48.6,30385,13692,339,305
28009,831,47.2,29257,21241,347,484
28012,20637,40,52292,30974,9887,10750
28016,13072,39.2,33193,18895,6362,6710
28017,691,20,-666666666,2071,215,476
28018,5910,44,36132,17678,2759,3151
28019,0,-666666666,-666666666,-666666666,0,0
28020,2088,51.9,30893,18151,1055,1033
28021,12285,43.7,42559,21885,5753,6532
28023,14321,39.3,47952,24718,6923,7398
28025,50140,36.8,50632,23389,24058,26082
28027,56586,36,59257,27730,27824,28762
28031,24805,38.2,81737,47288,12012,12793
28032,2961,41.4,53073,31270,1490,1471
28033,2626,44.6,44962,19231,1347,1279
28034,17293,39.9,39692,19604,8753,8540
28036,15034,35.8,87431,45081,7574,7460
28037,18080,44.3,73078,37196,9023,9057
28039,90,37.5,15455,6264,23,67
28040,7605,37.5,40985,21455,3842,3763
28043,22206,38.2,31786,16628,10379,11827
28052,35400,35.5,31467,15931,16728,18672
28054,35058,38.2,38208,20682,16609,18449
28056,32599,38.9,56255,27284,16305,16294
28071,3395,41.7,46823,31479,1735,1660
28072,1353,38.8,54265,20476,634,719
28073,5568,33,37798,16710,2620,2948
28075,15932,37.5,81570,31801,7287,8645
28076,1060,30,25221,9871,548,512
28077,385,38.4,19167,13956,172,213
28078,52776,35.4,83519,38134,26680,26096
28079,32322,35.1,66385,26736,15656,16666
28080,8383,39.9,57324,25656,4262,4121
28081,25527,37.8,37517,21009,12333,13194
28083,23618,38,37840,18752,11469,12149
28086,26564,43.1,38979,20241,13057,13507
28088,2877,47.5,37575,21446,1470,1407
28089,219,20.3,30625,6039,72,147
28090,8035,44.9,39339,19756,3873,4162
28091,2075,47,28520,19276,1203,872
28092,38278,41.1,41607,21032,18834,19444
28097,5759,40.2,51475,23446,3070,2689
28098,3723,39.5,43491,23966,1809,1914
28101,628,49,39219,26362,315,313
28102,100,39.3,89063,22984,53,47
28103,10024,41.5,47734,21202,5129,4895
28104,29378,40.3,92686,40405,14576,14802
28105,40529,38.8,63846,32598,19552,20977
28107,7136,42.7,49091,21628,3605,3531
28108,76,39.4,-666666666,20054,45,31
28109,301,21,35000,12721,164,137
28110,51733,34.2,57002,23018,25710,26023
28112,26162,38.3,47781,21914,12985,13177
28114,7015,44.4,44327,19661,3630,3385
28115,33908,37.6,53157,25048,17056,16852
28117,36076,39.1,78026,41696,18410,17666
28119,3635,36.9,32156,11946,1826,1809
28120,20253,40.7,50327,26833,9759,10494
28124,6285,44,46625,23341,3188,3097
28125,2536,43.7,48750,28210,1150,1386
28127,8078,43.4,45461,22110,4467,3611
28128,6753,44.7,40139,20352,3415,3338
28129,5493,43.9,52803,24431,2860,2633
28133,2783,46,40456,20999,1556,1227
28134,9998,34.9,50763,25856,4886,5112
28135,6051,34.6,40234,13785,3742,2309
28137,3167,39,44549,19164,1609,1558
28138,9846,40.6,42476,20512,4827,5019
28139,18931,45.5,40744,22648,9011,9920
28144,25406,35.5,33656,19309,12063,13343
28146,26585,43.3,46257,22377,13173,13412
28147,25337,35.8,43701,18853,13059,12278
28150,28289,40.5,34831,20820,13109,15180
28152,25209,37.8,42213,20039,12370,12839
28159,3169,39.1,36197,15516,1640,1529
28160,3771,41.3,25313,16950,1859,1912
28163,5980,33.6,50569,19084,3140,2840
28164,13172,41.9,48790,27945,6462,6710
28166,9089,42.1,52220,23020,4523,4566
28167,2626,48.2,31657,15812,1473,1153
28168,11391,39.6,44570,20163,5758,5633
28169,133,32.8,19250,11244,64,69
28170,11356,40.5,32730,18448,5148,6208
28173,45200,37.5,93297,38097,22654,22546
28174,9259,30.2,48077,17677,4067,5192
28202,10383,29.5,70300,58132,5551,4832
28203,12345,32.1,64604,55119,6009,6336
28204,5231,31.1,56286,42340,2642,2589
28205,45160,33.4,35310,23018,23208,21952
28206,11962,31.1,21087,11799,5693,6269
28207,9360,38.3,119063,92384,4243,5117
28208,34474,32.9,28435,14056,16580,17894
28209,21578,33.9,60180,43907,10466,11112
28210,42603,36.5,54915,43773,19877,22726
28211,29400,38.1,70403,55947,14041,15359
28212,40012,29.6,33781,16832,19269,20743
28213,36935,31.6,42405,21988,18106,18829
28214,33696,34.6,53527,24580,16522,17174
28215,54896,34,45983,19783,25804,29092
28216,48172,34.4,48491,24474,22176,25996
28217,28097,29.5,38832,17112,13924,14173
28226,37412,41.1,68291,48777,17418,19994
28227,51870,37.1,51527,24932,25977,25893
28244,0,-666666666,-666666666,-666666666,0,0
28262,40008,25.7,44481,22251,20034,19974
28269,74667,33.1,60070,27410,35864,38803
28270,32494,38.6,84429,43532,15389,17105
28273,32618,32.7,56048,25621,14919,17699
28277,60794,38,91989,50034,28372,32422
28278,21918,33.9,76566,35637,10668,11250
28280,0,-666666666,-666666666,-666666666,0,0
28282,0,-666666666,-666666666,-666666666,0,0
28301,17749,32.8,25465,17016,8028,9721
28303,29284,36.3,46919,27332,14079,15205
28304,38400,33.3,45190,21852,17332,21068
28305,6179,42.7,40134,32250,2995,3184
28306,41324,33,49082,22979,19719,21605
28307,19622,22.1,41460,15706,10130,9492
28308,293,22.3,-666666666,25883,242,51
28310,4534,22.9,-666666666,28063,4056,478
28311,33727,32.2,47308,24922,15940,17787
28312,18201,42.2,42037,23807,8751,9450
28314,52916,28.6,49011,24088,26028,26888
28315,12423,38.1,37672,20607,5802,6621
28318,4704,41.4,51090,24053,2392,2312
28320,9028,40,33497,18745,4164,4864
28323,3594,32.2,53854,19904,1700,1894
28325,661,26.5,35074,12613,287,374
28326,17733,29.1,43432,18037,8608,9125
28327,15333,40.6,51609,23841,7786,7547
28328,28150,38.9,36436,19639,13585,14565
28330,368,31.8,33929,14557,190,178
28332,485,27.9,27422,13605,264,221
28333,11103,34.9,39632,18667,5281,5822
28334,25216,39,35281,19878,12126,13090
28337,10065,41.2,29848,19040,4670,5395
28338,4756,36.8,29621,16323,2181,2575
28339,6574,42.2,40516,20005,3169,3405
28340,10622,42.2,26161,14825,5362,5260
28341,4076,40.5,36707,17722,2073,2003
28342,348,32.1,50417,17353,178,170
28343,1609,29.5,32321,15593,639,970
28344,3100,34,31977,15332,1607,1493
28345,12790,37.6,32966,16752,6075,6715
28347,1696,37.9,38438,12111,1094,602
28348,33279,32.8,51295,23372,15449,17830
28349,4277,38.3,39057,15572,2176,2101
28350,398,30.7,49915,20982,253,145
28351,3932,39.4,25139,13653,1835,2097
28352,26153,39,30342,16054,12936,13217
28356,5038,37.5,50400,23777,2732,2306
28357,3133,36.7,33953,17570,1530,1603
28358,39108,35.2,32964,17393,18871,20237
28360,16156,31.7,33299,15243,7896,8260
28363,1373,34,36119,17302,733,640
28364,15169,32.8,23317,12014,7001,8168
28365,17615,37.1,35680,18632,8681,8934
28366,5095,34.1,42705,19319,2582,2513
28367,117,32.1,28214,11665,48,69
28369,2664,39.7,32404,18620,1325,1339
28371,6628,33.6,43365,18333,3460,3168
28372,13271,30.6,27911,14295,6602,6669
28373,2469,34.5,41458,18802,1176,1293
28374,16359,59.6,71980,46135,7803,8556
28375,112,54,58750,24462,55,57
28376,39260,30.4,49298,19389,19321,19939
28377,13827,32.6,26708,13221,6560,7267
28379,25745,40.2,31358,18000,12619,13126
28382,7326,39.7,37576,20224,3434,3892
28383,7320,38.2,29471,16018,3428,3892
28384,12174,36.7,28045,14977,6030,6144
28385,2505,47.4,37244,26352,1124,1381
28386,5834,31.4,30093,12938,3015,2819
28387,13980,48.6,47982,34740,6708,7272
28390,21876,27.6,39413,19280,10680,11196
28391,5396,39.3,56607,23826,2840,2556
28392,1209,55,35347,28299,680,529
28393,1556,44.7,39917,16681,821,735
28394,5645,39,34614,23926,2608,3037
28395,1953,39.5,39813,23319,951,1002
28396,3063,39.2,31781,16574,1580,1483
28398,7506,40.2,28630,16187,3257,4249
28399,2047,41.6,36096,19809,928,1119
28401,22630,38.2,27702,19066,11377,11253
28403,38319,27.8,34356,22512,18313,20006
28405,29021,38.3,51580,32795,14507,14514
28409,30855,42.5,74633,41064,14708,16147
28411,32182,40.5,66553,33976,15764,16418
28412,35602,39.5,50654,28034,16543,19059
28420,3548,37.8,35061,17604,1888,1660
28421,1109,50.4,30657,21284,566,543
28422,6712,44.7,47484,22263,3581,3131
28423,2499,34.9,37946,15803,1105,1394
28424,61,47.6,16806,12141,26,35
28425,11984,36.5,40180,18661,6047,5937
28428,6175,42.3,61545,35588,2978,3197
28429,9039,35.9,48922,21373,4327,4712
28430,1550,36.6,28786,19681,600,950
28431,6091,42.8,28462,20487,2782,3309
28432,1778,39.5,44306,22015,933,845
28433,4955,45.1,26947,18472,2538,2417
28434,1370,46.8,26088,15202,698,672
28435,2289,47.2,35625,20965,1076,1213
28436,2170,37.9,45417,22077,1009,1161
28438,1646,47.3,44097,20294,935,711
28439,1818,46.9,38565,21169,845,973
28441,3791,36.4,24514,15154,1902,1889
28442,1208,48.3,38777,23420,571,637
28443,17769,41.9,50996,26826,8841,8928
28444,2609,36.2,39063,22820,1267,1342
28445,6412,36.4,56598,26816,3342,3070
28447,1936,37.4,29301,18228,939,997
28448,1149,40.5,37834,22740,456,693
28449,1643,58.4,67284,40474,764,879
28450,2369,44.5,55536,26011,1054,1315
28451,28304,38.8,49161,25408,14218,14086
28452,883,30.3,16961,5993,361,522
28453,4714,32.2,38848,15269,2622,2092
28454,1813,42.6,20711,13553,830,983
28455,1865,43.4,55417,24332,841,1024
28456,3453,42.5,43359,19887,1847,1606
28457,10031,38.9,43364,19797,4978,5053
28458,5745,38.8,26441,14002,2835,2910
28460,8583,33.1,46164,25115,4278,4305
28461,16040,55.9,50079,33553,7593,8447
28462,11380,49.8,35497,25045,5386,5994
28463,10837,38.3,23571,14901,5791,5046
28464,2345,30.6,29879,13140,1031,1314
28465,6700,52.9,49029,31924,3212,3488
28466,11194,37.2,35550,17951,5799,5395
28467,9319,60.9,44597,27470,4557,4762
28468,4351,64.9,55075,40675,2010,2341
28469,6293,57.7,49750,31153,2991,3302
28470,10221,41,35721,20092,4864,5357
28472,20915,40.1,35472,19131,10393,10522
28478,4112,46.6,32293,21332,2037,2075
28479,6174,39.1,52003,23481,2917,3257
28480,2511,38.2,69659,48382,1398,1113
28501,20785,38.4,28529,16851,9398,11387
28504,20832,43.2,43778,23147,10525,10307
28508,2822,30.2,47713,18884,1346,1476
28510,1262,55,48500,25671,580,682
28511,636,54.4,51042,25974,326,310
28512,3538,57,53102,35161,1855,1683
28513,10107,41.5,38648,19696,4694,5413
28515,2550,39.9,32315,15095,1563,987
28516,11773,44.2,37951,25471,5719,6054
28518,8335,39,37466,18354,4045,4290
28519,246,54.3,49464,25892,107,139
28520,345,44.2,38456,19482,118,227
28521,2248,48.3,30590,26158,1094,1154
28523,2392,45.5,47963,23889,1119,1273
28524,470,43,71071,27089,236,234
28525,2736,35.5,54227,19670,1301,1435
28526,2683,42.8,33354,15155,1332,1351
28527,1564,39.4,55658,23800,737,827
28528,492,54.5,38891,20926,226,266
28529,2653,45.1,41858,20985,1332,1321
28530,7408,43,35758,18973,3640,3768
28531,1457,51,51458,22096,698,759
28532,24882,26.2,45217,21803,13046,11836
28533,1986,21.5,-666666666,26659,1805,181
28537,174,26.9,34013,13479,90,84
28538,2195,42.3,49667,22449,1135,1060
28539,15202,27.7,47267,21111,8160,7042
28540,50745,27.5,42620,20340,25948,24797
28543,5287,21.9,33440,11647,2694,2593
28544,5561,24.3,33235,14324,2905,2656
28546,44364,26.5,48629,22592,22285,22079
28547,19145,21.5,50596,21252,15366,3779
28551,13804,39.4,37231,18884,6921,6883
28552,121,50.6,24013,16370,70,51
28553,384,63.1,62875,24545,190,194
28554,249,30.6,49934,21448,103,146
28555,4868,39.3,43750,20952,2496,2372
28556,985,46.3,55875,23561,482,503
28557,14180,47.9,43093,31042,6581,7599
28560,28683,41.3,46376,24961,13732,14951
28562,36394,41.8,51268,27552,17453,18941
28570,21503,41.2,45918,23486,10839,10664
28571,3014,58.6,57128,32294,1460,1554
28572,6584,42.4,42619,19609,3115,3469
28573,2508,45,31686,17708,1060,1448
28574,15232,29,46158,20070,7466,7766
28575,259,54.5,34250,27192,151,108
28577,592,52.3,72500,30768,300,292
28578,5596,36.1,41333,17555,3068,2528
28579,453,48.1,37071,21382,219,234
28580,12920,40.7,40326,18019,7211,5709
28581,151,54.9,48500,21752,86,65
28582,1753,39.3,47331,24646,899,854
28583,288,20.8,21779,9662,138,150
28584,11372,43,55581,29370,5341,6031
28585,3818,44.6,32708,20807,1971,1847
28586,7275,38.9,36532,17992,3870,3405
28587,340,39.8,35417,17958,152,188
28589,429,38.5,39348,20902,188,241
28590,23983,34,59059,28737,11579,12404
28594,3682,53,54201,38813,1937,1745
28601,48428,40.9,46330,27028,22843,25585
28602,29659,40.6,37803,19820,14572,15087
28604,6604,40,47992,29029,3178,3426
28605,3749,50.8,43536,32424,1709,2040
28606,1684,45.4,34728,18725,825,859
28607,33938,23.4,27819,18884,17182,16756
28609,5896,45.3,53003,25703,2953,2943
28610,9820,39,39886,19471,4650,5170
28611,1272,31.4,23068,11699,675,597
28612,12983,41.5,35336,16481,6243,6740
28613,23438,36.8,44920,21613,12201,11237
28615,1932,50.2,32500,18438,946,986
28616,349,22.5,29773,19999,164,185
28617,2562,36.2,43021,21044,1193,1369
28618,1871,44.3,41929,23581,1013,858
28619,1272,35.8,35667,18054,544,728
28621,10683,43.9,36560,18528,5124,5559
28622,2142,46.3,35110,22361,1042,1100
28623,1488,51.1,38370,19751,724,764
28624,1821,53.9,27428,16818,948,873
28625,36732,40.7,46426,22425,17771,18961
28626,2303,49.7,51974,25983,1175,1128
28627,1624,37.4,33381,14029,813,811
28628,320,38.8,38611,19315,168,152
28629,77,56.9,-666666666,17584,41,36
28630,20632,38.9,41200,19818,10135,10497
28631,622,43.6,40000,22225,328,294
28634,5727,39.9,36814,16758,2929,2798
28635,3920,35.6,30565,14292,2061,1859
28636,5900,41.7,37723,17978,2805,3095
28637,1596,38.2,34219,14884,896,700
28638,12223,42.1,39258,20769,6453,5770
28640,4940,41.7,32127,18289,2412,2528
28642,5939,42.8,34050,20245,2756,3183
28643,3751,46.3,29475,20118,1944,1807
28644,1216,56.1,28750,22697,526,690
28645,46444,42.6,30968,18399,22658,23786
28646,638,46.7,42727,40493,267,371
28647,92,32.5,54063,13750,42,50
28649,1397,37.9,22485,11243,666,731
28650,12046,39.9,47831,19626,5917,6129
28651,6674,40.7,34821,17830,3290,3384
28652,99,39.5,-666666666,4963,67,32
28654,4111,39.8,37042,21402,1905,2206
28655,55330,40.2,37295,20178,27993,27337
28657,9663,46.6,36016,22869,4956,4707
28658,26148,41.8,40405,20529,12738,13410
28659,20539,42.3,30191,17279,10281,10258
28660,2339,39.5,48224,20063,1108,1231
28662,13,-666666666,-666666666,,13,0
28663,709,39.6,36000,20294,369,340
28665,2462,45.2,42661,23422,1145,1317
28666,499,27.7,53523,19650,234,265
28667,477,45.3,31458,14542,220,257
28668,377,56,44962,27036,227,150
28669,3273,44.1,29467,16928,1509,1764
28670,3308,40.5,27371,16285,1442,1866
28671,624,55.8,48220,21098,278,346
28672,0,-666666666,-666666666,-666666666,0,0
28673,5707,43.2,61741,32335,3150,2557
28675,6122,48.2,33411,19901,3086,3036
28676,3351,50.4,35226,24612,1702,1649
28677,32557,38.3,34793,19550,15286,17271
28678,5253,38.7,41204,17902,2763,2490
28679,2129,37.3,32204,18155,1102,1027
28681,25727,41.1,39819,20347,12956,12771
28682,996,52.2,59107,37967,401,595
28683,1958,42.8,38323,17988,982,976
28684,2459,48.5,40385,22242,1213,1246
28685,1484,49.3,39671,23006,773,711
28689,1921,38.4,49104,19787,1103,818
28690,9238,46.6,40316,22178,4383,4855
28692,3593,48.7,46667,28230,1836,1757
28693,1415,49.4,47722,19889,706,709
28694,7733,44.8,35476,21516,3639,4094
28697,12899,42.9,39945,25458,6155,6744
28698,2124,42.3,46779,23607,1046,1078
28701,4008,46.1,51027,23281,1909,2099
28702,568,54.7,31635,20810,293,275
28704,21536,40.8,60077,29725,10465,11071
28705,6713,46.4,36023,20791,3377,3336
28707,100,60.8,54000,29980,59,41
28708,665,38.7,38889,24928,352,313
28709,2003,51.4,31406,21103,942,1061
28711,12599,44.4,42271,23832,5925,6674
28712,18048,49.4,40732,24005,8463,9585
28713,9011,46.7,43855,23080,4680,4331
28714,16466,46,39232,20520,7943,8523
28715,25488,41.5,43690,23600,12743,12745
28716,16858,44,42557,22536,8318,8540
28717,2334,42.1,49886,30628,1148,1186
28718,326,59.9,49274,21352,201,125
28719,8264,31.2,26565,13306,3675,4589
28720,147,53.2,39625,21612,83,64
28721,9488,43.8,29631,20005,4636,4852
28722,6866,50,43841,22450,3293,3573
28723,10563,21.7,23613,13271,5362,5201
28725,8,-666666666,-666666666,,5,3
28726,3359,40.7,25283,16562,1722,1637
28729,2907,36,44471,24960,1509,1398
28730,10321,42.4,54488,29546,4893,5428
28731,7771,46,42546,23847,3756,4015
28732,15406,40.6,45273,26177,7436,7970
28733,57,61.2,33750,18332,17,40
28734,26792,46.9,37066,20993,12999,13793
28735,215,50.3,39625,25815,104,111
28736,1048,37.7,31223,19372,577,471
28739,20336,53,51163,30206,10043,10293
28740,1803,41.8,31699,15406,910,893
28741,3833,58.4,50459,46029,1799,2034
28742,3403,49.2,49910,25387,1446,1957
28743,1894,51.4,24159,15467,798,1096
28745,724,60.3,95455,39875,333,391
28746,2484,58,47292,34434,1243,1241
28747,2380,42.8,36197,23375,1262,1118
28748,11706,43.1,40781,20928,5696,6010
28749,0,-666666666,-666666666,-666666666,0,0
28751,3129,54.6,40714,27006,1560,1569
28752,30584,42.1,33386,19340,15009,15575
28753,11426,44.5,40578,19923,5804,5622
28754,7962,40.7,38148,19426,3878,4084
28756,4083,40.8,33740,21397,1968,2115
28757,316,61.5,53750,31053,150,166
28759,6875,49.4,60061,30844,3394,3481
28761,7794,41.3,39847,18629,3950,3844
28762,6810,44.4,37054,18232,3644,3166
28763,2391,50.9,43992,22696,1198,1193
28766,1241,49.4,43964,27198,715,526
28768,7166,51.2,41315,23489,3262,3904
28771,8137,41.7,34081,19718,4028,4109
28772,1600,52.8,52064,19156,799,801
28773,2701,47.3,48359,30297,1408,1293
28774,1407,61.1,56250,33899,633,774
28775,356,29.5,24583,14726,95,261
28777,10081,43.6,40000,19156,5656,4425
28778,10697,38.4,38589,19719,5235,5462
28779,16457,42.2,41446,24536,8050,8407
28781,814,55.1,30938,17861,425,389
28782,6662,56.9,46713,28377,3233,3429
28783,1055,46.3,21421,16611,536,519
28785,8418,44.7,50610,27457,4095,4323
28786,20411,48.4,42419,26233,9619,10792
28787,19133,42.9,50230,25410,9227,9906
28789,4609,46.8,39060,20931,2248,2361
28790,3412,38.7,48246,23077,1851,1561
28791,15109,51.4,54146,29830,6683,8426
28792,32082,43.2,36683,21510,15741,16341
28801,14421,37.3,29441,22705,6881,7540
28803,29324,41.7,45833,33161,13941,15383
28804,20645,42.4,50058,30600,10060,10585
28805,17732,47.4,45720,31006,8221,9511
28806,38110,35.4,41548,21269,18164,19946
28901,5363,46.1,30595,17309,2669,2694
28902,1598,46.4,43469,22179,833,765
28904,8174,51.6,37250,22855,3962,4212
28905,2931,41.7,41250,21763,1361,1570
28906,18562,50.4,34451,17721,8953,9609
28909,1063,53.7,43224,21231,522,541
29001,1954,36.9,33205,17998,869,1085
29003,6825,41.5,37560,19155,2999,3826
29006,9471,42.6,33340,18592,4574,4897
29009,2346,47,31098,16966,1158,1188
29010,12060,39.1,27674,14160,6486,5574
29014,1852,45.7,44043,20308,903,949
29015,1414,42.7,28207,16124,687,727
29016,16479,39.1,76156,34145,7921,8558
29018,3691,40,33472,16109,1694,1997
29020,22509,42.8,42158,24776,10769,11740
29030,2312,42.9,43958,24420,1126,1186
29031,1430,46.2,25865,18038,660,770
29032,4444,33.9,26467,13367,2063,2381
29033,12232,37.3,43624,23925,6005,6227
29036,18643,45,78522,36749,9479,9164
29037,950,44.8,46089,20127,458,492
29038,2908,39.5,43175,17409,1384,1524
29039,4238,32.1,32140,15231,1877,2361
29040,9335,33.3,51056,21440,4952,4383
29042,5587,34.7,22489,17545,2862,2725
29044,5599,40.5,44773,20912,2739,2860
29045,21378,38.2,55658,25691,10710,10668
29046,279,60,24239,17474,134,145
29047,3697,48.4,34750,19907,1822,1875
29048,4903,49,33797,14695,2237,2666
29051,1756,30.8,40234,9596,1437,319
29052,2068,39,23500,15571,1085,983
29053,19368,34.8,36264,17220,9438,9930
29054,9459,38.7,54086,25904,4817,4642
29055,4926,37.8,27382,14020,2491,2435
29056,2510,39.6,23023,13380,1104,1406
29058,4641,38.7,35033,18877,2398,2243
29059,5633,34,23086,13931,2627,3006
29061,14647,38.1,55400,23458,6836,7811
29062,123,48.3,46200,18472,53,70
29063,34172,36,66829,31215,16376,17796
29065,786,46.5,25463,18166,340,446
29067,11071,40,34219,16566,6300,4771
29069,5353,37.6,32472,15892,2564,2789
29070,14876,43.3,41633,23903,7096,7780
29072,51055,37.6,76124,34814,25216,25839
29073,40827,36.1,52158,22882,19656,21171
29074,204,65.5,60871,26712,100,104
29075,3236,43.7,70491,30459,1652,1584
29078,15199,39.6,48534,23150,7412,7787
29079,46,-666666666,-666666666,,38,8
29080,3194,47.8,25197,16066,1464,1730
29081,1050,48.5,19125,17479,463,587
29082,580,36.8,27308,17889,280,300
29101,3208,33,47759,19114,1546,1662
29102,18117,42.7,32184,18338,8479,9638
29104,1633,44,28542,19029,725,908
29105,937,34.8,36971,22532,492,445
29107,2923,43.1,39241,19841,1480,1443
29108,21017,35.7,36141,18676,10051,10966
29111,1754,31.8,40694,16630,842,912
29112,4686,43.8,30908,18470,2247,2439
29113,2176,32.1,36875,13381,948,1228
29114,2112,42.7,31227,14145,920,1192
29115,28719,35.2,29288,15851,13258,15461
29117,1104,19.8,-666666666,1563,621,483
29118,15950,41.5,46915,25660,7567,8383
29122,51,51.8,43500,29035,21,30
29123,7209,36.5,47585,18314,3418,3791
29125,2470,44.2,24419,16660,1038,1432
29126,2237,46.3,50190,23070,1094,1143
29127,7556,46.2,54910,29134,3606,3950
29128,5610,41.2,32050,16936,3113,2497
29129,3548,40.7,37433,20065,1903,1645
29130,7440,44.9,44359,26877,3961,3479
29133,1308,40.3,35809,16013,679,629
29135,8772,40.8,38295,21222,4286,4486
29137,2845,38,38342,19621,1383,1462
29138,10767,36.3,36336,17628,5640,5127
29142,5347,41.2,31250,16918,2624,2723
29145,690,44.5,28929,19091,375,315
29146,1695,47.6,31250,20667,736,959
29147,0,-666666666,-666666666,-666666666,0,0
29148,6909,50,28952,17908,3464,3445
29150,41044,35.2,38761,21894,18965,22079
29152,1482,22.1,31104,12617,881,601
29153,16700,35,36146,15954,8099,8601
29154,29547,35.8,49271,22002,14319,15228
29160,8490,38.7,51594,20996,3964,4526
29161,11303,38.8,40158,18366,5348,5955
29162,2731,38.7,27361,18274,1379,1352
29163,2038,40.8,28765,14383,933,1105
29164,3837,44.2,36170,21176,2066,1771
29166,1014,43.1,53269,28522,540,474
29168,2686,37.9,32448,15962,1341,1345
29169,22364,36.7,40298,25188,11024,11340
29170,21101,36.8,56415,25261,10547,10554
29172,9085,35.9,45839,22663,4352,4733
29175,352,46.3,24813,17991,141,211
29178,3136,48.3,28635,16437,1510,1626
29180,13678,38.8,37893,18791,6351,7327
29201,21057,22.4,29557,18470,10775,10282
29202,234,23.7,25417,36381,122,112
29203,40391,35.7,31262,17235,17813,22578
29204,20381,37.5,32272,22134,9181,11200
29205,26510,30,42721,31706,14014,12496
29206,19137,38,65707,39744,8643,10494
29207,10505,20.7,34875,14904,7283,3222
29208,844,19.4,-666666666,5500,395,449
29209,33381,34.6,46449,27817,16425,16956
29210,41047,31.3,37818,19045,21249,19798
29212,29043,41.3,67840,33896,14380,14663
29223,50639,36.4,51040,28017,24249,26390
29225,1029,19,-666666666,5904,67,962
29229,43933,32.1,63753,26536,19808,24125
29301,30123,36,40142,22566,14440,15683
29302,17475,41.1,53345,29163,8239,9236
29303,25416,30.7,26855,13101,12274,13142
29306,16173,37.9,26656,16410,6759,9414
29307,19317,42.8,43672,26176,9131,10186
29316,22273,36.4,57716,25216,10842,11431
29320,819,29,23264,12569,352,467
29321,2138,48.4,27857,19161,923,1215
29322,8541,45.1,44269,20973,3973,4568
29323,15011,41.7,42315,19673,7745,7266
29324,147,49.1,49167,22309,85,62
29325,15069,34.7,35041,16835,7357,7712
29329,199,26.2,20724,11376,79,120
29330,8216,38.7,35486,17589,3971,4245
29331,163,46.7,43125,10822,55,108
29332,2709,52.9,37114,21369,1484,1225
29333,444,53.2,20844,8042,162,282
29334,12774,34.6,47103,24459,6497,6277
29335,5749,39.1,42153,16546,3509,2240
29338,11,-666666666,-666666666,,0,11
29340,20974,36.6,30230,16488,10231,10743
29341,19353,39.1,39334,20735,9071,10282
29346,134,56.7,14297,15433,74,60
29349,29747,39.4,47811,23495,14497,15250
29351,1356,41,43571,19741,591,765
29353,3833,37.7,30191,16427,2034,1799
29355,933,41,31455,17888,423,510
29356,7571,47.9,45682,28917,3842,3729
29360,21074,38.8,33056,18287,9850,11224
29364,590,45.6,37500,19080,301,289
29365,9659,36,50755,21207,4845,4814
29368,16,-666666666,-666666666,,0,16
29369,14236,35.5,61831,27940,6993,7243
29370,523,47.2,27045,21522,253,270
29372,4646,44.4,36425,17715,2280,2366
29373,155,33.5,40486,8959,94,61
29374,3108,42.5,50859,25134,1627,1481
29375,156,17.5,26094,11266,69,87
29376,6696,39.4,58185,25504,3197,3499
29377,562,31.9,50225,18443,374,188
29378,118,53.8,12019,8676,66,52
29379,19433,42.6,35121,19912,9207,10226
29384,4657,45,41913,20719,2324,2333
29385,7360,38.8,33685,18141,3508,3852
29388,14182,41.6,37877,19644,6940,7242
29401,10746,27,54405,44299,4448,6298
29403,22031,27.2,27108,20755,10711,11320
29404,1129,22.3,33201,15722,743,386
29405,28248,33.5,24650,14754,15135,13113
29406,30103,29,35656,17009,14268,15835
29407,34658,39,47678,29021,16143,18515
29409,2178,20.3,190938,6087,2010,168
29410,18475,35.3,48223,25399,9622,8853
29412,35493,39,59216,36388,17491,18002
29414,34605,36.3,63805,32177,15780,18825
29418,22875,33.1,42190,23422,11516,11359
29420,23084,31.4,56864,24433,10946,12138
29423,555,19.6,-666666666,3202,225,330
29424,339,19.5,-666666666,2515,146,193
29426,1535,50.3,31607,16648,721,814
29429,3192,41.9,35284,26893,1344,1848
29431,6302,39.3,43604,19582,2931,3371
29432,2775,46.4,39620,22762,1423,1352
29434,456,38.9,48750,20108,241,215
29435,3676,43.5,30816,19238,1828,1848
29436,3999,48.9,42500,19070,2099,1900
29437,2231,47.6,26192,22448,1211,1020
29438,2385,58.5,57328,40743,1217,1168
29439,2299,46.8,72193,48688,1279,1020
29440,28033,42.1,33289,20015,13317,14716
29445,56629,30.9,58037,24120,29742,26887
29446,1272,51,66169,23075,665,607
29448,2061,48.5,33558,17317,909,1152
29449,7705,50.5,46541,31258,3583,4122
29450,2894,39.9,34762,18745,1318,1576
29451,4245,49.8,81157,55730,2184,2061
29452,233,29,27993,10285,116,117
29453,1442,40.5,51389,22156,682,760
29455,21631,40.1,60954,36676,10497,11134
29456,30719,31.7,48801,20267,14170,16549
29458,2501,49.9,36993,19179,1335,1166
29461,31217,38.6,47392,22481,15178,16039
29464,44849,39,68721,41359,21420,23429
29466,29160,37.3,84665,37835,14105,15055
29468,1768,43.8,19663,28526,838,930
29469,605,46.1,37600,36986,321,284
29470,4202,42.4,43936,25860,2115,2087
29471,1382,46.5,35536,20332,723,659
29472,9411,40.9,43324,16691,5476,3935
29474,2358,46.1,38661,16832,1260,1098
29475,2642,47.5,27245,17334,1313,1329
29477,6491,44.1,31273,18182,3097,3394
29479,7990,39.7,38538,16459,3958,4032
29481,2098,38.9,37054,16919,1004,1094
29482,1969,51.9,111250,73024,854,1115
29483,66204,35,51814,23652,31313,34891
29485,48443,35.7,59449,26416,23611,24832
29487,2924,50,47068,32758,1345,1579
29488,21990,38.6,33692,18362,10266,11724
29492,10731,35.6,88837,46944,5340,5391
29493,107,49.8,73750,28469,60,47
29501,43971,38.2,47202,27250,20536,23435
29505,26598,37.4,54110,24611,11888,14710
29506,20683,35.3,31180,17973,9550,11133
29510,11320,34.3,25010,14056,5145,6175
29511,4778,40,41883,20075,2162,2616
29512,19061,39.2,29037,14412,10462,8599
29516,801,48.1,32736,17788,466,335
29518,1332,44.5,32708,15668,535,797
29519,294,57.1,23792,13560,106,188
29520,14797,42.8,29401,17863,6757,8040
29525,1626,43.9,21550,15016,789,837
29526,40040,38,41108,21121,19299,20741
29527,24582,35,35927,16537,11842,12740
29530,2347,36.4,35439,15307,1219,1128
29532,19914,38.8,31049,18025,9295,10619
29536,17830,37.3,26113,14817,8547,9283
29540,5838,43.3,40276,16745,2785,3053
29541,8885,37.4,43512,23049,4525,4360
29543,605,53.5,34726,19530,218,387
29544,5225,35.4,39757,15950,2450,2775
29545,1983,32.7,36066,14743,848,1135
29546,2648,43.9,25578,18302,1160,1488
29547,1855,43,32595,14556,887,968
29550,31845,40.7,39893,22233,15358,16487
29554,9301,43.6,32063,17105,4439,4862
29555,6357,35.4,33646,16902,3215,3142
29556,12299,39.6,28445,15460,5615,6684
29560,12960,40.8,31177,18739,5968,6992
29563,2482,38.9,28856,15950,1177,1305
29564,725,42.9,23945,13807,370,355
29565,7672,36,28681,12813,3426,4246
29566,16118,51,42919,24958,7840,8278
29567,680,34.4,38942,14772,288,392
29568,13371,43.7,43304,23184,6275,7096
29569,15980,37.3,36246,17059,7496,8484
29570,4203,32.7,29095,13514,2035,2168
29571,15788,37,30690,16691,7191,8597
29572,8253,56.5,53092,46288,4244,4009
29574,11797,43,28750,16291,5435,6362
29575,16270,50.3,43127,27133,7546,8724
29576,25174,55.5,45905,33966,12145,13029
29577,27503,36,35352,22346,13911,13592
29579,32097,35.2,51414,26870,16641,15456
29580,1250,49.4,19182,12610,486,764
29581,4307,39.3,32326,18586,2031,2276
29582,14899,55.7,46636,34388,7307,7592
29583,5818,35.5,43090,18679,2888,2930
29584,2476,39.5,31795,15802,1094,1382
29585,13356,55.4,55471,33967,6407,6949
29588,36438,40.8,43792,21787,18145,18293
29590,4086,37.8,20911,10254,2848,1238
29591,5205,39.1,34637,17544,2640,2565
29592,1029,34.6,34375,16329,505,524
29593,2416,41.1,38824,21669,1140,1276
29594,122,39.9,47708,15271,50,72
29596,2471,40.4,25000,16512,1212,1259
29601,10751,38.8,32068,30002,5768,4983
29605,35157,35.2,41333,26066,16863,18294
29607,35840,34.3,48809,30197,17226,18614
29609,28386,35.6,40705,25708,13902,14484
29611,28826,36.3,26723,14303,14134,14692
29613,1580,20,-666666666,3275,736,844
29614,2679,20.5,36719,5902,1099,1580
29615,32967,41.9,49964,35906,15876,17091
29617,26624,34.6,36936,18716,12684,13940
29620,13165,42.9,33531,17504,6276,6889
29621,41422,38,49703,26140,20021,21401
29624,14047,40.1,22044,13793,6428,7619
29625,27097,39.3,39205,22028,13628,13469
29626,13896,40.7,39598,18829,6776,7120
29627,17213,43.5,43434,21876,8215,8998
29628,2690,42.8,31344,16986,1468,1222
29630,14344,27,32445,21632,7182,7162
29631,13259,24.4,39955,23482,7189,6070
29634,6402,19.4,3404,2351,3183,3219
29635,1406,47.1,42795,25761,643,763
29638,3038,40.4,36920,21222,1514,1524
29639,1691,23,53958,16034,899,792
29640,30611,40.9,40731,20217,15290,15321
29642,28936,40.3,59068,26607,13820,15116
29643,2876,48.1,48724,25514,1376,1500
29644,18742,37.5,46112,21638,9325,9417
29645,9133,42.4,45107,21214,4312,4821
29646,28603,36.1,26950,17762,13084,15519
29649,25589,37.1,50385,24621,12164,13425
29650,33900,39.3,70098,34253,16536,17364
29651,44733,38.5,49217,24715,21941,22792
29653,4838,44.2,41098,23056,2457,2381
29654,10194,43.6,42742,20893,4743,5451
29655,7291,45.7,33481,17058,3520,3771
29657,14691,38.3,39343,19446,7045,7646
29658,304,50.8,36806,19720,193,111
29659,152,26.6,15417,10288,67,85
29661,5469,44.6,35349,21832,2926,2543
29662,14604,38.8,51742,25199,6476,8128
29664,1765,54.4,46371,22133,831,934
29665,49,68.3,-666666666,15502,7,42
29666,6812,42.7,41023,21763,3137,3675
29667,246,39.7,31875,15663,129,117
29669,12296,39.3,39861,21104,5985,6311
29670,8558,42.4,37140,22054,4194,4364
29671,17210,42.8,42873,22223,8471,8739
29672,11535,47.4,61622,34385,6130,5405
29673,25872,39,44200,22307,11960,13912
29676,5203,58.8,51898,36050,2639,2564
29678,22277,38.4,36890,21792,10499,11778
29680,28807,36.3,64385,27552,14738,14069
29681,49692,39.2,75832,33678,24661,25031
29682,3965,42.5,41686,21726,2029,1936
29683,242,38.6,53419,17460,183,59
29684,4577,41,35282,16481,2461,2116
29685,1127,53.3,66528,43070,554,573
29686,1047,46.1,50076,21241,537,510
29687,42351,38.5,49773,23904,20045,22306
29689,4168,45,55943,22252,2068,2100
29690,20841,36,46409,21561,10170,10671
29691,11657,34.7,37287,18013,5431,6226
29692,4938,38.8,35036,17430,2208,2730
29693,13914,46.7,33350,19848,6853,7061
29696,3900,43.2,49438,23683,2171,1729
29697,12122,37.6,51947,22210,5640,6482
29702,10137,39.4,34047,16454,4996,5141
29704,4091,43.6,45096,21809,2253,1838
29706,19640,40.8,30879,17290,9251,10389
29707,18862,43.8,60169,31161,8802,10060
29708,27047,37.9,94463,37203,12865,14182
29709,6154,39.3,38942,18347,2889,3265
29710,29485,38.9,55525,27080,14382,15103
29712,2383,37.6,43750,22942,1082,1301
29714,2676,40.9,32782,23654,1422,1254
29715,25505,38.6,70522,32804,11953,13552
29717,1096,40.8,49375,23546,512,584
29718,3972,36.5,32955,17266,2064,1908
29720,46633,39.2,35092,17816,22593,24040
29724,14,-666666666,-666666666,,10,4
29726,1881,42.7,45082,20576,961,920
29727,1561,39.6,49500,18651,749,812
29728,9854,37.7,28780,14633,5051,4803
29729,2209,42.1,45104,21480,1119,1090
29730,52496,34.4,37152,19990,25174,27322
29732,54548,37.7,56825,28020,26488,28060
29733,1731,19.6,-666666666,2871,538,1193
29741,2004,47.5,31518,18833,1050,954
29742,2477,45.8,42341,21789,1106,1371
29743,981,43.8,45368,23379,571,410
29745,29857,39.3,48924,22340,14606,15251
29801,27047,36.9,39630,21915,12699,14348
29803,37092,46.8,62568,34908,17936,19156
29805,5724,40.6,38125,21415,2840,2884
29809,2354,35.9,34705,17682,1146,1208
29810,5008,36.3,24914,14573,2573,2435
29812,11295,37.7,35331,20130,5294,6001
29816,1566,31.2,24470,12592,592,974
29817,5640,41,32456,17124,2669,2971
29819,1331,43.4,43224,17477,745,586
29821,1113,38.8,63125,27942,602,511
29824,8577,40.7,34393,17049,5125,3452
29826,142,34.5,14286,11006,75,67
29827,4524,38.6,24288,11035,2537,1987
29828,1232,46.4,19243,12368,571,661
29829,9352,36.3,45637,21910,4529,4823
29831,3559,41.2,34909,20890,1658,1901
29832,5664,43.8,33156,16269,2734,2930
29834,1344,38.9,32375,16178,708,636
29835,6835,56.1,40298,24244,3283,3552
29836,598,54.7,48487,29182,311,287
29838,558,55.1,49250,54594,302,256
29840,245,36.1,17024,11695,105,140
29841,32639,40,47094,25334,15609,17030
29842,9236,36.9,30537,15873,4708,4528
29843,1607,45.1,27440,18172,840,767
29844,88,55.5,24643,27126,47,41
29845,968,38.8,40000,20317,460,508
29847,4513,40.1,43477,18188,2449,2064
29848,981,44.3,45250,20297,501,480
29849,213,36,12115,13285,100,113
29850,274,40.7,26865,13272,166,108
29851,7228,31.9,34330,17876,3719,3509
29853,6407,38.4,40427,16670,3248,3159
29856,3698,33.1,30714,13694,1691,2007
29860,14547,42,66070,28568,7073,7474
29899,1177,39,-666666666,416,1177,0
29902,14956,35.2,51383,27199,7507,7449
29904,296,20.8,-666666666,18707,268,28
29905,3989,20.2,85769,14275,3278,711
29906,22027,26.9,43055,19552,10635,11392
29907,12049,40.6,66798,33427,6014,6035
29909,16801,66.2,65487,41003,7652,9149
29910,35253,34.9,57665,28066,17794,17459
29911,1846,40.9,30096,30337,1006,840
29912,0,-666666666,-666666666,-666666666,0,0
29915,603,29.9,74500,46470,379,224
29916,1504,49.1,30469,16440,710,794
29918,5520,36.6,32969,16963,3073,2447
29920,9667,51.6,48668,27774,4500,5167
29921,210,51.3,28333,16832,115,95
29922,1119,45.9,32989,18568,638,481
29923,476,54.5,22500,8980,206,270
29924,3957,38.8,42303,19786,1976,1981
29926,24845,50.2,71124,42155,11975,12870
29927,8214,28.6,39450,16524,4234,3980
29928,15870,59.8,70079,53613,7887,7983
29929,1023,40.4,43866,18834,557,466
29932,247,34.1,31771,16760,137,110
29934,1086,47.1,33065,18460,533,553
29935,3020,40.2,40432,26060,1129,1891
29936,13953,37.1,35642,17679,7556,6397
29939,218,38.5,23750,12846,113,105
29940,4240,37,35049,17492,1832,2408
29941,414,61.6,60938,80312,203,211
29943,472,50.2,56809,23635,269,203
29944,5451,41.6,39572,21106,2579,2872
29945,4589,32.6,23679,11572,2033,2556
30002,6123,36.8,50174,35407,2986,3137
30004,54714,36.7,95922,47376,27553,27161
30005,37014,35.7,102230,43754,18647,18367
30008,32366,31.2,42707,20113,16506,15860
30009,14584,38.3,72798,36235,7062,7522
30011,15328,34.7,53907,22215,7367,7961
30012,27342,34.1,42890,19244,13075,14267
30013,25636,35.3,54572,23463,11889,13747
30014,36840,34.8,45837,21915,17514,19326
30016,50852,34.2,51550,20226,24061,26791
30017,21151,38.5,78783,30719,10757,10394
30019,41483,34.6,77872,28231,19948,21535
30021,24504,29.7,31612,13536,12150,12354
30022,66120,37.5,99597,42659,32972,33148
30024,68650,36.2,99931,37352,35336,33314
30025,8756,40.2,49868,24565,4476,4280
30028,21234,36.8,66724,25938,10609,10625
30030,25701,38.2,66134,41718,11274,14427
30032,48693,36.1,33475,16716,23595,25098
30033,29604,36.3,59997,35870,13629,15975
30034,45359,35.2,48210,20837,20328,25031
30035,20154,33.9,41584,18760,9473,10681
30038,39490,33.9,48856,24007,17271,22219
30039,42049,34.3,60819,24370,19429,22620
30040,58225,35.3,81378,30623,28883,29342
30041,56176,39.2,92733,38615,27587,28589
30043,83855,33.9,67260,26317,41590,42265
30044,81764,33.2,51827,22190,40421,41343
30045,33063,35.8,71401,25456,16237,16826
30046,34744,33.8,47003,19533,17064,17680
30047,61805,37.7,67395,27484,30606,31199
30052,59226,34.9,63338,24201,28994,30232
30054,11826,38.8,60798,24316,5584,6242
30055,3080,37.5,60568,25293,1573,1507
30056,2229,44.6,45336,21180,1207,1022
30058,54053,31.5,45792,20649,24339,29714
30060,35761,30.2,36284,16627,17604,18157
30062,63806,39.8,86352,38957,31140,32666
30064,46401,40.9,74603,36075,22398,24003
30066,52060,40.1,77661,36393,26009,26051
30067,45206,33.4,48093,34720,22673,22533
30068,33185,43,101284,46555,16133,17052
30070,253,37.1,32083,14728,127,126
30071,21172,30.6,41165,20179,11195,9977
30072,588,47.3,52976,33277,263,325
30075,55253,42.1,102305,47380,26872,28381
30076,41719,36.7,68108,37868,20231,21488
30078,34676,39.5,67018,28282,15563,19113
30079,3507,31.1,30139,16707,1543,1964
30080,53298,32.6,52249,36047,25399,27899
30082,24720,36.1,70884,36740,11665,13055
30083,52056,32.6,41179,18916,23999,28057
30084,35524,37.4,52167,27583,17549,17975
30087,35077,42.6,68063,30811,16267,18810
30088,27003,35.8,46108,20882,12881,14122
30092,31992,34.4,58791,35396,15945,16047
30093,56213,29.2,35037,14832,29135,27078
30094,31024,40.3,57033,26465,14726,16298
30096,67110,32.2,49883,25227,30734,36376
30097,41467,38,97612,44968,20168,21299
30101,55141,36.8,75421,31013,27092,28049
30102,35198,36.3,62523,28076,17970,17228
30103,16596,35.2,44600,18695,8232,8364
30104,4357,39,41096,19459,2083,2274
30105,2339,48.5,59400,28826,1243,1096
30106,18316,38.7,45850,24017,8621,9695
30107,12522,40.6,63362,27977,6373,6149
30108,7644,38.6,37335,19726,3393,4251
30110,12638,40,44078,21314,5794,6844
30113,6180,44.2,37789,18950,3250,2930
30114,50138,37.4,59879,28031,24632,25506
30115,38093,35.8,73032,29158,18560,19533
30116,22793,34.7,50983,22504,11805,10988
30117,34266,31.9,36075,19839,16172,18094
30118,2380,19,-666666666,2392,1175,1205
30120,37250,35.9,44141,20678,18484,18766
30121,21652,35.9,46344,21703,10677,10975
30122,23930,32.8,42308,20359,11685,12245
30124,2984,38.4,45167,19615,1508,1476
30125,24840,35.1,38377,16511,12268,12572
30126,40243,35.1,67955,33413,19316,20927
30127,60016,38,71164,28683,28520,31496
30132,33402,35.2,64878,23969,16263,17139
30134,43108,34,49386,21496,20793,22315
30135,61298,35.9,60035,25697,28673,32625
30137,1838,42.5,61667,24923,953,885
30139,4087,40.8,39286,20025,2051,2036
30141,21935,35.6,56990,24210,10939,10996
30143,21086,45.4,53792,29612,10717,10369
30144,51872,32.1,59758,27364,25407,26465
30145,8713,37.3,59931,21026,4261,4452
30147,5481,37.9,35408,16214,2729,2752
30148,413,48.4,40227,24203,179,234
30149,1396,19.9,-666666666,3727,297,1099
30152,41689,36.7,74559,35046,19455,22234
30153,18382,36.7,44072,19858,9019,9363
30157,46413,33.1,59301,22820,22749,23664
30161,35367,39.5,39356,21606,17402,17965
30164,0,-666666666,-666666666,-666666666,0,0
30165,38941,36.4,40105,20172,18479,20462
30168,25777,30.2,36172,16531,12247,13530
30170,3501,38.1,57759,22920,1753,1748
30171,3601,37.5,59859,21991,1908,1693
30173,5556,40.7,47014,21800,2770,2786
30175,6221,37.5,43474,21421,3040,3181
30176,7187,37.4,37688,18245,3522,3665
30177,1369,35.9,33866,15101,683,686
30178,3355,39.9,67444,29161,1715,1640
30179,16505,36.7,47961,20007,8535,7970
30180,34137,35.4,60428,26193,16492,17645
30182,3259,33.7,38750,17778,1744,1515
30183,5298,40.3,59091,25167,2778,2520
30184,7233,38.5,57234,24946,3385,3848
30185,4084,37.5,50986,21415,2006,2078
30187,8806,42.3,64328,27458,4438,4368
30188,54177,35.6,69186,30092,26115,28062
30189,36506,38.2,76464,33420,17993,18513
30204,12724,37.2,37286,17013,5903,6821
30205,2875,46.2,76016,34729,1481,1394
30206,2971,36,55684,20650,1487,1484
30213,28726,32.7,53956,23135,13033,15693
30214,29291,44.1,64712,29929,13917,15374
30215,32317,42.4,87289,36264,15821,16496
30216,2361,31.9,53355,16758,1142,1219
30217,9432,39,38852,18866,4723,4709
30218,2174,42.2,50189,19011,1169,1005
30220,5036,32.9,48958,22400,2264,2772
30222,4581,43.8,33500,20295,2271,2310
30223,35169,38.5,36401,18256,16965,18204
30224,25651,38.1,46894,22280,12629,13022
30228,36771,33.5,54757,21314,17179,19592
30230,8736,38,37056,17979,4202,4534
30233,22588,40.5,49188,21373,12085,10503
30234,2065,32.1,59833,18388,1128,937
30236,44082,33.9,40107,21374,21568,22514
30238,36899,31.1,43569,16682,17403,19496
30240,28553,39.3,47700,25025,13354,15199
30241,24178,33.2,40653,18471,11848,12330
30248,22772,35.8,68759,27140,10971,11801
30250,995,30.2,-666666666,10088,804,191
30251,2806,31.4,39141,15402,1329,1477
30252,43451,36.3,71962,26821,21055,22396
30253,52256,34,57913,25320,24914,27342
30256,2524,36.9,48795,20784,1240,1284
30257,4540,40.6,51750,24174,2196,2344
30258,2743,40.8,48375,21078,1420,1323
30259,3128,43.7,49722,23047,1556,1572
30260,26660,33.8,42204,17479,12237,14423
30263,52604,36.8,47331,23666,25991,26613
30265,32344,36.7,73826,30341,15628,16716
30268,9736,32.7,47421,22939,4909,4827
30269,34879,42.2,87159,38600,16566,18313
30273,13866,35,42620,18884,6514,7352
30274,34607,32.3,37920,17135,16622,17985
30275,0,-666666666,-666666666,-666666666,0,0
30276,14538,34,64867,27089,7276,7262
30277,21169,41.2,75578,32468,10137,11032
30281,65931,35.6,53818,23543,31394,34537
30284,55,51.2,74167,30278,30,25
30285,544,33.3,47353,21616,268,276
30286,23746,41.6,34446,17467,11242,12504
30288,10620,30.9,49693,19098,4206,6414
30289,52,57.5,55313,23450,13,39
30290,8400,40.8,86627,36658,4254,4146
30291,21147,31.4,36355,18192,8857,12290
30292,6597,31.8,60701,21541,2935,3662
30293,2503,46.5,37404,18703,1304,1199
30294,38015,35.2,56577,23748,18356,19659
30295,4389,43,40639,21213,2214,2175
30296,26587,34.2,50810,19877,12373,14214
30297,27678,29.9,30598,12244,14610,13068
30303,5001,22.8,19000,12180,2787,2214
30305,21262,37.7,85993,74976,9920,11342
30306,21262,37.6,82566,67959,10333,10929
30307,17684,35.2,76591,57430,8969,8715
30308,16434,30.2,51584,42155,8972,7462
30309,21074,35,71854,66311,11251,9823
30310,27775,36.6,22861,14667,13351,14424
30311,36074,36.4,27651,17213,15476,20598
30312,19644,32.7,39105,30162,9492,10152
30313,9489,21.2,39670,15706,5974,3515
30314,21045,27.5,23649,12934,10284,10761
30315,33248,34.2,20951,14821,16357,16891
30316,30700,36.4,44129,26437,15075,15625
30317,11787,36.6,50548,30618,5336,6451
30318,53622,29.7,39421,25451,27943,25679
30319,36947,36.5,87759,63624,17670,19277
30322,2364,19.8,-666666666,1863,1115,1249
30324,26900,33.4,63810,51006,14752,12148
30326,5118,34.1,81794,64121,2705,2413
30327,22735,43.8,139543,95742,10934,11801
30328,32447,37.7,73434,51254,15063,17384
30329,26211,30.9,43933,30532,13621,12590
30331,59107,34.6,41777,22710,26812,32295
30332,3200,20,-666666666,2007,1918,1282
30334,0,-666666666,-666666666,-666666666,0,0
30336,752,29.1,35484,13072,444,308
30337,11388,34.3,28388,19263,5506,5882
30338,32737,38.3,82765,47959,15798,16939
30339,18904,31.7,63871,53088,9352,9552
30340,31559,30.4,40955,18720,17340,14219
30341,30139,33.3,52423,31021,16330,13809
30342,31965,33.1,68867,51621,16354,15611
30344,32715,35.3,36830,19267,15888,16827
30345,24261,33.7,67335,40502,12543,11718
30346,5184,32.4,63409,50100,2589,2595
30349,68941,31.8,43498,21145,31609,37332
30350,33451,32.8,51133,44680,15777,17674
30354,15983,32.3,28230,16595,7452,8531
30360,15476,32.9,48336,26229,8412,7064
30363,2845,27.8,56806,41158,1592,1253
30401,13457,34.5,31228,16013,6385,7072
30410,1836,42.8,35991,19449,1028,808
30411,5234,35.3,28919,6378,4232,1002
30412,78,32.7,52500,20323,40,38
30413,1505,47.4,33375,20291,802,703
30415,7641,39.6,46636,20406,3870,3771
30417,11009,34.4,36459,18702,5301,5708
30420,1291,35.3,31094,14178,655,636
30421,3648,40.4,28902,17780,1788,1860
30423,166,45.5,51250,22746,27,139
30425,1433,40.5,45347,26357,700,733
30426,894,45.8,32500,13376,532,362
30427,11550,36.2,46486,18840,6750,4800
30428,2238,47.1,30750,18262,917,1321
30429,303,40.1,23707,11751,174,129
30434,6009,35.7,26125,13357,2903,3106
30436,11600,34.5,28394,15519,5601,5999
30438,63,45.7,54063,20943,29,34
30439,11039,37.3,34625,17945,5483,5556
30441,1825,41.2,36410,21227,879,946
30442,7305,42,25047,15983,3389,3916
30445,3574,33.1,30125,13153,1793,1781
30446,1722,34.3,41917,21607,951,771
30448,80,21.5,49375,20044,53,27
30449,107,42.5,34821,12433,55,52
30450,2259,34.7,31356,16262,1103,1156
30451,28,52.3,50625,23050,12,16
30452,1479,43.8,36091,17749,702,777
30453,10058,33.8,30570,10467,6291,3767
30454,412,50.5,35313,13809,194,218
30455,438,50.8,26875,16013,216,222
30456,2271,39.2,43571,17420,1082,1189
30457,6333,37.9,34152,18522,3147,3186
30458,41829,23.2,27908,16731,20558,21271
30460,804,19.5,-666666666,1258,374,430
30461,13720,34.6,53606,24355,6885,6835
30464,94,33.1,21667,9206,54,40
30467,12413,40.2,35620,18658,5999,6414
30470,428,46.6,35100,21101,189,239
30471,4893,37.4,30898,15687,2680,2213
30473,2801,38.1,36651,18590,1497,1304
30474,16788,38.3,31946,20741,7622,9166
30475,0,-666666666,-666666666,-666666666,0,0
30477,3400,35.3,20992,11730,1662,1738
30501,27169,30.7,31588,18076,13521,13648
30504,22659,30,42034,18721,11742,10917
30506,41560,41.5,63038,32116,20705,20855
30507,29839,30.5,44527,16108,14642,15197
30510,8268,35.7,36926,14998,3366,4902
30511,3337,34.6,44504,20020,1692,1645
30512,19192,52.8,39269,22339,9387,9805
30513,11216,48.9,29751,17376,5182,6034
30516,1585,39.7,35625,22797,797,788
30517,13374,33.6,67712,31315,6489,6885
30518,45866,35.1,63843,27427,22742,23124
30519,40881,36.2,70015,26516,21050,19831
30520,4681,38.1,29983,15068,2354,2327
30521,4148,46.5,29647,18727,1992,2156
30522,767,61.8,41208,26101,371,396
30523,12436,48.7,43717,24555,6266,6170
30525,7501,40.5,32620,21233,3621,3880
30527,3975,45,65948,27120,2144,1831
30528,22817,40.3,36982,20327,11304,11513
30529,10412,38.2,38632,19088,4991,5421
30530,6947,38.9,43333,18305,3458,3489
30531,11445,35.1,35083,17372,5234,6211
30533,26185,36.3,41635,20484,12907,13278
30534,27968,40.2,53289,26133,13607,14361
30535,7353,33.9,41703,17399,3530,3823
30536,8042,49.1,42138,25889,4265,3777
30537,1580,57.8,46946,28577,786,794
30538,2514,45.1,40625,16839,1132,1382
30540,17982,40.8,37017,19195,8918,9064
30541,1707,47.7,41850,23859,870,837
30542,33420,36.8,67411,26778,16568,16852
30543,4108,40.8,50146,19738,2215,1893
30545,666,54.3,28221,20409,284,382
30546,6580,55.7,36871,23228,3278,3302
30547,3517,36.4,39118,19196,1782,1735
30548,15934,41.6,77143,31040,7862,8072
30549,22398,36.7,58061,25297,11449,10949
30552,1518,54.3,32941,24950,847,671
30553,6911,43.3,38580,21312,3513,3398
30554,7771,37.6,49455,22831,3941,3830
30555,2030,41.9,26893,17903,1008,1022
30557,4401,41.4,40982,21218,2205,2196
30558,5231,40.7,43140,18013,2611,2620
30559,3911,50.5,39615,23005,2008,1903
30560,4478,48,36913,19624,2282,2196
30562,685,41.9,20862,14804,295,390
30563,5438,39.3,46646,19560,2776,2662
30564,3714,40.5,64213,23422,1970,1744
30565,4088,41.7,44589,21374,1992,2096
30566,8539,32.1,41559,19842,4066,4473
30567,2985,39.1,50293,23005,1535,1450
30568,2300,48.4,52778,22766,1223,1077
30571,3951,53.3,55000,32400,1976,1975
30572,1537,55.3,28013,17404,864,673
30573,98,65.6,122727,47443,51,47
30575,1124,49.1,46797,27132,614,510
30576,2432,48.2,30132,18703,1081,1351
30577,23003,40.4,37109,18512,10878,12125
30581,0,-666666666,-666666666,-666666666,0,0
30582,4875,40.7,42511,16810,2258,2617
30601,21349,26,20884,13402,10663,10686
30602,2562,19.4,-666666666,2073,1035,1527
30605,40159,24.4,31319,18570,19104,21055
30606,40963,30.1,39623,26512,19519,21444
30607,11865,31,44225,18917,5864,6001
30609,1659,18.8,-666666666,1857,474,1185
30619,1429,49.9,56000,26896,701,728
30620,12043,33.2,62500,23500,6096,5947
30621,4882,41.7,72679,29780,2331,2551
30622,10222,38,58571,32392,4660,5562
30623,182,45.6,34028,16105,84,98
30624,3141,37.9,37802,18083,1568,1573
30625,2309,45.6,48831,25995,1229,1080
30627,2080,49.4,34583,20020,1035,1045
30628,7127,36.9,43868,20791,3627,3500
30629,4346,44.6,37280,20494,2045,2301
30630,2286,44.6,45703,17523,1251,1035
30631,1859,44.2,25523,13557,847,1012
30633,8399,38.8,41074,18751,4214,4185
30634,2164,43.4,43108,19460,1156,1008
30635,15839,41.7,34933,18725,7489,8350
30641,2069,37.1,82206,31994,1041,1028
30642,10792,49.1,45647,32729,5459,5333
30643,17064,43.8,35433,20453,8298,8766
30646,6735,39.3,42641,19986,3189,3546
30648,3371,41.9,48571,18682,1467,1904
30650,11805,37.4,48392,26757,5467,6338
30655,22953,36.5,41929,20091,10692,12261
30656,15905,37.6,53828,22741,7835,8070
30660,1123,38.3,40781,18695,511,612
30662,8517,35.1,31680,18264,4306,4211
30663,3226,45.9,42595,21568,1644,1582
30664,11,64.3,23750,19000,6,5
30665,113,36.9,30417,10103,63,50
30666,9287,37.3,53627,23167,4343,4944
30667,943,33.3,39315,17656,421,522
30668,1891,48.7,26376,15618,1018,873
30669,3464,40.5,30938,15993,1596,1868
30673,7767,44.7,29414,18206,3686,4081
30677,16711,39.2,68969,31054,8410,8301
30678,1426,52.5,35536,23354,764,662
30680,39230,33,53266,20995,19607,19623
30683,6788,36.8,48077,25356,3500,3288
30701,39365,36.2,41923,19336,19382,19983
30705,34139,36.5,35548,16363,16809,17330
30707,16162,37.7,39763,20289,7941,8221
30708,273,47.9,80119,23744,96,177
30710,6292,40.2,42331,21005,3185,3107
30711,3761,42.2,32834,17450,1919,1842
30720,28466,37.1,42902,23511,13853,14613
30721,51763,31.8,35507,15727,26106,25657
30725,3638,48,50576,26226,1626,2012
30726,0,-666666666,-666666666,-666666666,0,0
30728,19519,39.1,38023,19473,9658,9861
30730,1689,38.6,36058,15907,844,845
30731,2220,40,36439,18011,1222,998
30733,1789,44.5,39500,17488,773,1016
30734,3436,42.1,34263,19394,1800,1636
30735,5893,35.1,41183,16708,3190,2703
30736,41467,38.2,54967,23435,20413,21054
30738,3669,46.8,51411,27404,1721,1948
30739,5674,41.9,62601,23287,2920,2754
30740,8816,35.7,58553,26837,4465,4351
30741,30809,39.6,34728,18052,14907,15902
30742,7220,44.1,35764,20584,3325,3895
30746,1245,38.5,49097,18408,717,528
30747,16942,41.5,34497,16654,8829,8113
30750,4563,27.5,69797,31348,2310,2253
30751,74,45.5,48942,17647,33,41
30752,9235,40.7,42385,21836,4524,4711
30753,7206,34.8,32409,15130,3587,3619
30755,9072,38.1,40218,19775,4473,4599
30756,217,22.7,53889,10974,112,105
30757,2365,39,31377,15401,1202,1163
30802,5463,44.8,67049,28762,2605,2858
30803,655,50.1,24441,16167,306,349
30805,2452,39.4,38547,15933,1156,1296
30807,92,45.4,38333,19280,32,60
30808,4627,42.1,43435,19632,2116,2511
30809,41342,38.5,86628,35896,20356,20986
30810,2122,42.6,34279,17919,986,1136
30812,440,54.9,-666666666,8458,226,214
30813,33290,31.4,58601,23259,16763,16527
30814,8280,39.2,41747,21447,3797,4483
30815,41845,33.5,49979,20534,19316,22529
30816,2263,40.1,43025,20797,1097,1166
30817,7595,45.2,35830,20611,3704,3891
30818,524,28.7,40810,14218,310,214
30820,1417,40.8,48750,18188,731,686
30821,938,46.1,22786,13171,391,547
30822,820,31.6,35781,15139,451,369
30823,1668,43.6,43194,22146,786,882
30824,17024,37.8,34567,17681,8173,8851
30828,4016,41.5,28125,16631,1890,2126
30830,14040,34.1,29097,16079,6523,7517
30833,3544,38.5,33257,17009,1766,1778
30901,16148,36.2,16631,12697,8104,8044
30903,493,29,77176,32473,217,276
30904,26108,35.8,30691,19593,12936,13172
30905,7185,22.3,47872,19357,4525,2660
30906,60634,32.5,34265,16731,28681,31953
30907,49959,38.6,62758,32902,24342,25617
30909,38822,34.7,41666,28716,18353,20469
30912,254,26.8,-666666666,9822,118,136
31001,4745,40.4,31722,9608,3214,1531
31002,2868,42.8,42439,24531,1505,1363
31003,152,55.3,71875,34225,68,84
31005,15848,34.8,72254,31658,7836,8012
31006,4799,40.4,28598,16109,2506,2293
31007,1105,41.8,29417,14202,461,644
31008,18002,38.5,54878,23593,8792,9210
31009,1545,38.3,29219,18193,875,670
31011,1088,36.6,40143,20091,542,546
31012,3055,38.5,45750,10219,2328,727
31014,14095,38.2,35958,20080,6702,7393
31015,22347,37.6,34879,18108,10763,11584
31016,1139,45.3,35556,18796,631,508
31017,1666,44.5,38456,21794,762,904
31018,2926,39.6,46136,12931,2118,808
31019,2265,40.3,37330,17066,1113,1152
31020,2383,45.3,27586,18892,1156,1227
31021,27992,38,36654,19847,13267,14725
31022,1399,39.8,49800,22933,677,722
31023,14377,38.1,35568,18806,7010,7367
31024,20505,44.1,44379,26157,10166,10339
31025,1601,42.3,82143,26052,814,787
31027,10796,37.4,30128,14791,5151,5645
31028,5201,39.4,57444,26544,2611,2590
31029,16559,37.4,45728,19807,8158,8401
31030,19756,29.3,33116,16180,9463,10293
31031,6697,36.7,42203,21350,3575,3122
31032,13740,37.6,58560,26678,6795,6945
31033,1921,39,30412,18808,815,1106
31035,1431,32.3,42500,17108,731,700
31036,12514,42.3,45100,19564,5342,7172
31037,3810,35.4,21617,8604,2351,1459
31038,774,45.4,56607,32444,403,371
31039,0,-666666666,-666666666,-666666666,0,0
31041,1135,40.7,19940,13970,617,518
31042,2144,40.2,29849,14141,977,1167
31044,2546,45.9,25915,14780,1282,1264
31045,77,64.1,10833,9431,37,40
31046,3230,46.6,58156,25703,1722,1508
31047,10869,39.3,81379,32816,5305,5564
31049,1721,48.4,44028,21688,789,932
31050,1146,49.6,54239,20374,773,373
31051,202,41.8,21944,12930,88,114
31052,8373,46.2,65333,27933,4444,3929
31054,1770,38.6,30972,14033,757,1013
31055,10033,40.9,29295,13006,5754,4279
31057,2078,44.9,32869,17081,1119,959
31058,1401,51.2,32304,18168,629,772
31060,1884,43.8,31066,19716,940,944
31061,43970,34.5,33558,18471,21755,22215
31062,278,68.3,-666666666,12455,196,82
31063,5609,37.6,25796,13204,2615,2994
31064,9252,37.1,41309,21217,4670,4582
31065,852,50.3,31214,20865,429,423
31066,1042,43.1,31250,27383,497,545
31067,258,50.7,45139,18363,119,139
31068,5254,36.7,34758,12311,3252,2002
31069,20853,37.5,51739,25197,10652,10201
31070,1171,43.8,43385,18746,603,568
31071,1316,39.4,33750,16613,625,691
31072,1494,38.3,39875,18870,660,834
31075,2561,31.8,42375,19386,1115,1446
31076,3196,41,29054,19231,1383,1813
31077,1043,45,34850,17928,481,562
31078,3310,40,30417,16493,1841,1469
31079,2141,42.9,35709,18802,1151,990
31081,265,23,25788,10715,134,131
31082,10146,37.2,29351,18780,4619,5527
31083,247,34.1,36875,13206,126,121
31084,88,24.9,2499,1103,5,83
31085,1153,35.3,49643,18589,545,608
31087,9271,42.5,24586,12341,5062,4209
31088,49883,34,58276,26993,24588,25295
31089,4746,36.7,33477,15746,2332,2414
31090,610,52.3,31000,17791,275,335
31091,5354,41.3,31010,9420,3793,1561
31092,6612,40.1,28540,18585,2998,3614
31093,29558,32.2,32445,16791,13287,16271
31094,976,51.7,38561,24824,463,513
31096,7310,39.9,35811,15253,4175,3135
31097,1215,46.9,39911,23623,518,697
31098,3278,21.9,56004,18660,1791,1487
31201,9049,33.2,18642,14154,4763,4286
31204,29913,38.5,27439,19157,13510,16403
31206,30595,28.6,23681,10736,13656,16939
31207,1277,19.5,-666666666,349,332,945
31210,32074,37.4,62328,33661,14824,17250
31211,16078,38.6,37363,21191,7497,8581
31213,0,-666666666,-666666666,-666666666,0,0
31216,16655,39.1,59659,24885,8944,7711
31217,18762,36.9,30756,15987,9024,9738
31220,13695,36.2,57700,27056,6365,7330
31301,5414,26.2,38445,16326,2582,2832
31302,8777,35.6,64643,23342,4393,4384
31303,2136,43.5,45781,19927,1101,1035
31304,0,-666666666,-666666666,-666666666,0,0
31305,7195,39.5,35244,20790,3412,3783
31307,651,41.9,37328,22847,277,374
31308,7035,35.2,47315,19239,3556,3479
31309,953,41.9,44511,19491,532,421
31312,15309,38.8,63204,25780,7548,7761
31313,41339,27.7,45852,21770,19742,21597
31314,1549,21.8,-666666666,23296,1497,52
31315,8376,20.6,35628,12149,4212,4164
31316,10179,34.1,45972,17821,4865,5314
31318,372,48.5,110473,45314,154,218
31320,9153,40.9,49864,25273,4624,4529
31321,6082,33.4,46143,19207,3380,2702
31322,22431,32.6,64533,28515,10653,11778
31323,1573,51.3,43869,21504,776,797
31324,21428,36.1,80288,31613,10251,11177
31326,20171,33.6,67723,26527,10026,10145
31327,121,60.4,-666666666,62697,74,47
31328,3329,53.8,53471,33690,1676,1653
31329,9406,34.6,51359,20016,4664,4742
31331,6627,46.6,39650,21250,2982,3645
31401,20177,27.7,23090,20075,9501,10676
31404,31634,31.9,31263,16634,14750,16884
31405,37016,34.6,43051,23719,18008,19008
31406,34607,36.2,44547,24496,17031,17576
31407,8686,31.5,62760,26646,4221,4465
31408,10170,33.9,30029,14097,5456,4714
31409,389,22.6,-666666666,25542,368,21
31410,23603,41.8,68834,38085,11833,11770
31411,8034,63.6,106979,64753,3897,4137
31415,12172,33.7,24125,12939,5719,6453
31419,54730,30.7,48750,24517,25760,28970
31501,14868,39.8,30829,17971,7669,7199
31503,21445,36.1,37236,19831,10408,11037
31510,10143,36.5,34300,18798,5153,4990
31512,2787,30,49868,21746,1274,1513
31513,16456,37.8,36533,19698,8217,8239
31516,14585,38.3,38125,20014,7026,7559
31518,519,50.1,37457,21929,279,240
31519,3144,40.5,33367,18930,1466,1678
31520,21289,36.7,29522,17441,10225,11064
31522,14846,53.2,66580,48045,6902,7944
31523,14026,36.1,57021,24540,6488,7538
31524,0,-666666666,-666666666,-666666666,0,0
31525,28726,36.4,46082,23223,13650,15076
31527,693,65.7,70964,49193,354,339
31532,1005,32.9,36719,19457,503,502
31533,16206,36.8,32222,17764,7221,8985
31535,12349,32.3,41069,18183,6259,6090
31537,10913,39.6,42162,16800,6033,4880
31539,14181,36.1,36101,17490,7184,6997
31542,2678,33.6,27600,15354,1286,1392
31543,3971,38.3,41661,17236,2206,1765
31544,490,56.9,19952,13896,257,233
31545,16010,35.3,33456,16886,7582,8428
31546,8218,40.5,38831,16860,4933,3285
31547,952,22,45238,24428,819,133
31548,20880,31.3,55238,21351,10163,10717
31549,1615,34,19097,13438,757,858
31550,612,41.6,37468,23606,309,303
31551,1089,30.3,36750,14123,530,559
31552,1031,39.8,41429,16826,535,496
31553,5213,40.2,31321,16203,2723,2490
31554,7906,34.9,33521,11330,5131,2775
31555,2894,37.3,40000,18381,1608,1286
31556,116,29,21875,8625,54,62
31557,2847,45.3,35385,21639,1530,1317
31558,20964,29.5,50879,23239,11028,9936
31560,2693,41.4,36505,20019,1389,1304
31561,560,36.7,19444,22095,227,333
31562,2229,35.9,35027,18556,1307,922
31563,1479,38.8,42024,18177,811,668
31565,1462,50.4,40208,23777,699,763
31566,4503,39.3,41675,15954,1995,2508
31567,1119,39.4,41133,18807,584,535
31568,1009,38.9,29118,21204,541,468
31569,5425,42.4,52121,25632,2652,2773
31601,33968,29.2,24582,12881,16624,17344
31602,34255,29.6,36181,21530,17175,17080
31605,21588,28.2,53807,22925,10924,10664
31606,4054,37.6,48861,20729,2033,2021
31620,10693,36.6,36863,19827,5263,5430
31622,1874,36,32361,18535,851,1023
31623,105,43,35250,7577,77,28
31624,955,36.1,38194,17139,427,528
31625,1574,41.5,30448,14524,754,820
31626,3555,47.1,43231,19204,1620,1935
31627,207,36.7,24196,13597,94,113
31629,819,53.6,33679,15390,363,456
31630,487,24.5,34628,15650,219,268
31631,701,41.4,41625,16650,411,290
31632,10778,33.1,51578,22049,5070,5708
31634,5740,36.9,23547,17991,2723,3017
31635,5949,35.6,31151,16706,3020,2929
31636,9616,36.1,44975,20655,4490,5126
31637,3009,41.5,30116,16801,1653,1356
31638,1007,32.6,24472,15801,589,418
31639,10441,40.5,30607,17518,4992,5449
31641,1753,34.1,47043,17561,781,972
31642,4894,34.4,27674,15836,2416,2478
31643,8696,40,36411,18963,4174,4522
31645,6039,30.2,39846,15849,3180,2859
31647,3257,31.6,33844,16289,1445,1812
31648,1139,27.6,24183,11425,501,638
31649,1373,36.9,46417,24777,645,728
31650,3157,35.6,25139,15259,1709,1448
31698,1396,18.7,-666666666,2698,289,1107
31699,324,21.1,-666666666,21915,269,55
31701,21467,33,20872,13734,9848,11619
31705,34946,29.4,27112,13904,16680,18266
31707,25386,35.2,34654,22291,11235,14151
31709,15712,32.8,37056,20302,7248,8464
31711,810,43.9,33021,14104,334,476
31712,1002,46.7,45179,19243,498,504
31714,6276,40.1,25725,17005,3177,3099
31716,2817,37.8,35450,17244,1263,1554
31719,10626,33.2,29667,14962,5093,5533
31720,494,40.2,23092,12071,213,281
31721,19775,40,61026,29216,9509,10266
31722,530,35.3,25000,11713,231,299
31730,9526,36.2,33350,17721,4548,4978
31733,2079,46.8,63125,25549,1032,1047
31735,821,40.7,44375,24177,376,445
31738,1835,38,41319,21588,985,850
31743,419,40.3,29375,14236,178,241
31744,2747,35.9,38900,18043,1193,1554
31747,147,51.4,20500,15248,70,77
31749,2903,35.1,40811,13689,1379,1524
31750,19001,37,29934,14764,8992,10009
31756,1303,46.3,32813,15214,547,756
31757,10392,38.9,42131,19867,5173,5219
31763,23881,36.1,58235,26245,12385,11496
31764,1395,43.9,34138,16906,666,729
31765,2806,42,24056,14313,1467,1339
31768,23784,36.4,30511,16710,11566,12218
31771,6207,32.9,33524,17690,2944,3263
31772,541,44.6,41912,18321,234,307
31773,3406,46.3,37872,18282,1835,1571
31774,6101,36.2,31752,16833,3282,2819
31775,2835,32.4,18375,12815,1645,1190
31778,2317,48.6,37254,24751,1123,1194
31779,9940,37.1,26995,12856,5797,4143
31780,2204,44.7,29274,16606,1219,985
31781,1921,41.9,37981,18281,998,923
31783,986,41.5,38750,19507,487,499
31784,764,35,36136,19310,425,339
31787,1192,39.1,29535,19891,507,685
31788,10317,31.9,37906,17353,5446,4871
31789,1736,41.5,29358,15776,932,804
31790,1974,40.5,40759,18504,1075,899
31791,11637,39.4,35594,18658,5359,6278
31792,23915,37.5,31591,21275,11137,12778
31793,9098,29.4,47607,19015,4596,4502
31794,26239,36.6,31069,19187,12151,14088
31795,2431,28.3,46046,17507,1147,1284
31796,1185,54.2,28717,20665,624,561
31798,869,43.4,51211,21396,417,452
31801,2360,46.3,34811,15548,1243,1117
31803,6686,39.4,31815,18233,3458,3228
31804,6005,41.1,88151,32610,2960,3045
31805,3353,34.1,34271,17550,1796,1557
31806,4802,40.6,38600,19141,2406,2396
31807,2489,39,75563,33230,1371,1118
31808,6752,41.4,81325,33385,3451,3301
31810,217,46.7,26875,19889,137,80
31811,5018,39.5,52283,27425,2674,2344
31812,399,47.9,17560,18349,166,233
31814,254,23.9,43618,16645,132,122
31815,2817,36.9,30721,13981,1950,867
31816,5632,36.7,32878,16342,2483,3149
31820,8546,42.6,101193,43390,3998,4548
31821,442,31.8,21756,11214,283,159
31822,5638,41.9,44472,27336,2765,2873
31823,721,45.1,37396,23426,349,372
31824,1858,37.6,36037,17955,988,870
31825,2857,46,20303,14550,1448,1409
31826,3065,38.6,37885,17145,1332,1733
31827,2690,44.7,25000,14783,1292,1398
31829,1101,40.6,99508,31971,509,592
31830,2115,43.7,35301,17040,931,1184
31831,3349,44.7,51633,28419,1706,1643
31832,127,61.2,58438,29787,65,62
31833,7777,41.4,34167,21383,4105,3672
31836,881,47.6,20375,21139,487,394
31901,8048,34,14504,13814,4141,3907
31903,22594,29.8,22063,11725,10958,11636
31904,32416,38.6,42392,30871,15258,17158
31905,20069,21.3,52260,17723,13804,6265
31906,20567,37,33974,24178,9343,11224
31907,56859,35.1,40972,19314,26846,30013
31909,34763,34.2,58447,28503,15352,19411
32003,28738,41.2,89419,34453,13859,14879
32008,5470,48.4,28537,19377,2770,2700
32009,3138,38.1,56750,21640,1648,1490
32011,14541,40.8,52509,22575,7456,7085
32024,20526,37.4,39300,19451,10417,10109
32025,23341,35.2,39916,17493,12329,11012
32026,889,32.5,-666666666,495,889,0
32033,4679,44,49257,26529,2447,2232
32034,31477,49.4,62932,37240,15020,16457
32038,8197,47.6,40729,22363,4117,4080
32040,6981,39.7,60881,25323,3650,3331
32043,25160,39.5,56283,26782,12341,12819
32044,2112,38.5,42813,17791,1051,1061
32046,9129,38.2,45918,20829,4550,4579
32052,8806,36.5,42784,13333,5659,3147
32053,3970,44.7,36766,22348,2005,1965
32054,11668,38.7,41450,15345,7266,4402
32055,16543,40.5,34974,19845,8109,8434
32058,4732,38.3,42500,15610,2922,1810
32059,2197,36.4,39219,17589,1064,1133
32060,22853,42.7,41129,20041,11946,10907
32061,165,47.6,63359,16140,74,91
32062,2117,43.2,34063,16553,943,1174
32063,14185,35.9,47823,20041,6763,7422
32064,6841,34.4,24090,14169,3530,3311
32065,35947,32,63850,24407,18022,17925
32066,7119,33.5,41509,18820,4332,2787
32068,48490,38.2,56573,23868,23844,24646
32071,2602,48.7,25815,16418,1389,1213
32072,194,58.4,65818,23131,88,106
32073,39458,39.4,52800,27245,18869,20589
32079,293,81.2,33056,25435,95,198
32080,21450,53.2,58648,38612,10293,11157
32081,4670,36.2,85354,35401,2286,2384
32082,29538,49.6,87878,62837,14166,15372
32083,4713,41.3,47400,7721,3891,822
32084,30993,40.7,37670,21126,14717,16276
32086,25200,47.7,47670,26398,11648,13552
32087,5561,32.8,35509,12578,3559,2002
32091,14968,40.7,38443,18703,7294,7674
32092,29960,35.7,87640,35826,14805,15155
32094,2178,53.3,33911,19108,1148,1030
32095,6625,39.6,63651,30981,3531,3094
32096,2587,48.4,30962,17390,1414,1173
32097,15765,38.9,54851,24402,7657,8108
32102,2040,60.6,30120,19650,1124,916
32110,7538,40.3,33967,18635,3351,4187
32112,8421,39.2,28214,13444,4457,3964
32113,5419,48.5,34750,20136,2487,2932
32114,32630,32.4,25150,14521,16077,16553
32117,25306,40.9,27106,15921,12017,13289
32118,15841,55.8,33942,27860,7570,8271
32119,20630,45.5,35727,21976,9860,10770
32124,5119,36.8,43698,20324,3541,1578
32127,29978,50.2,43857,27654,14041,15937
32128,16858,51.9,63161,38189,7937,8921
32129,20300,48.1,40497,23404,9553,10747
32130,5779,41.2,44677,19763,2504,3275
32131,4407,41.7,41619,27095,2337,2070
32132,6671,50,45213,24819,3122,3549
32133,77,-666666666,-666666666,,38,39
32134,7914,50.3,33539,16721,3885,4029
32136,7496,56.4,48767,32663,3740,3756
32137,36076,53.7,51153,28756,17593,18483
32139,1132,57.1,22768,17061,596,536
32140,1023,48.5,45321,23896,546,477
32141,18026,49.4,44518,24802,9057,8969
32145,4904,43.6,41750,18564,2645,2259
24078,7832,38.9,37741,22759,3483,4349
24079,1825,48.1,39969,24651,1017,808
24082,421,53.5,40568,16260,252,169
24083,2277,46.4,91295,47678,1209,1068
24084,11290,45.1,47428,24154,5656,5634
24085,2043,46.5,50107,23123,1058,985
24086,231,32,26188,12218,72,159
24087,4706,41.1,43142,22227,2189,2517
24088,5058,28.9,37482,15365,2725,2333
24089,2841,48,33984,16320,1324,1517
24090,5138,45.4,67206,39781,2224,2914
24091,6426,45.5,46040,22608,2952,3474
24092,3070,46.9,42373,21229,1520,1550
24093,199,47.4,52986,16920,105,94
24095,4148,45.2,52000,27011,2069,2079
24101,6604,44.4,64332,30044,3159,3445
24102,1773,40.4,42125,18680,857,916
24104,3727,53.1,58555,29660,1701,2026
24105,942,35.9,28914,13497,477,465
24112,32773,45.1,32566,20194,15553,17220
24120,1802,51.2,34732,21078,958,844
24121,9538,51.6,56387,33074,4700,4838
24122,1889,49.8,52096,26000,971,918
24124,4236,42.5,42623,20317,2142,2094
24127,4289,44.4,46134,21327,2114,2175
24128,1683,47.6,55481,32149,808,875
24130,0,-666666666,-666666666,-666666666,0,0
24131,31,-666666666,-666666666,,17,14
24132,456,47.5,18566,14490,224,232
24133,2478,46.9,33005,18357,1028,1450
24134,5626,41.5,46354,24400,2752,2874
24136,3588,42.9,47435,22885,1715,1873
24137,2893,46.3,54979,30491,1511,1382
24138,1646,43.4,64125,23216,891,755
24139,800,53.7,37174,17153,413,387
24141,21702,30.7,39808,20647,10499,11203
24142,2755,19.2,-666666666,4338,1135,1620
24147,1187,53.5,36406,22825,600,587
24148,7685,47.1,40159,21112,3661,4024
24149,3493,36.7,70097,27545,1887,1606
24150,783,47.3,36217,18370,382,401
24151,19066,41.8,38887,22230,8995,10071
24153,36526,42.2,52924,28314,17727,18799
24161,257,66.2,21583,16673,96,161
24162,1830,50.4,43533,25736,976,854
24165,1125,51.6,30139,18283,528,597
24167,255,54.2,18083,36215,99,156
24168,324,35.4,71520,22244,123,201
24171,7881,49.9,34048,21013,3820,4061
24174,2579,45.8,45030,24130,1257,1322
24175,9719,48.4,70671,33095,4947,4772
24176,1723,41.9,47115,25296,906,817
24179,18464,42.8,50819,25389,8912,9552
24184,4505,50.1,49688,24284,2319,2186
24185,1573,29.9,44559,15864,915,658
24201,16755,41.9,31977,18873,7746,9009
24202,13195,42.1,43996,27097,6769,6426
24210,16239,44.7,39229,23820,8041,8198
24211,10503,46.4,50598,31817,5008,5495
24216,2891,36.2,29091,15730,1345,1546
24217,451,48.1,45147,20359,230,221
24219,11661,39.5,37258,18185,6339,5322
24220,615,39.9,46923,22993,319,296
24221,944,40.6,44938,17942,479,465
24224,6830,40.6,34390,18214,3425,3405
24225,2033,38.4,28427,16871,928,1105
24226,1713,40.8,31765,14699,846,867
24228,6636,49.9,32612,20105,3300,3336
24230,8813,41,32777,17210,4629,4184
24236,3371,49.8,32083,20717,1510,1861
24237,1235,40.8,24545,15686,695,540
24239,180,48.4,26250,16092,68,112
24243,2489,44.6,34583,17954,1210,1279
24244,5616,44,33137,17132,2869,2747
24245,1172,37.3,23219,15437,565,607
24246,359,43.8,16385,9305,71,288
24248,2512,48.1,25972,16303,1227,1285
24250,1395,38.1,46929,23113,692,703
24251,8289,45.2,40417,24923,4194,4095
24256,3618,39,28523,16507,1802,1816
24258,1622,48.4,43611,21626,718,904
24260,6103,45.3,30846,16550,2871,3232
24263,6702,39.4,32312,16693,3310,3392
24265,998,46.4,39213,21677,521,477
24266,8526,43.7,37569,24388,4237,4289
24269,716,29.3,25250,10684,333,383
24270,582,50.9,27083,17071,300,282
24271,2559,43.8,36815,20736,1210,1349
24272,455,24.8,23333,19183,264,191
24273,6755,40.5,43781,21850,3034,3721
24277,6289,42.9,29663,15804,3789,2500
24279,5709,39.8,36114,16930,3279,2430
24280,693,49.7,45139,25540,340,353
24281,2691,37.6,22902,15557,1398,1293
24282,587,50.1,24716,14288,301,286
24283,2206,46.3,40026,22048,1043,1163
24290,2469,44.2,37279,20226,1291,1178
24292,548,55.6,30536,18223,280,268
24293,10352,36.3,45880,23720,4949,5403
24301,13653,44.9,37667,22326,6839,6814
24311,1906,46.7,38000,21546,1011,895
24312,2006,45,29778,15962,1073,933
24313,1209,34.5,26741,15598,572,637
24314,1524,42.1,56858,24861,796,728
24315,3926,42.1,37054,14930,2381,1545
24316,26,-666666666,-666666666,,13,13
24317,4335,39.2,30955,15694,2127,2208
24318,792,49.6,47260,26347,400,392
24319,7398,38.8,36520,17581,3496,3902
24322,216,59.2,17470,19838,24,192
24323,584,60.2,30441,18519,222,362
24324,2211,44.5,51051,24793,1135,1076
24325,1052,57,42672,20598,579,473
24326,970,48.8,28300,17224,545,425
24328,1607,47.5,47177,28436,633,974
24330,3722,45.4,25637,16513,1838,1884
24333,17947,45.3,31489,20636,8703,9244
24340,5431,40.5,38735,21257,2729,2702
24343,8815,45,33459,21139,4264,4551
24347,1937,37.1,52587,25406,1073,864
24348,4048,48,38750,25488,2102,1946
24350,898,44.3,26786,15609,504,394
24351,630,45.3,24757,18176,320,310
24352,923,54.5,33182,18544,500,423
24354,15271,44.5,37673,22872,7411,7860
24360,6497,42.4,47132,26520,3375,3122
24361,5206,41.1,35060,19278,2485,2721
24363,1241,49.2,32083,16910,600,641
24366,473,51.6,44917,25636,217,256
24368,4870,39.2,45781,26230,2468,2402
24370,6228,44.5,33340,18073,2985,3243
24374,1012,45.6,40140,15419,423,589
24375,1569,43.9,40030,18047,847,722
24377,245,58.5,52188,22670,144,101
24378,1412,53,32926,17143,588,824
24380,2928,37.2,51854,19768,1668,1260
24381,3522,42.9,32399,20934,1734,1788
24382,13810,46,40052,22877,6750,7060
24401,35256,43.1,45044,26392,16241,19015
24411,112,9,-666666666,,56,56
24412,138,42.6,67212,27571,75,63
24413,142,57.3,56429,31679,82,60
24415,87,50.2,-666666666,12768,21,66
24416,8674,38.2,36364,19467,4034,4640
24421,3439,50.2,53750,34101,1624,1815
24422,6694,46.4,39635,22744,3310,3384
24426,14035,45,43756,23759,6929,7106
24430,4617,39.1,28427,11034,3604,1013
24431,2489,42.7,34939,20746,1211,1278
24432,308,53.1,60221,25184,131,177
24433,99,67.5,37500,17170,41,58
24435,2264,47.5,61679,30958,1086,1178
24437,1159,52.3,96080,36286,619,540
24439,1396,50.4,23056,14716,645,751
24440,2762,44.8,45861,19977,1421,1341
24441,6994,38.1,44232,20668,3308,3686
24442,137,46.4,26875,19495,62,75
24445,2207,45.4,40697,30153,1032,1175
24448,448,40.4,37019,17148,221,227
24450,16649,34.5,48708,22887,9293,7356
24457,230,51.4,28922,15218,117,113
24458,469,58.9,52292,26384,211,258
24459,966,39,63125,28747,525,441
24460,1501,51.7,65093,31483,745,756
24464,263,51.3,46438,23650,124,139
24465,1282,59.5,51806,29229,620,662
24467,2055,42.6,56667,33581,1132,923
24471,1011,54.2,41154,25845,532,479
24472,1673,56.4,53729,28782,905,768
24473,743,56.1,37083,25873,341,402
24474,501,50.4,30566,15957,276,225
24476,258,50.4,36328,26463,139,119
24477,9933,43.4,53440,24613,4877,5056
24479,1234,42.5,51449,26193,746,488
24482,4230,44.5,44784,22368,2196,2034
24483,1047,31.1,46250,13993,556,491
24484,1118,34.8,39211,19763,447,671
24485,287,49.1,56818,23957,150,137
24486,3656,34.7,53750,22136,1788,1868
24487,321,43.3,43036,16551,140,181
24501,26605,29.7,29916,16498,11914,14691
24502,44647,28.2,44340,20517,21545,23102
24503,19111,42.7,66161,39887,9258,9853
24504,10818,35,28300,16162,5226,5592
24517,5535,45.5,36422,23816,2397,3138
24520,1965,48.5,40804,30862,870,1095
24521,10582,45.7,43420,22210,5377,5205
24522,9625,45.1,49466,23985,4436,5189
24523,18761,46.2,42685,23521,8733,10028
24526,1292,48.6,48546,25001,604,688
24527,2924,44,49620,22262,1426,1498
24528,3289,50.5,34835,19739,1623,1666
24529,1320,49.2,34866,21473,645,675
24530,1132,49.1,36786,19053,585,547
24531,9306,44,39863,20697,4714,4592
24534,1537,53.2,28051,18292,702,835
24536,146,57.3,58250,21749,47,99
24538,4729,46.9,55569,27329,2422,2307
24539,61,59.5,32308,23320,43,18
24540,31276,43.8,36513,20249,14455,16821
24541,28901,41.8,32931,21264,13580,15321
24549,4682,39.3,42473,20969,2268,2414
24550,7698,39.9,51980,21418,3961,3737
24551,21793,42,73776,32632,11149,10644
24553,2490,35.2,41285,20101,1307,1183
24554,3637,38.3,43426,20138,1691,1946
24555,2506,41.6,49330,20724,1298,1208
24556,3581,45.3,63629,27023,1842,1739
24557,7341,51.7,32490,21115,3365,3976
24558,6721,42.1,41639,22612,3152,3569
24562,328,49.7,51932,29012,196,132
24563,5335,44.6,40000,20867,2774,2561
24565,1129,46.3,34464,13178,571,558
24566,1546,42.2,40027,17146,773,773
24569,1111,49.2,38396,21403,635,476
24570,0,-666666666,-666666666,-666666666,0,0
24571,2012,44.7,39491,20418,942,1070
24572,15878,42.2,44468,22976,7349,8529
24574,3866,44,47955,23250,1986,1880
24577,4945,45.5,37514,19319,2629,2316
24578,866,48.8,47143,26195,343,523
24579,1266,48.9,39719,21008,503,763
24580,626,36.7,52143,15150,377,249
24581,0,-666666666,-666666666,-666666666,0,0
24586,5949,43.1,43452,21789,2619,3330
24588,8792,45.6,45944,24255,4310,4482
24589,2254,44.3,21646,15935,1281,973
24590,7877,39.1,51840,25723,3618,4259
24592,14529,42.8,32285,20422,6608,7921
24593,2047,31.8,65242,24114,1005,1042
24594,1389,48.3,35305,19986,755,634
24595,717,20.1,66058,7475,29,688
24597,1301,44.4,40368,18306,624,677
24598,1995,52.6,43380,23299,900,1095
24599,394,41.6,32042,20984,193,201
24601,45,54.6,-666666666,10338,7,38
24602,1012,54.5,35598,16503,555,457
24603,1266,52.1,31701,22006,731,535
24604,643,35,22719,10400,210,433
24605,8426,44.6,44083,26368,4131,4295
24606,386,48.5,50923,19524,193,193
24607,452,42.1,20806,10249,244,208
24609,7139,44.7,34947,19498,3300,3839
24612,138,56.8,55357,33782,84,54
24613,405,62,19741,17886,223,182
24614,7570,43.9,33769,19509,3664,3906
24620,3439,32.4,16678,10827,1543,1896
24622,858,47.2,24750,17294,458,400
24628,242,53.2,50170,21214,148,94
24630,7466,38.2,33707,19346,3957,3509
24631,2096,48.9,31354,17630,1261,835
24634,711,48.4,42292,15555,355,356
24635,1121,38.8,26359,12483,750,371
24637,4070,41.5,53320,23270,1958,2112
24639,4027,42.6,27120,14848,2287,1740
24641,5982,42.3,33788,19085,2716,3266
24646,559,45.4,33571,20712,251,308
24649,3123,41.8,24820,15655,1628,1495
24651,6026,47.4,33160,26725,2928,3098
24656,3310,47.9,37341,18712,1659,1651
24657,440,46.7,17868,16935,219,221
24701,20885,43.3,32646,20392,9881,11004
24712,1915,21.9,38043,14363,952,963
24714,87,35.6,18750,17569,37,50
24715,548,50.4,34444,17444,251,297
24716,320,57.4,14531,13450,161,159
24719,503,38.1,52772,13429,292,211
24724,116,35.4,75078,29468,52,64
24726,313,45.9,40132,12799,170,143
24729,127,55.8,23036,14675,69,58
24731,278,36.4,41250,13349,155,123
24733,552,55.6,16951,12853,248,304
24736,846,43.4,34375,16574,382,464
24737,107,49.5,22222,18082,59,48
24738,262,67.3,43036,20794,143,119
24740,31041,41.3,37045,21639,14758,16283
24747,3011,40.7,33682,14186,1422,1589
24801,4449,39,27386,14310,2288,2161
24808,644,35.5,40556,18376,311,333
24811,647,41,16331,12022,373,274
24813,415,44.8,27721,11253,169,246
24815,823,34,25642,12031,423,400
24816,100,61.1,35221,27334,64,36
24817,839,34.1,16750,10881,398,441
24818,1561,34.6,32623,12644,701,860
24822,564,45.8,45893,19957,340,224
24823,541,39.5,27578,18125,254,287
24826,273,45.4,20850,12298,129,144
24827,1591,44.6,43915,17232,745,846
24828,890,45.4,24471,14461,459,431
24830,97,70,33333,23761,47,50
24831,164,56.4,18917,17096,71,93
24834,571,29.1,53679,18665,209,362
24836,544,55.5,20000,15024,237,307
24839,1115,44.1,18906,14082,506,609
24843,140,60.4,20673,14761,77,63
24844,1839,44.1,24128,16287,895,944
24845,280,47.8,46125,26040,152,128
24846,168,54.3,13542,13596,94,74
24847,350,31.7,20662,8088,218,132
24848,166,54.5,9615,14070,98,68
24849,304,41.5,44830,21082,145,159
24850,830,44.1,16875,11099,305,525
24851,308,42.4,26250,19506,162,146
24853,731,53.2,19744,16106,317,414
24854,479,35.4,24597,16003,244,235
24857,739,49.3,27404,23977,365,374
24860,505,60,35833,16137,245,260
24861,390,41.6,14844,9916,207,183
24862,481,52.8,31343,16763,283,198
24866,106,57.2,15865,12147,49,57
24867,323,36.9,91375,23019,152,171
24868,1649,44.2,28781,11730,663,986
24869,286,58.4,30375,19865,136,150
24870,3191,41.6,36702,19221,1587,1604
24871,195,60.6,13750,10791,64,131
24872,825,38.9,17201,14851,518,307
24873,498,59.4,20278,27893,234,264
24874,2275,45.4,34265,21278,1020,1255
24878,500,31,16429,12090,276,224
24879,599,49.1,18472,10415,305,294
24880,442,38.9,48438,15368,308,134
24881,553,41.7,34659,15500,250,303
24882,596,40.5,44167,18975,364,232
24884,314,38.6,55365,19443,137,177
24887,125,14.8,-666666666,4526,71,54
24888,242,51.8,50375,19721,98,144
24892,1544,44.4,17946,12964,827,717
24894,198,41.8,22569,10469,80,118
24898,117,40.8,18681,14194,67,50
24901,8436,44.1,46926,27354,4117,4319
24910,5616,41.5,35000,16905,2324,3292
24915,375,52.8,31477,20978,154,221
24916,699,43.2,46339,20687,360,339
24918,1542,45.7,41525,19989,736,806
24920,399,41.9,19236,15862,172,227
24924,270,47.8,39375,19891,133,137
24925,766,38.2,43529,22498,384,382
24927,220,48.7,16827,11444,125,95
24931,1741,42.5,40691,21829,732,1009
24934,349,51.1,32132,55462,233,116
24935,625,56.2,43667,24432,295,330
24938,1701,38,45774,21435,937,764
24941,1375,49,38857,17729,687,688
24944,397,49.5,59028,31306,170,227
24945,421,52.3,41667,17750,241,180
24946,1745,47.9,32098,16182,1014,731
24951,1395,41.4,34103,16568,621,774
24954,4034,47,34978,19481,1947,2087
24957,170,50.1,33631,26776,72,98
24962,124,50.4,14012,17935,63,61
24963,3537,44.7,46008,23646,1788,1749
24966,1004,54.1,30761,18871,536,468
24970,4950,39.5,31849,18872,2328,2622
24974,280,19.4,34063,9178,187,93
24976,1176,31.8,53036,19308,676,500
24977,450,58.4,44107,22004,230,220
24981,823,57.9,41786,20219,413,410
24983,2756,49.5,45366,22920,1338,1418
24984,259,28.8,33415,17366,101,158
24986,5496,44.8,36438,21941,2608,2888
24991,582,46.8,55430,27895,341,241
25002,123,51.5,52500,26746,83,40
25003,2436,40.3,37264,24291,1224,1212
25005,158,49.2,48523,24921,74,84
25007,559,32.8,39635,16777,250,309
25008,359,27,34620,13016,161,198
25009,1386,43,55000,19628,656,730
25011,977,45.6,41875,29163,636,341
25015,4378,45.2,45402,22631,2128,2250
25019,479,50.1,29545,19291,284,195
25021,344,27.4,40568,19498,165,179
25022,140,36.8,62688,22802,41,99
25024,693,55.3,48897,26070,354,339
25025,170,41.4,41917,25391,71,99
25028,335,52.8,35536,32127,136,199
25030,453,48.8,42813,22338,267,186
25031,1091,30.8,57107,18898,510,581
25033,1851,44.6,37120,21722,918,933
25035,1133,41.8,26359,16878,609,524
25036,1188,41.8,38750,15962,1005,183
25039,1401,31.5,36667,13930,706,695
25040,653,32.8,51477,19551,306,347
25043,1724,41.8,26964,15902,907,817
25044,334,39.2,27826,11315,186,148
25045,5640,43.2,38596,18689,2774,2866
25047,503,25,22071,12064,314,189
25048,22,-666666666,-666666666,,11,11
25049,665,28,53036,17520,440,225
25051,25,45.4,-666666666,13536,9,16
25053,4371,41.6,34973,18423,2101,2270
25054,225,15.7,-666666666,7157,146,79
25057,218,26.5,38929,15897,101,117
25059,626,44.2,49306,20083,284,342
25060,412,56,29361,22542,206,206
25061,349,66.3,35769,22003,160,189
25062,159,63.2,41000,17925,102,57
25063,1567,47.8,24679,17953,713,854
25064,9682,40,41861,24193,4519,5163
25067,1140,44.6,43264,21304,554,586
25070,1981,37.7,44896,24434,1048,933
25071,12297,42.1,50549,25648,5959,6338
25075,588,41.7,37500,23348,317,271
25076,274,40.5,21141,12481,102,172
25081,1170,42.6,72450,39041,589,581
25082,1791,40.9,48068,23364,895,896
25083,596,43.2,57929,17976,241,355
25085,958,47.5,33333,19228,462,496
25086,867,52.2,39844,19339,425,442
25088,98,48.3,53500,24140,36,62
25090,116,66.8,32262,23912,56,60
25093,128,56.1,56111,31791,80,48
25102,348,38.3,34375,19390,190,158
25103,137,56.5,16786,24138,80,57
25106,656,38.7,25721,16975,279,377
25107,390,40.2,16167,14714,164,226
25108,390,52.1,53824,29898,156,234
25109,450,54.7,50500,15612,223,227
25110,555,26.5,41250,18996,233,322
25111,723,43.4,36417,15064,377,346
25112,89,19.4,-666666666,2600,44,45
25113,828,46.2,42031,23202,447,381
25114,796,44.8,32386,18378,357,439
25115,300,33.2,21359,6528,150,150
25118,1265,48,33958,17549,575,690
25119,641,19.6,30750,11600,295,346
25121,899,47.8,62222,24833,425,474
25123,3602,43.7,46302,24104,1815,1787
25124,1350,45.5,40625,23470,600,750
25125,762,47.1,36250,17480,392,370
25126,38,59.5,68214,41800,17,21
25130,3467,45.6,48342,25819,1694,1773
25132,538,30.9,30855,10968,291,247
25133,1201,30.5,54125,14398,562,639
25134,511,48,37000,20314,266,245
25136,2049,30.7,27768,18241,1144,905
25139,248,49.6,39583,31373,122,126
25140,1153,32.7,40370,14644,583,570
25141,211,42.2,37321,13691,129,82
25142,402,44.6,53173,21885,183,219
25143,8393,41.2,47793,25315,3740,4653
25148,118,47.9,46667,22293,49,69
25149,315,34.8,51055,18439,130,185
25152,307,41.4,40405,14387,175,132
25154,805,32.2,32411,19726,400,405
25156,149,53.9,27619,9243,92,57
25159,5487,41,39474,22303,2570,2917
25160,237,33.1,63750,14498,103,134
25161,303,36,27885,13736,134,169
25162,499,45.7,53365,23478,247,252
25164,1183,50.6,19893,14454,523,660
25165,451,41.1,49886,24418,218,233
25168,2425,46.3,41985,18608,1312,1113
25169,618,31.9,33889,14203,259,359
25173,340,51.6,29917,16607,155,185
25174,539,31.6,33681,13762,278,261
25177,24606,43.1,46283,24634,11830,12776
25180,53,51.9,-666666666,16547,21,32
25181,2301,32.9,41200,19595,1085,1216
25183,0,-666666666,-666666666,-666666666,0,0
25185,494,38.8,-666666666,6816,494,0
25186,1083,40.4,26076,16384,436,647
25187,678,52.5,61750,31031,343,335
25193,690,34.9,55948,23001,387,303
25201,27,-666666666,-666666666,,13,14
25202,1164,46.5,53214,19856,551,613
25203,53,51.3,7391,42566,32,21
25204,300,30.1,43947,17734,152,148
25205,234,56.9,31279,26403,121,113
25206,494,48,15288,12794,224,270
25208,1033,36.4,45288,15700,525,508
25209,1001,52.4,25417,19426,477,524
25211,136,26.7,29861,17159,56,80
25213,6009,42.3,55830,25983,3059,2950
25214,748,21.7,72841,19426,406,342
25234,1760,43.6,46522,22448,840,920
25235,802,39,35662,12442,369,433
25239,1711,42.8,33009,19340,866,845
25241,1475,46.9,57669,28646,800,675
25243,583,50.6,33889,24186,297,286
25244,748,46.6,39423,15562,374,374
25245,612,56.5,70561,38178,292,320
25247,645,36.5,30956,16759,378,267
25248,3476,38.8,37391,22498,1803,1673
25251,600,32.5,32639,12574,322,278
25252,1200,39,46292,19310,742,458
25253,2118,38.9,40245,18032,1031,1087
25259,653,40.5,29423,19440,282,371
25260,1708,46.4,38205,26831,820,888
25261,299,56.3,43144,18063,150,149
25262,1193,41.6,61806,26475,681,512
25264,325,41.9,26066,14013,162,163
36753,42,73.3,18625,18064,22,20
36754,403,49.7,28500,14086,182,221
36756,6440,39.6,30815,14730,3036,3404
36758,1661,43.6,33869,19878,856,805
36759,1488,39.2,26907,18308,777,711
36761,960,52.6,21250,15952,428,532
36763,253,38.2,58750,21762,169,84
36765,1400,40.5,19167,13919,500,900
36766,30,42.8,-666666666,26717,6,24
36767,1902,32.7,14683,14498,885,1017
36768,889,47.2,25703,13537,404,485
36769,2731,35.5,25388,13452,1278,1453
36773,1149,31,23625,10356,455,694
36775,710,47.6,20956,12965,409,301
36776,1662,29.8,25313,23672,798,864
36782,3042,36.8,37243,22367,1564,1478
36783,767,44,38750,17028,321,446
36784,7691,42.2,37575,20689,3473,4218
36785,1738,36,36364,30610,824,914
36786,3167,30.5,15625,10126,1502,1665
36790,80,69.2,63611,23869,47,33
36792,1373,30.7,32574,16881,749,624
36793,650,56,34155,17523,487,163
36801,22895,37.8,37451,22589,10970,11925
36804,17898,37.5,44938,22734,8958,8940
36830,34089,28.4,50693,30400,17698,16391
36832,23598,22.5,21387,16049,12160,11438
36849,3204,19.3,-666666666,4641,832,2372
36850,2722,44.2,31282,16505,1420,1302
36852,2082,36.3,42411,30034,1030,1052
36853,8055,49.1,45688,26612,3984,4071
36854,14719,39.9,36465,19691,7269,7450
36855,1582,51.8,39125,19032,755,827
36856,4732,33.7,61215,22667,2476,2256
36858,540,37.4,71563,25395,261,279
36859,38,57.9,-666666666,56511,18,20
36860,1404,46.7,22339,13734,673,731
36861,3038,50.2,40417,23554,1526,1512
36862,6510,43.4,30795,17526,2899,3611
36863,12188,39.5,30786,18808,5735,6453
36865,20,57.5,16250,14080,10,10
36866,3739,38.6,36836,19354,1724,2015
36867,21976,32.9,37202,23440,9816,12160
36869,19025,35.9,32202,17690,9852,9173
36870,18792,31.2,60009,22757,9199,9593
36871,1150,47.4,32321,20272,567,583
36874,8775,38.9,49872,21693,4137,4638
36875,5120,40.3,51490,20547,2297,2823
36877,11523,37.8,46073,23203,5986,5537
36879,2591,39.2,48194,23974,1189,1402
36901,399,47.7,21748,11610,210,189
36904,3973,45.1,38116,21225,1910,2063
36907,2017,44.1,26641,16875,934,1083
36908,2372,44.7,43542,21645,1197,1175
36910,26,-666666666,-666666666,,0,26
36912,1854,43.2,32629,19895,877,977
36913,176,47.6,21591,11485,63,113
36915,481,58.9,53295,25883,223,258
36916,656,40.9,41944,20622,345,311
36919,1994,39.1,24942,16254,911,1083
36921,1337,42.9,28364,21874,655,682
36922,647,40.9,37000,17700,349,298
36925,3605,35.7,20938,14310,1513,2092
37010,5633,38.2,80673,33364,2746,2887
37012,2477,43.5,44643,19577,1340,1137
37013,81944,31.5,47455,23850,38998,42946
37014,2130,44.5,67262,33443,882,1248
37015,17400,40.1,47683,21531,8653,8747
37016,1215,39.6,42917,18184,508,707
37018,1625,44.2,25906,20119,819,806
37019,731,50.3,47639,23371,446,285
37020,5200,36.1,53471,23353,2748,2452
37022,6022,42.5,44878,23229,3010,3012
37023,1486,42.5,37035,25928,803,683
37025,6038,35.6,42528,18765,3289,2749
37026,2134,40.6,32269,28431,970,1164
37027,51034,41.3,114257,55045,25121,25913
37028,775,31.4,41607,16208,354,421
37029,5100,44,70742,34047,2572,2528
37030,7057,39.3,39211,21322,3338,3719
37031,3892,41.8,61447,27317,2028,1864
37032,4496,37.2,49107,24720,2151,2345
37033,8146,44.5,42681,21708,4090,4056
37034,7210,36.5,56791,22983,3398,3812
37035,3386,36.7,55469,21386,1926,1460
37036,5911,37.4,39673,18541,2861,3050
37037,6350,31.6,67014,23495,3157,3193
37040,44301,29.7,44843,20539,22110,22191
37042,68419,27.3,46477,19578,34041,34378
37043,42919,36.2,57443,27303,20816,22103
37046,4345,43.6,59167,25279,2234,2111
37047,2444,40.8,44646,20587,1195,1249
37048,6679,39.5,61092,23991,3268,3411
37049,3088,38.2,55477,24784,1531,1557
37050,1997,38.1,34744,15512,1030,967
37051,3966,41.1,46303,19747,1945,2021
37052,2376,44.2,55577,23585,1178,1198
37055,27780,37.6,42430,20678,13168,14612
37057,1213,37.3,39758,16775,626,587
37058,7512,42.7,39744,22091,3812,3700
37059,1432,35.1,26979,17400,644,788
37060,2382,41.7,55756,25027,1236,1146
37061,5185,41.2,35833,18221,2475,2710
37062,10715,37.3,53829,24990,5006,5709
37064,51393,39.1,73043,35485,25164,26229
37066,43709,38.4,49632,27215,21106,22603
37067,23391,37.6,95155,45675,10817,12574
37069,19583,40.5,110798,50696,9644,9939
37072,29970,42.3,53138,26684,14088,15882
37073,13271,40,53943,27504,6458,6813
37074,7188,36.4,37688,19276,3479,3709
37075,60280,39,63464,32330,29209,31071
37076,37929,33.9,52249,27161,18281,19648
37078,712,36.8,33750,18689,379,333
37079,2051,42.7,51168,23754,949,1102
37080,7962,44.3,61824,25231,4231,3731
37082,6398,41.8,63498,27823,3116,3282
37083,14006,37.9,35574,17387,6660,7346
37085,4309,42.7,67944,31530,2094,2215
37086,32310,31.1,53311,21309,16695,15615
37087,41928,38.5,47594,24679,20618,21310
37090,13231,41.7,58766,27211,6449,6782
37091,20606,40.4,37174,19875,10066,10540
37095,1606,42.6,37250,19381,905,701
37096,5588,40.5,33151,16974,2768,2820
37097,2232,44.8,33393,17760,1158,1074
37098,4587,42.2,33993,17751,2306,2281
37101,6388,41.1,50398,21198,3041,3347
37110,33063,39.1,33762,19452,16467,16596
37115,36959,35.8,37200,20094,17136,19823
37118,1678,33,57786,19687,721,957
37122,48107,38.6,72168,30784,23767,24340
37127,16555,34.1,61051,26327,8080,8475
37128,41108,32.6,63337,27735,19962,21146
37129,50076,36.5,62295,28360,24865,25211
37130,50538,29,36934,22440,25569,24969
37132,2730,19.5,-666666666,3643,1273,1457
37134,2882,39.7,53036,25955,1476,1406
37135,9524,34.8,95580,36802,4389,5135
37137,3182,39,37170,17010,1514,1668
37138,21909,42.4,56504,29948,10833,11076
37140,1329,35,44605,2974,1284,45
37141,1235,34.6,44444,20819,609,626
37142,2079,40.5,63350,24583,967,1112
37143,4032,41.1,58051,23960,2012,2020
37144,3682,43.4,41838,21977,1928,1754
37145,2103,46,42218,18931,1003,1100
37146,7084,36.3,67222,28178,3521,3563
37148,22373,36.6,49359,21321,11350,11023
37149,2331,45.6,53828,24847,1267,1064
37150,4597,47,32109,17144,2408,2189
37151,488,40.2,53393,19643,224,264
37153,5774,36.5,69732,24481,2844,2930
37160,32686,36,37477,18415,16115,16571
37165,50,55.3,14500,14440,24,26
37166,13470,40.4,36382,21864,6764,6706
37167,51973,33.8,56967,25053,24808,27165
37171,556,48.2,43214,22160,248,308
37172,28918,36.1,45964,21225,14109,14809
37174,29070,33.4,68923,26825,13891,15179
37175,1214,44,34338,15257,646,568
37178,2087,44.3,41157,21730,1087,1000
37179,10194,35.7,90156,32285,5081,5113
37180,2967,35.6,40887,19549,1572,1395
37181,1506,48.1,38661,22722,784,722
37183,3338,42,42898,19637,1691,1647
37184,6516,42.9,45524,19493,3199,3317
37185,8575,42.6,38089,22046,4309,4266
37186,9099,38.1,35965,17149,4460,4639
37187,6715,39.4,44607,20258,3383,3332
37188,13877,37.8,63060,25445,6906,6971
37189,3019,42.7,52589,24668,1368,1651
37190,9106,42.4,40549,18866,4332,4774
37191,4226,39.3,63393,28185,2071,2155
37201,2001,31.3,54392,24789,1564,437
37203,11525,29.8,28651,24644,5800,5725
37204,12869,33.2,64267,40886,5721,7148
37205,23812,44.7,80910,70263,11322,12490
37206,24931,33,37369,22759,12068,12863
37207,34306,34.3,31756,17175,16163,18143
37208,16044,31.1,22409,16592,7245,8799
37209,36000,31.3,43625,23808,18197,17803
37210,15071,30,26567,15863,7253,7818
37211,77379,31.7,43251,22300,39356,38023
37212,19490,24,51435,34776,9522,9968
37213,175,41,-666666666,9246,154,21
37214,29675,36.7,49476,26599,14289,15386
37215,21521,44.2,95237,71677,10247,11274
37216,18158,38,44323,23154,9053,9105
37217,28930,32.4,40661,20868,14473,14457
37218,14985,41.2,42225,19097,6998,7987
37219,1151,36.8,52232,49896,690,461
37220,5787,44,99260,54537,2790,2997
37221,39125,39.9,68473,38661,18688,20437
37228,1330,30.3,15286,13347,498,832
37240,626,20,-666666666,14936,336,290
37243,0,-666666666,-666666666,-666666666,0,0
37246,0,-666666666,-666666666,-666666666,0,0
37301,1518,39.9,31488,12721,819,699
37302,3573,44.9,66859,32301,1964,1609
37303,25680,40.3,39384,19656,12200,13480
37305,994,43.1,21513,10708,554,440
37306,3007,31.2,36703,15848,1355,1652
37307,5488,39,39135,19627,2786,2702
37308,2423,40.1,44358,21415,1260,1163
37309,2026,44.4,49457,28385,1059,967
37310,3870,39.9,42800,22540,1707,2163
37311,26285,34.4,28410,16675,12414,13871
37312,33032,40.3,51305,26633,16360,16672
37313,1435,38.5,24735,16473,683,752
37315,1266,20.1,-666666666,4176,536,730
37317,2916,44.2,42612,20400,1477,1439
37318,1672,38.8,26849,17025,779,893
37321,19100,37.1,34046,17667,9252,9848
37322,7184,44,36441,19003,3620,3564
37323,30960,38.3,42840,20679,15346,15614
37324,5264,40.5,37033,20466,2695,2569
37325,1473,44.8,43016,23221,766,707
37326,453,64.7,20250,16581,167,286
37327,11831,40.7,36219,20534,5873,5958
37328,1144,44.1,44514,24537,660,484
37329,6124,45.3,36516,19090,2927,3197
37330,7437,43.5,45285,23135,3608,3829
37331,7580,46.3,35729,20256,3932,3648
37332,2706,45.9,45149,20588,1359,1347
37333,674,45.1,26979,13573,372,302
37334,21350,41.1,41197,22287,10095,11255
37335,2845,40.5,32146,17070,1522,1323
37336,4864,44.4,48066,22370,2438,2426
37337,1067,49.6,29487,17117,621,446
37338,3194,34.4,30365,13675,1529,1665
37339,1725,43.2,28500,15517,804,921
37340,434,59.4,45913,22083,179,255
37341,13571,41.1,56609,27417,6840,6731
37342,3179,37.8,44432,19690,1659,1520
37343,42128,41.8,59644,28820,20678,21450
37345,2155,46,38688,20549,1125,1030
37347,7336,40.9,43097,21508,3729,3607
37348,1390,43.6,38920,18041,637,753
37350,1849,45.4,110208,69821,842,1007
37351,516,38.5,40577,17723,287,229
37352,3408,42.8,43438,19687,1576,1832
37353,4523,43.4,38701,20162,2122,2401
37354,16650,39.9,33655,18275,8024,8626
37355,25681,37.7,40980,19702,12162,13519
37356,2325,43.5,31189,19150,1050,1275
37357,5392,36.6,35036,18369,2825,2567
37359,739,43.8,38750,26106,427,312
37360,1756,41.8,41080,25497,760,996
37361,1492,49.6,38750,24714,681,811
37362,2822,40.5,36523,17605,1451,1371
37363,33075,41.1,66641,31419,16132,16943
37365,1356,43.7,21382,12279,683,673
37366,879,44.9,31382,18446,426,453
37367,9665,43.7,32094,15778,5294,4371
37369,675,58.7,32847,15339,301,374
37370,4871,41.2,43682,18491,2399,2472
37373,2787,49.1,47039,23270,1405,1382
37374,2116,32.8,29398,15842,1080,1036
37375,4317,22.3,65743,19864,2014,2303
37376,447,41.4,18036,14113,262,185
37377,15564,42.3,84493,47522,7565,7999
37379,26423,42.9,54713,27569,13012,13411
37380,6058,45.5,37225,20922,2812,3246
37381,9521,44.5,42913,21973,4885,4636
37385,8170,41.3,39114,18594,4250,3920
37387,3604,44.9,29494,20024,1742,1862
37388,25301,42.2,37041,22714,12596,12705
37391,1093,46,33590,22880,512,581
37394,63,61.2,40795,23849,33,30
37396,315,23.6,47589,12577,125,190
37397,10591,43.7,40658,20138,5298,5293
37398,13589,45.6,43330,24562,6395,7194
37402,3505,44,9954,11815,1895,1610
37403,5774,20.9,37120,14288,2953,2821
37404,11848,37.4,27878,18917,5591,6257
37405,15041,36.2,45035,33461,7354,7687
37406,14396,34.2,27632,13259,6560,7836
37407,9568,28.4,21870,10776,4715,4853
37408,1414,38.8,22375,26687,718,696
37409,2931,36.3,43533,25039,1442,1489
37410,4420,24.7,13575,8836,2028,2392
37411,18507,36.3,36842,21425,8661,9846
37412,21137,38.7,38998,21171,9392,11745
37415,23679,36.3,41596,29693,11555,12124
37416,15242,39.9,41298,23984,6771,8471
37419,6096,48,51843,34393,2756,3340
37421,45902,41.4,54595,31610,22130,23772
37601,37428,39.7,33273,22314,17118,20310
37604,34456,38.5,39298,26540,17088,17368
37614,1860,19.8,-666666666,6693,720,1140
37615,19503,40.7,50740,30352,9700,9803
37616,4939,41.1,37092,23122,2389,2550
37617,14275,44,45996,25551,6978,7297
37618,13562,43.9,38312,21665,6806,6756
37620,38407,44.2,35868,21363,18821,19586
37640,3176,43.7,26085,20182,1707,1469
37641,8194,43.7,38938,19369,3899,4295
37642,13828,43.1,40561,22236,6566,7262
37643,34390,43.5,31543,19318,16749,17641
37645,5224,43.4,51863,22661,2427,2797
37650,12334,45.7,29272,19019,5946,6388
37656,4125,45,45896,24189,1880,2245
37657,1009,52.7,26328,20966,513,496
37658,4136,45.1,28247,16644,1984,2152
37659,27349,40.5,47647,26447,13792,13557
37660,39777,44.2,34323,22824,18472,21305
37663,14808,43.6,55000,30461,7437,7371
37664,26106,45,47199,26451,12636,13470
37665,5698,38,26612,15601,2519,3179
37680,594,51.2,45417,25578,216,378
37681,5660,45.1,34764,18459,2967,2693
37682,616,19.9,-666666666,3878,220,396
37683,13740,43.5,28766,15171,7520,6220
37686,7498,42.9,47294,29870,3622,3876
37687,5007,40.8,30743,16381,2635,2372
37688,979,50.5,31583,17301,495,484
37690,3914,43.1,43667,20932,1869,2045
37691,642,39.8,41413,18466,348,294
37692,4968,40.2,42122,22953,2491,2477
37694,1902,40,35625,17127,1093,809
37701,7232,41.5,40587,21960,3388,3844
37705,4247,42.1,40443,20263,2116,2131
37708,6327,44.1,30905,18539,3171,3156
37709,3842,41.6,39362,20240,1978,1864
37710,948,48.8,34167,15782,523,425
37711,5087,42.5,34384,17540,2512,2575
37713,1216,47.3,31094,17906,665,551
37714,4619,45.1,33022,18709,2028,2591
37715,635,45.7,19125,13429,316,319
37716,25516,43.6,42047,22018,12532,12984
37719,115,61.9,53594,38980,58,57
37721,12740,41.1,51122,22946,6254,6486
37722,6946,40.8,35030,15582,3534,3412
37723,935,45.8,39167,20909,490,445
37724,2484,43.8,26341,16607,1210,1274
37725,16333,44.4,39434,20912,8395,7938
37726,1381,52.9,27391,19426,670,711
37727,2101,49.8,29779,20369,1141,960
37729,1656,32.7,33931,14332,806,850
37730,43,64.7,11630,11893,27,16
37731,884,45.6,27717,14008,417,467
37732,57,29,33083,25707,39,18
37733,20,70.2,-666666666,30255,14,6
37737,5464,45.7,54405,29839,2833,2631
37738,5356,53.8,40117,26893,2372,2984
37742,6111,42,49976,24348,3139,2972
37743,26696,44.8,34855,19552,12939,13757
37745,17755,41,33789,19925,9060,8695
37748,18215,42.9,40899,20268,8882,9333
37752,6316,42.7,42600,22052,3228,3088
37753,960,33.6,38875,16551,482,478
37754,4823,45,48429,19497,2573,2250
37755,3228,34.8,28036,13219,1619,1609
37756,3249,41,24769,13675,1631,1618
37757,9117,42.2,37331,19474,4455,4662
37760,13572,38,40647,19910,6598,6974
37762,2833,45.9,25256,16218,1241,1592
37763,15733,45.7,50335,26808,8018,7715
37764,9241,41.1,46102,22642,4479,4762
37765,411,47.5,32760,15733,216,195
37766,18880,41.3,29266,15598,9397,9483
37769,6231,38.7,31775,16655,3129,3102
37770,2889,42.5,34076,19248,1558,1331
37771,15750,36.8,39931,20119,7637,8113
37772,10599,48,61975,36727,5135,5464
37774,19097,53.7,52611,27445,9318,9779
37777,11051,40.2,43220,27407,5160,5891
37779,4726,38.6,37237,18152,2273,2453
37801,25500,39.3,43269,22065,12512,12988
37803,31576,44.3,49748,25539,15360,16216
37804,24513,39.4,48295,22499,11486,13027
37806,2657,43.8,33808,18137,1189,1468
37807,9388,40,32756,16097,4721,4667
37809,2337,41,34724,22264,1101,1236
37810,2024,39.3,36458,19116,972,1052
37811,3605,45.4,32917,19265,1726,1879
37813,18252,36.9,35513,18707,8844,9408
37814,33030,39.6,40811,22857,16102,16928
37818,4955,43.6,36203,17900,2456,2499
37819,613,48.5,30843,19967,311,302
37820,7430,41.1,42321,23032,3474,3956
37821,22086,42.3,27632,17376,10479,11607
37825,8543,41.1,31951,20079,4328,4215
37826,4607,39.5,38214,19967,2231,2376
37828,1708,51.8,60446,35460,748,960
37829,2254,38.1,43200,18750,1035,1219
37830,29828,42.1,54663,32238,14339,15489
37840,10131,42.7,35884,20799,4575,5556
37841,9873,37.3,30789,20414,4682,5191
37843,3740,45.3,40305,19165,1814,1926
37845,502,54.8,31806,18446,259,243
37846,6103,37.6,30440,13675,3138,2965
37847,2549,38.3,26304,12008,1131,1418
37848,259,64.2,30417,19709,150,109
37849,25799,37.9,53762,24052,12874,12925
37851,6,-666666666,-666666666,,0,6
37852,2539,39.1,27140,17361,1337,1202
37853,3857,42.7,36275,23025,2017,1840
37854,12106,46,33857,20652,5529,6577
37857,21312,42.1,32328,19386,10440,10872
37860,4487,39.6,47583,20125,2256,2231
37861,8344,42.9,33448,17906,4110,4234
37862,21953,39.1,35895,20191,10981,10972
37863,6635,45.2,34280,21332,3194,3441
37865,20719,43.4,53671,25797,10525,10194
37866,1627,48.7,45163,24225,786,841
37869,4979,44.1,20855,13941,2424,2555
37870,4513,45.8,33433,18250,2223,2290
37871,8777,39.2,46565,20188,4162,4615
37872,1730,46.4,36250,19900,878,852
37873,4599,37.6,34256,17497,2485,2114
37874,13509,43.5,39303,20329,6753,6756
37876,29550,38.9,46399,21151,14367,15183
37877,7965,43.5,42750,21809,3836,4129
37878,645,38.7,38559,15088,283,362
37879,11162,39.9,33099,16066,5278,5884
37880,4025,50.8,36946,22566,2060,1965
37881,2239,41.9,24032,14956,1201,1038
37882,2854,54.5,38797,22571,1367,1487
37885,4787,50.6,42878,28517,2320,2467
37886,4658,40.4,44618,21421,2104,2554
37887,7731,38.4,36027,13202,5111,2620
37888,2828,40.8,31190,15159,1300,1528
37890,6687,41.7,38045,20307,3360,3327
37891,3165,42.3,31152,19247,1531,1634
37892,1967,43.1,26474,14525,1077,890
37902,1810,31.1,29938,30518,953,857
37909,15966,31,42158,28455,7427,8539
37912,18856,41,34080,24579,9308,9548
37914,21082,39.4,35843,19839,10018,11064
37915,6325,26.9,10422,12060,2951,3374
37916,12677,20.8,9106,7022,6578,6099
37917,24267,43,30335,20688,11492,12775
37918,44863,36,46944,23509,21548,23315
37919,29037,37.4,51390,41466,13684,15353
37920,37540,39.6,36942,24156,18206,19334
37921,28464,34.9,39157,21851,13461,15003
37922,34186,38.1,97197,44907,16679,17507
37923,27624,37,53893,30167,14604,13020
37924,10891,45.3,46379,24499,5539,5352
37931,25848,37.4,61017,32045,12521,13327
37932,14453,37.8,80405,35771,7056,7397
37934,24835,41.9,92838,40787,11666,13169
37938,17695,39.3,66622,28037,8760,8935
38001,4508,43.6,28068,17881,2128,2380
38002,39470,36.1,90327,34421,19562,19908
38004,10406,36,80404,28969,5059,5347
38006,5651,38.4,43925,18933,2801,2850
38007,58,38.6,33750,12966,27,31
38008,9431,41.2,29201,16256,4579,4852
38011,9721,35.9,53803,23428,4686,5035
38012,14135,41.3,33525,19029,6604,7531
38015,2740,38.5,38750,18771,1333,1407
38016,42103,35.8,66845,33436,19312,22791
38017,48641,39,99256,39882,23157,25484
38018,35504,35.3,66518,33016,17525,17979
38019,15860,40.8,36192,19611,7886,7974
38021,191,48.1,41757,18852,80,111
38023,6572,36,61125,22207,3317,3255
38024,27815,40.1,37981,21965,13374,14441
38028,6865,48,91209,43998,3447,3418
38029,0,-666666666,-666666666,-666666666,0,0
38030,853,34.2,41071,13969,406,447
38034,2854,41.3,35735,17927,1390,1464
38036,596,36.1,13438,11509,227,369
38037,2159,35.7,31957,14622,1079,1080
38039,1591,33.4,30466,12147,790,801
38040,5337,34.8,38472,18037,2553,2784
38041,5014,36.8,30819,10082,3832,1182
38042,955,49,28625,17019,436,519
38044,594,52,29000,22417,227,367
38046,37,60.8,78750,44308,18,19
38047,40,59.3,-666666666,22050,29,11
38049,4572,36.2,32386,24972,2459,2113
38050,447,41.7,26346,13181,231,216
38052,4139,39.1,37846,17620,2053,2086
38053,28228,38,51513,24258,13832,14396
38054,263,23.7,123889,36348,188,75
38057,3568,39.7,45200,22978,1745,1823
38058,8817,39.6,60524,25244,4371,4446
38059,7587,37.7,41643,19454,3967,3620
38060,9979,37,60656,30666,5212,4767
38061,765,52.2,26200,17126,416,349
38063,16844,38.1,30995,17023,7852,8992
38066,2758,47.2,60409,26665,1286,1472
38067,1355,42.5,33472,17235,632,723
38068,10284,42.9,46571,23150,4943,5341
38069,2340,36.4,31250,16882,1127,1213
38070,103,55.4,17167,11328,44,59
38075,7022,36.1,26639,10686,5053,1969
38076,1066,47.3,50083,29058,465,601
38077,93,55.9,-666666666,21075,32,61
38079,5242,39.8,26414,10182,3783,1459
38080,2772,39.2,27649,15349,1253,1519
38103,12630,31.8,56388,44441,7408,5222
38104,23261,37.1,36398,33485,11695,11566
38105,6720,32.9,17348,12687,3579,3141
38106,25072,38.1,22374,12964,11461,13611
38107,16504,40.4,27151,17348,8088,8416
38108,18788,34.1,22497,10988,9383,9405
38109,48169,36.3,31067,14619,22209,25960
38111,43725,31.7,35558,23582,20430,23295
38112,17033,34.5,30418,20471,8388,8645
38114,28215,38.8,24019,12986,12757,15458
38115,41712,27.3,29230,16078,18832,22880
38116,42016,31.1,37714,16831,18456,23560
38117,26504,42.1,62580,41667,11743,14761
38118,42639,28,31979,13660,20397,22242
38119,22809,38.9,58276,37150,11131,11678
38120,14617,40.8,83396,61724,7052,7565
38122,24353,35.1,34735,17918,12646,11707
38125,37766,34.4,65465,27812,17376,20390
38126,6781,24.3,14889,7472,2638,4143
38127,45074,28.3,25592,12414,20923,24151
38128,43552,31.1,35053,16111,20862,22690
38131,0,-666666666,-666666666,-666666666,0,0
38132,0,-666666666,-666666666,-666666666,0,0
38133,20372,36,63184,28737,10195,10177
38134,43261,33.3,47529,21959,21874,21387
38135,28852,39,77880,32469,13838,15014
38138,23457,47.9,97649,49151,11236,12221
38139,16762,42.7,131948,55567,8556,8206
38141,22454,32.3,51228,20627,10689,11765
38152,818,19.8,-666666666,2691,157,661
38201,10142,38.2,35457,19052,5032,5110
38220,1813,48.3,36979,18797,902,911
38221,3297,48,28060,17026,1515,1782
38222,2675,48,44359,23882,1215,1460
38224,1044,39.2,36932,19238,576,468
38225,6525,40.4,37099,20228,3238,3287
38226,117,59.1,17000,21352,78,39
38229,2948,43.5,36800,19886,1462,1486
38230,3554,40.4,34146,19893,1623,1931
38231,2127,32.8,41771,17388,1009,1118
38232,1850,47.7,35100,18902,956,894
38233,2688,45.2,39507,18236,1289,1399
38235,220,38.8,42857,21063,97,123
38236,630,46.1,33800,25031,343,287
38237,16278,29.4,34190,19587,8030,8248
38240,2273,44.8,39709,21406,1132,1141
38241,935,48.2,30139,18874,497,438
38242,19903,42.5,32761,20975,9514,10389
38251,2791,45.1,43636,29695,1419,1372
38253,1332,42.6,48661,24028,699,633
38254,53,52.3,30938,8328,33,20
38255,2409,42.1,37069,18406,1128,1281
38256,2852,55.7,42238,25856,1463,1389
38257,4358,47,40548,20954,2103,2255
38258,1424,42.8,31369,16854,663,761
38259,875,46.1,41389,22519,437,438
38260,3528,41.7,44226,20770,1807,1721
38261,16963,39.4,40007,21377,7820,9143
38301,36403,34.5,29156,15755,17348,19055
38305,50335,37.3,52233,28432,23720,26615
38310,6151,43.6,32075,18950,2986,3165
38311,1007,35.4,52386,36916,545,462
38313,3234,42.2,42634,20796,1787,1447
38315,3737,42.8,35192,17702,1766,1971
38316,3486,38.8,45680,23434,1793,1693
38317,2801,40.6,32946,17593,1300,1501
38318,345,60.1,13295,14266,166,179
38320,10489,44.8,35322,19296,5253,5236
38321,2391,44.1,38205,21536,1124,1267
38326,2466,48.1,41875,28663,1220,1246
38327,409,50.2,30132,18757,224,185
38328,829,32.2,53906,21499,387,442
38329,3432,43.9,35237,24020,1699,1733
38330,4383,38.3,41972,19225,2114,2269
38332,1495,44.6,44797,19442,676,819
38333,551,51.4,26486,17826,290,261
38334,1701,48.8,42500,20067,816,885
38337,1354,42.1,41528,21126,647,707
38339,574,40.5,44500,21109,296,278
38340,13740,33.5,42056,17814,6334,7406
38341,2293,49.6,29762,17276,1163,1130
38342,1288,43.6,33242,18589,658,630
38343,15792,44.7,36971,21750,7027,8765
38344,8576,44.8,32979,17275,3984,4592
38345,2093,39,43024,22567,1139,954
38347,122,42.9,15882,21484,82,40
38348,1306,39.8,52591,23202,609,697
38351,18350,38.8,38923,20443,8906,9444
38352,457,35.8,29583,12643,228,229
38355,5803,31.7,69457,27378,2972,2831
38356,2325,41.7,44797,23065,1180,1145
38357,2983,43.8,28906,14642,1568,1415
38358,11372,39.6,35947,19823,5148,6224
38359,331,60.5,25978,17127,151,180
38361,922,40.4,31250,35196,507,415
38362,1068,30.3,41019,17570,383,685
38363,5485,45.9,36023,22834,2568,2917
38365,0,-666666666,-666666666,-666666666,0,0
38366,2002,43.1,46771,28507,908,1094
38367,2694,40.3,35594,22182,1319,1375
38368,1432,51.3,26563,19173,637,795
38369,1934,39.4,34183,20768,938,996
38370,554,59.7,19926,15062,312,242
38371,1212,50.3,39091,20701,629,583
38372,17391,42.3,33533,19030,8245,9146
38374,1839,48.7,37415,30591,868,971
38375,9598,40,31980,16636,4715,4883
38376,183,48.1,16200,11771,94,89
38379,1225,44.2,40078,32568,674,551
38380,885,34.8,39946,17593,450,435
38381,1485,44.5,34476,20837,825,660
38382,9273,39.9,32493,17135,4537,4736
38387,409,41.9,44773,21171,174,235
38388,1582,43.5,34779,19219,746,836
38390,965,43.1,34583,17462,498,467
38391,1273,44.2,39082,18111,613,660
38392,557,43.7,50595,23031,278,279
38401,54353,38.7,41665,22466,26180,28173
38425,3612,37.9,31077,16150,2810,802
38449,2784,46.2,38807,18988,1341,1443
38450,2669,42.4,32077,17033,1362,1307
38451,4899,39.2,53564,23995,2386,2513
38452,1030,45.5,29844,17075,512,518
38453,378,60.1,58571,29049,218,160
38454,1223,46.6,41289,19363,556,667
38455,110,54.5,21471,16638,59,51
38456,4553,30.8,37530,13690,2205,2348
38457,752,34.6,47708,20232,377,375
38459,577,37.3,62083,30090,275,302
38460,1344,42.4,42768,24445,700,644
38461,1408,45,38683,17324,763,645
38462,10248,41.3,33903,17688,5102,5146
38463,2872,37,41071,18499,1388,1484
38464,22171,41.9,36276,20587,10651,11520
38468,5079,43.5,45617,19853,2665,2414
38469,3765,44.4,34960,18081,1873,1892
38471,591,43.7,33409,12924,295,296
38472,2679,47,47356,23250,1221,1458
38473,982,41.4,31875,14881,477,505
38474,8263,40.4,41019,18495,4009,4254
38475,915,22.8,33125,15286,444,471
38476,945,46.5,61429,29112,467,478
38477,2825,46.3,44952,22353,1441,1384
38478,18120,40,35737,19212,8802,9318
38481,983,44.7,34569,18124,478,505
38482,1445,40.3,32813,23854,739,706
38483,5757,39.1,42150,17610,2825,2932
38485,6752,46.9,32641,18855,3271,3481
38486,841,43.4,30000,15140,444,397
38487,762,41.6,38125,18884,408,354
38488,2364,42.7,55919,25099,1204,1160
38501,37675,33.2,28770,18101,18330,19345
38504,1167,38.6,46786,19634,657,510
38505,1753,19.4,-666666666,324,993,760
38506,26380,41.9,44897,25872,13295,13085
38541,1502,48.1,35637,22693,774,728
38542,26,49.4,-666666666,16746,8,18
38543,521,48.5,31000,17669,284,237
38544,6943,40.4,30925,17009,3418,3525
38545,1207,43.9,36492,15630,605,602
38547,1676,40.6,50306,22010,790,886
38548,597,33.2,34063,19208,323,274
38549,3888,47.2,33828,19737,1915,1973
38551,3843,47,25554,15913,1899,1944
38552,483,43.4,56750,23075,287,196
38553,2549,42.2,37277,15132,1271,1278
38554,899,59.7,26058,13065,439,460
38555,19274,44.2,35403,20815,8874,10400
38556,12098,43.1,27801,16066,5846,6252
38558,7501,68.9,49984,32254,3630,3871
38559,1532,33.1,37825,14924,791,741
38560,1325,40.8,41627,19579,720,605
38562,6621,43.6,32871,19971,3335,3286
38563,2415,39.6,45278,21428,1206,1209
38564,340,59.8,33269,19452,196,144
38565,1158,36.1,33060,18302,594,564
38567,890,42.5,53591,22895,388,502
38568,2504,41.4,34464,16066,1241,1263
38569,328,42.5,34830,31573,170,158
38570,9626,41.7,36204,19644,4622,5004
38571,13448,44.5,34838,18387,6666,6782
38572,10923,44.9,36175,18462,5623,5300
38573,2269,40.2,37414,20600,1080,1189
38574,8245,46.2,29782,16885,3919,4326
38575,1248,36.9,48113,20748,597,651
38577,802,54.5,45625,24113,410,392
38578,134,79.1,18438,24923,33,101
38579,941,46.6,28000,12351,449,492
38580,1637,40.5,43512,20331,785,852
38581,4300,39.5,39476,19238,2003,2297
38582,1439,47.4,44028,31581,747,692
38583,24159,42.4,34487,18308,11779,12380
38585,3786,40.1,31317,18415,1889,1897
38587,1085,48.6,37361,28530,547,538
38588,963,44.5,31071,14478,490,473
38589,249,34.4,16118,11019,115,134
38601,3200,36.9,61875,23486,1747,1453
38603,3035,47.5,34583,23958,1370,1665
38606,15628,34.7,40282,20615,7110,8518
38610,3664,38.8,47907,17431,1790,1874
38611,15868,39.4,37892,19766,8045,7823
38614,19865,32.6,26958,16269,9118,10747
38617,841,37.2,23846,12245,416,425
38618,11716,40.1,38616,19815,5844,5872
38619,5732,40.3,30398,16176,3144,2588
38620,3999,39.6,37708,16771,1768,2231
38621,1875,32.3,19561,9144,835,1040
38622,584,38.3,16106,13501,304,280
38623,279,38.5,14766,11898,127,152
38625,910,39.4,29298,16926,490,420
38626,1105,49,32371,25565,587,518
38627,1035,36.5,60313,22887,538,497
38629,2370,38,27153,15038,1092,1278
38630,218,40.6,25469,11697,139,79
38631,913,36.3,20000,12102,425,488
38632,25340,38.6,64018,28050,12549,12791
38633,2717,37.5,30547,13195,1325,1392
38635,16895,37.3,33912,16831,8156,8739
38637,26350,31.2,46322,17928,12675,13675
38639,1230,26.4,19091,9535,524,706
38641,2890,39.3,68333,24456,1259,1631
38642,2182,35.9,36111,13938,982,1200
38643,2331,33.9,18466,11060,1004,1327
38644,286,26,26458,12424,158,128
38645,1777,35.1,26838,12995,751,1026
38646,3307,41.2,27585,16844,1659,1648
38647,1420,35.1,16157,18109,799,621
38650,3879,37.8,35625,17974,1785,2094
38651,7251,40.7,65861,27064,3680,3571
38652,15959,38.2,39984,20690,7696,8263
38654,47182,37.9,68998,28518,23213,23969
38655,37188,29.7,43929,24104,18180,19008
38658,1696,44.9,30523,19704,906,790
38659,2511,32.5,33726,15872,1180,1331
38661,1919,46.7,42853,21790,1015,904
38663,11896,36.3,35107,19295,5779,6117
38664,3506,28.4,33378,15959,1682,1824
38665,2629,29.7,42731,15920,976,1653
38666,6794,36.7,29316,15863,3546,3248
38668,14728,34.4,42380,21344,7465,7263
38670,1130,33.9,27578,12183,549,581
38671,35476,33,50335,22463,16711,18765
38672,12196,36.8,91218,31039,5786,6410
38673,670,30.2,30000,9897,235,435
38674,1002,50.8,20827,17496,528,474
38676,6285,35.2,28816,15098,2989,3296
38677,4541,19.3,-666666666,2551,2136,2405
38680,5481,32.9,55469,21743,2899,2582
38683,5250,38.4,27515,17189,2409,2841
38685,891,47.1,27102,18200,324,567
38701,23774,38,28645,18286,11196,12578
38702,0,-666666666,-666666666,-666666666,0,0
38703,13799,32.5,26767,14242,6085,7714
38704,6,-666666666,-666666666,,3,3
38720,678,35.9,38000,15116,308,370
38721,1129,34.6,55536,15963,574,555
38722,482,40.8,24861,16248,259,223
38723,5,-666666666,-666666666,,0,5
38725,817,40.1,24583,15727,359,458
38726,374,35.6,30000,12752,170,204
38730,1802,30.9,36607,18518,871,931
38731,171,33.5,-666666666,12296,73,98
38732,17853,33.4,33161,18127,8341,9512
38736,450,35.5,27500,12851,204,246
38737,3876,30.5,25857,9547,2490,1386
38738,2874,36.8,34213,2724,2830,44
38740,390,42,30750,14987,201,189
38744,813,39.5,36917,22406,367,446
38745,129,46.8,18750,9929,78,51
38746,604,36.4,25833,12041,306,298
38748,4193,33.4,28003,13987,2093,2100
38749,16,-666666666,-666666666,,7,9
38751,11508,33.9,26483,16098,5004,6504
38753,1255,42.2,29833,17663,541,714
38754,1812,32.8,22689,9162,901,911
38756,6679,37.6,30185,18079,3268,3411
38759,1146,37.9,41014,25465,538,608
38760,1005,31,23462,10149,410,595
38761,2526,27.6,19885,9404,1202,1324
38762,2494,28.9,28077,13099,1104,1390
38764,321,49.4,27063,18894,191,130
38765,84,5.7,-666666666,,27,57
38767,96,47.6,-666666666,19350,58,38
38768,158,40.1,48750,14872,82,76
38769,2413,34.9,18671,15097,1116,1297
38771,3165,34,25265,12553,1443,1722
38772,208,40.7,27333,20591,102,106
38773,3744,38.5,22340,11990,1950,1794
38774,2409,37.3,18750,11510,1062,1347
38778,1669,33.4,22188,11473,727,942
38781,219,47.8,9420,7869,91,128
38801,29730,34.4,39516,21717,13672,16058
38804,17754,38.7,43935,23542,8545,9209
38821,12346,41,35350,18794,5729,6617
38824,8278,43,32344,19219,3857,4421
38826,4730,41.6,40135,24973,2552,2178
38827,2730,31.3,33479,16104,1317,1413
38828,4838,32.8,31773,16880,2558,2280
38829,18131,38.5,33953,16607,9030,9101
38833,2983,43,28741,14890,1362,1621
38834,29944,39.5,34267,19803,14888,15056
38838,1401,45.1,32679,16047,699,702
38841,2690,31.7,37651,17694,1351,1339
38843,11607,38.9,40100,18630,5693,5914
38844,153,58.9,36071,20537,68,85
38846,2223,45.1,32500,17935,1187,1036
38847,3158,41.9,34297,17256,1513,1645
38848,947,27.5,48882,16298,493,454
38849,5635,37.3,41755,18882,2775,2860
38850,2910,39.9,29821,16920,1506,1404
38851,8407,37.6,32692,18475,3971,4436
38852,9166,45.7,35196,20648,4410,4756
38855,4876,33.8,33403,16725,2269,2607
38856,1841,41.5,38500,20711,1031,810
38857,3490,32.6,40329,21418,1757,1733
38858,7392,39.1,38586,18655,3750,3642
38859,614,32.5,31750,16307,333,281
38860,5585,43.2,26235,14187,2547,3038
38862,2265,41.5,32537,18957,1152,1113
38863,20306,35.9,41305,18576,9764,10542
38864,1823,29.9,40532,14446,950,873
38865,4211,43.9,27192,16749,1897,2314
38866,12534,34.7,55403,22162,5914,6620
38868,5133,35,38963,17181,2486,2647
38869,390,28.4,37656,13988,171,219
38870,2559,40.8,53443,22094,1330,1229
38871,1998,35.1,43750,20717,1014,984
38873,2582,45.5,37542,17479,1256,1326
38876,1619,43.9,35543,16336,698,921
38878,2919,34.7,28576,14721,1460,1459
38879,526,31.5,20868,10358,331,195
38901,18306,40,34811,21941,8456,9850
38913,430,37.5,73750,27370,234,196
38914,447,38.3,36875,16121,246,201
38915,3994,40.3,32782,18109,1878,2116
38916,4809,43.6,25828,16577,2209,2600
38917,2695,50.4,32245,20765,1319,1376
38920,679,55.5,27083,20087,335,344
38921,4831,34.1,28074,13020,2011,2820
38922,3493,45.6,29665,17205,1903,1590
38923,1772,32.2,23462,9650,1040,732
38924,604,37.6,14375,11201,257,347
38925,2492,37.5,30000,14555,1250,1242
38927,1068,41.5,40972,17224,563,505
38928,347,20.3,28750,6632,154,193
38929,1365,44.8,23288,19381,633,732
38930,26085,34.8,26552,15473,12483,13602
38940,1589,47.1,38333,22137,801,788
38941,4638,26.6,24103,11230,2323,2315
38943,407,34.5,42955,21312,233,174
38944,537,38.1,23750,11659,285,252
38945,14,-666666666,-666666666,,14,0
38946,341,24.9,21500,8716,116,225
38947,653,39.5,16392,9427,186,467
38948,1782,50.5,29279,19867,767,1015
38949,78,66.2,18676,11541,32,46
38950,265,35.2,33917,16489,94,171
38951,1572,40.3,28357,13852,752,820
38952,662,29.8,35000,13305,341,321
38953,1030,29.8,61627,22571,597,433
38954,1115,33.8,16470,10841,537,578
38957,615,34.5,21935,13541,295,320
38958,29,-666666666,-666666666,,17,12
38961,720,39.2,29338,15933,330,390
38962,77,67.6,14405,23796,22,55
38963,5414,32.2,29940,9103,4101,1313
38964,270,45.4,80000,23919,106,164
38965,9024,39.9,37073,18794,4391,4633
38966,792,43.2,28125,13506,243,549
38967,7550,38.6,31793,16079,3341,4209
39038,6518,32.4,22744,13121,3014,3504
39039,1838,49.1,30903,21730,984,854
39040,3785,35.4,32813,17737,1921,1864
39041,4003,42.1,35547,20906,1831,2172
39042,33776,39.1,61696,29565,15833,17943
39044,4101,40,63190,20698,1964,2137
39045,1369,29.3,27069,10291,548,821
39046,26746,33.3,37586,19705,12581,14165
39047,38370,35.4,74353,32691,17959,20411
39051,16682,34.4,31922,16886,8191,8491
39054,519,29.2,56165,16419,254,265
39056,25996,35.9,59988,27183,12312,13684
39057,2005,31.6,31486,12860,949,1056
39059,11623,39.6,37068,17908,5856,5767
39061,271,15.7,-666666666,6735,28,243
39062,439,41.4,36806,19338,203,236
39063,3477,30.7,24348,12446,1660,1817
39066,4761,40.3,38234,19337,2449,2312
39067,1486,43.2,29330,16672,804,682
39069,6417,37.6,23207,10752,3199,3218
39071,5218,41.4,39974,27641,2509,2709
39073,20122,37.6,48713,22845,10305,9817
39074,14712,33,33665,16480,7349,7363
39078,909,45.5,22379,17429,408,501
39079,2199,21.9,21776,10556,1016,1183
39082,1282,32.1,28482,11120,748,534
39083,10552,38.1,30000,18088,4947,5605
39086,2435,27.1,31842,12211,1109,1326
39088,192,50.1,47171,18348,148,44
39090,13919,38.1,33874,18641,6206,7713
39092,3262,40.2,35000,19027,1707,1555
39094,3982,40.5,31284,14869,1888,2094
39095,7562,36.7,25864,13520,3671,3891
39096,1373,30.4,26818,12105,759,614
39097,495,58,26838,17399,236,259
39108,1844,44.3,31538,17219,911,933
39110,38083,39.2,97322,43278,19012,19071
39111,9270,35.8,35680,20912,4584,4686
39113,656,32.5,14091,8066,461,195
39114,10151,39.5,39688,20029,4673,5478
39115,51,39.8,9830,8137,19,32
39116,2587,37.2,35221,21243,1371,1216
39117,10035,39,39930,17527,4724,5311
39119,5990,35,28482,15595,2821,3169
39120,32501,39.8,27476,17592,16209,16292
39140,2078,40.7,39891,20716,880,1198
39144,1071,32.9,19583,9269,543,528
39145,5220,46.7,41800,23984,2628,2592
39146,2317,43.9,23850,13933,968,1349
39149,1459,39.9,29934,15731,802,657
39150,5485,36.5,24875,13350,2376,3109
39152,1218,34.8,24787,12258,629,589
39153,3822,41.3,38311,20233,1754,2068
39154,10381,37.8,55625,23605,5340,5041
39156,318,35.3,57625,21772,176,142
39157,24663,34.5,52146,35710,11578,13085
39159,3128,46.9,27852,16824,1368,1760
39160,2821,42,20924,15419,1643,1178
39162,78,56.6,23750,26988,22,56
39166,505,39.1,37708,15385,259,246
39167,0,-666666666,-666666666,-666666666,0,0
39168,6921,36.8,36234,17368,3218,3703
39169,3097,31.4,15909,9253,1428,1669
39170,9417,43.9,60023,27596,4508,4909
39174,622,20,9375,2547,215,407
39175,4342,40.1,28995,19192,2304,2038
39176,2045,41.5,25845,13376,1067,978
39177,59,60.7,49063,29042,33,26
39179,711,50.6,21607,23689,335,376
39180,33827,37.1,40661,21209,16261,17566
39183,14244,39.6,41659,25112,6661,7583
39189,4737,28,38550,19561,2807,1930
39191,7242,37.5,42366,21499,3391,3851
39192,1334,50.6,21766,17034,515,819
39193,1092,44.1,-666666666,6724,900,192
39194,21466,34.3,24798,12759,12040,9426
39201,467,31.3,55179,31449,344,123
39202,9028,29.1,32411,22179,4263,4765
39203,6666,30.4,20029,9791,3137,3529
39204,19557,27.7,25565,11932,9046,10511
39206,24890,33.3,34923,19262,11426,13464
39208,29894,34.5,44150,20206,14539,15355
39209,28998,31.4,25885,13351,13468,15530
39211,24742,36.3,56453,36963,11300,13442
39212,34092,29.3,37678,16809,15195,18897
39213,22472,38.3,23255,13143,11008,11464
39216,2952,47.4,48250,36283,1486,1466
39217,756,20.2,-666666666,1907,250,506
39218,7240,31.7,43769,21606,3381,3859
39232,7129,30.6,51750,32534,3332,3797
39269,0,-666666666,-666666666,-666666666,0,0
39272,13402,31.6,56382,22542,6241,7161
39301,26616,35.8,30821,18782,12010,14606
39305,20578,40.3,49664,30622,9649,10929
39307,18484,35,28216,14093,9580,8904
39309,590,21.8,-666666666,16209,486,104
39320,2226,40.9,58750,24143,1078,1148
39322,1670,47,31667,21946,812,858
39323,1103,34.8,42384,19801,548,555
39325,6332,36.5,54543,23511,3243,3089
39326,1173,36.3,19602,11784,568,605
39327,4251,31.7,54444,21503,2033,2218
39328,4932,37.4,30533,13455,2508,2424
39330,2621,41.2,40887,22438,1380,1241
39332,1705,41.6,39167,19396,859,846
39335,3395,45.4,30119,18069,1644,1751
39336,1157,51.7,40448,21667,608,549
39337,1944,41.2,33765,20198,1123,821
39338,3360,42,24851,17563,1630,1730
39339,15725,39.8,28947,17412,7629,8096
39341,6749,35.4,23750,11617,3198,3551
39342,1579,30.9,38883,19834,738,841
39345,6296,38,40833,17432,2808,3488
39346,2480,37.4,38125,25135,1267,1213
39347,1618,45.1,19938,16887,658,960
39348,516,45.5,23750,15045,252,264
39350,25605,34.6,37280,18236,12027,13578
39352,644,47.9,19612,19416,345,299
39354,1175,50.2,27563,18556,612,563
39355,6579,44.9,29710,18178,2954,3625
39356,635,45.5,41354,23223,436,199
39358,1630,25.4,18625,11591,717,913
39359,235,39.8,57614,39002,115,120
39360,4497,35,27202,13509,2276,2221
39361,1951,40.2,21468,16081,949,1002
39362,2495,33.8,22452,15550,1311,1184
39363,1607,42.9,27535,19040,774,833
39364,3177,40.9,46574,22486,1738,1439
45682,2554,40.6,34393,18953,1182,1372
45684,1862,40.8,47517,18795,939,923
45685,1183,36.6,35341,18112,551,632
45686,3590,41,40743,15814,1827,1763
45688,533,43.7,28382,15338,276,257
45690,14244,40.4,41925,22777,7109,7135
45692,8449,37.7,33750,17100,3753,4696
45693,8207,40.4,39889,18494,4057,4150
45694,12375,40.5,43078,22231,6274,6101
45695,558,42.7,32458,18584,292,266
45696,1353,34.6,57237,19430,615,738
45697,5478,33.5,39521,19555,2592,2886
45698,414,48.6,34609,21173,175,239
45701,33913,22.5,29172,16139,17295,16618
45710,5901,40.9,42135,22392,2677,3224
45711,1305,43.8,37176,16293,604,701
45714,9429,48,39360,24110,4428,5001
45715,2607,43.9,42768,33405,1304,1303
45716,434,40.4,45357,25019,183,251
45719,1218,33.9,30888,14211,537,681
45721,11,-666666666,-666666666,,11,0
45723,3903,42.4,45682,19695,1995,1908
45724,1888,43,52301,24499,1023,865
45727,504,41.8,30625,17068,232,272
45729,1533,35.4,59806,22844,647,886
45732,4484,37.6,39375,17082,2142,2342
45734,607,38.1,64375,21742,349,258
45735,1794,52.8,41125,23311,887,907
45740,581,30.5,45833,17127,268,313
45741,973,41.3,33239,16299,462,511
45742,3161,45.9,47750,23515,1727,1434
45743,1364,43,46923,20138,679,685
45744,2507,47,48514,23077,1155,1352
45745,1419,46.2,45417,17416,807,612
45746,319,52.2,38493,17135,169,150
45750,27535,41.6,40743,24441,13379,14156
45760,3861,44.2,27266,15590,1813,2048
45761,1973,34.7,43281,18423,966,1007
45764,9046,34.3,30702,15519,4829,4217
45766,1247,37.9,30161,15745,723,524
45767,2657,46.3,36064,18986,1323,1334
45768,1653,39.3,47621,22455,792,861
45769,6550,42.6,34852,19325,3344,3206
45770,500,37.2,46146,19098,287,213
45771,3497,40,36779,20161,1723,1774
45772,1991,43.5,33621,18411,1032,959
45773,213,29.3,25750,7998,119,94
45775,1252,40.3,37321,19254,613,639
45776,610,43.8,36823,29054,238,372
45778,645,52.7,42313,25982,358,287
45779,696,36.7,38636,19060,372,324
45780,3351,41,33892,17139,1571,1780
45782,407,36.5,24219,12944,196,211
45784,3336,40.4,50742,22598,1716,1620
45786,3499,44,61667,23519,1795,1704
45787,0,-666666666,-666666666,-666666666,0,0
45788,1213,39.7,45441,21095,546,667
45789,159,55.2,24137,14374,93,66
45801,24866,34.4,34380,16086,13511,11355
45804,14968,35.1,24151,14757,7025,7943
45805,24102,36.1,47730,26425,11777,12325
45806,10632,46,53764,27887,5170,5462
45807,11651,46.4,56466,28553,5799,5852
45808,380,39.3,41875,18356,195,185
45809,75,30.9,64107,23405,35,40
45810,8305,23.1,39559,17138,4219,4086
45812,1581,38.7,41506,19485,781,800
45813,3598,41.4,45068,23571,1705,1893
45814,2688,35.4,52281,24217,1303,1385
45816,416,36.1,37292,19873,243,173
45817,6662,39.5,60224,27212,3203,3459
45819,259,31.2,41250,18002,127,132
45820,423,42.1,44732,23890,170,253
45821,1516,49.5,58468,23507,766,750
45822,19285,42.5,46650,24272,9365,9920
45826,361,44.5,54643,27950,199,162
45827,2104,36,62450,24982,1134,970
45828,6148,40.1,61926,24823,3174,2974
45830,6471,39.3,59750,24164,3339,3132
45831,3349,42.1,53452,22957,1692,1657
45832,3179,37.7,53165,22619,1560,1619
45833,10510,41.4,51686,23693,5268,5242
45835,348,58.2,39607,27455,179,169
45836,1560,36.3,46313,18826,776,784
45838,28,41,38125,12418,13,15
45840,54941,38.7,47592,26756,26609,28332
45841,781,40,69107,27096,416,365
45843,4012,40.4,56081,28269,1997,2015
45844,3228,42.2,67195,29601,1715,1513
45845,2785,37,62625,26761,1397,1388
45846,4236,30.2,62762,25211,2265,1971
45849,1274,38.2,52891,19348,598,676
45850,3847,37.7,46800,20978,1900,1947
45851,585,36.6,39565,19956,217,368
45853,1213,42.6,69814,31378,586,627
45854,478,50.9,35000,20377,240,238
45855,183,43.2,50000,23984,93,90
45856,5064,41.2,54263,24123,2572,2492
45858,3409,37,64014,23571,1642,1767
45859,449,36.1,32102,15488,216,233
45860,2094,31,70958,24602,1021,1073
45861,156,42.7,28750,14144,76,80
45862,1583,37.9,46765,21550,825,758
45863,1004,39.2,40000,18276,489,515
45864,131,39.8,56667,27308,63,68
45865,4937,41.2,65719,29653,2543,2394
45866,231,48.6,37813,24878,96,135
45867,1071,34.6,55750,22908,490,581
45868,538,40.8,52500,19086,275,263
45869,4496,38.9,63750,28477,2201,2295
45870,92,37.9,34231,13745,45,47
45871,1830,41,59412,27211,963,867
45872,4331,35.4,42536,21768,2214,2117
45873,2049,40.5,38472,23956,1055,994
45874,2041,41.5,42917,19294,933,1108
45875,11268,37.5,62170,26249,5336,5932
45876,804,35.4,71691,27402,378,426
45877,2178,39.9,53580,23006,1075,1103
45879,6479,39.5,42695,21596,3253,3226
45880,2316,37.2,45262,23329,1148,1168
45881,1780,37.6,53125,22815,909,871
45882,2764,42.6,48239,21774,1339,1425
45883,3979,34.1,63155,24385,2116,1863
45884,159,44.3,45741,20321,50,109
45885,12736,40.3,46007,24260,6442,6294
45886,801,32.2,48929,21348,385,416
45887,4550,41.8,48536,23810,2469,2081
45888,197,37.9,71250,34863,111,86
45889,1294,35.8,61420,26770,639,655
45890,850,34.8,63500,22806,384,466
45891,15096,42.3,43877,24184,7360,7736
45894,639,30.4,42450,17531,311,328
45895,18356,39.4,53214,23965,9273,9083
45896,2235,37.2,53566,22555,1076,1159
45897,155,45.3,-666666666,8999,89,66
45898,1326,38.9,50588,21574,722,604
45899,310,41.1,45227,19030,162,148
46001,10350,45.7,43248,23248,5184,5166
46011,16523,43.9,51570,26614,8035,8488
46012,19874,39.9,47044,21967,9680,10194
46013,18475,39,37752,20581,8730,9745
46016,18892,33.6,22964,13195,8889,10003
46017,5604,48.1,44371,24334,2918,2686
46030,3106,40.7,56469,26233,1545,1561
46031,2434,38.4,65583,28007,1151,1283
46032,42335,38.9,94045,51959,20715,21620
46033,35659,39.7,116021,51445,17145,18514
46034,7240,40.8,56653,28839,3535,3705
46035,1174,40.4,57750,21529,576,598
46036,11738,37.7,40979,20139,6051,5687
46037,36885,33.9,99707,39151,17835,19050
46038,38735,33.8,75320,33664,18680,20055
46039,843,39.2,62344,24915,438,405
46040,11537,39.2,73929,31153,5685,5852
46041,23668,37,46281,20782,11734,11934
46044,2701,40.1,56758,23371,1294,1407
46045,243,34.1,75875,21691,133,110
46047,117,7.4,-666666666,,94,23
46048,2128,30.2,52330,21721,935,1193
46049,884,46.1,57500,26516,460,424
46050,1902,40.5,57935,23534,924,978
46051,3148,40.5,59779,25332,1470,1678
46052,21879,40.1,47922,26073,10936,10943
46055,9706,36.1,82872,42145,4729,4977
46056,2131,37.1,49063,24442,1142,989
46057,925,37.9,65586,22476,487,438
46058,1992,44,54474,27316,927,1065
46060,35159,32.8,58526,28472,17622,17537
46062,31175,37.6,76085,35221,15055,16120
46063,517,27.8,32292,13324,249,268
46064,15771,37.4,62544,24431,8973,6798
46065,3541,39.6,66739,23174,1777,1764
46068,2358,49.9,52169,28933,1163,1195
46069,7044,40.1,49496,22973,3433,3611
46070,2156,37.7,56713,25108,1032,1124
46071,3804,42.8,66961,25766,2071,1733
46072,9603,41.5,50995,23848,4640,4963
46074,28951,32.6,94293,37033,14202,14749
46075,3246,31.9,64606,29637,1579,1667
46076,1730,42.4,51389,24016,905,825
46077,25250,38.2,107301,53764,12349,12901
46103,223,36.6,84375,24382,109,114
46104,865,43.9,51739,25368,437,428
46105,2181,35.6,50341,21928,1136,1045
46106,6051,38.5,74663,33960,2934,3117
46107,12763,35.7,41722,21249,5923,6840
46110,540,34.4,66023,31420,203,337
46111,361,38.9,25357,20450,185,176
46112,33844,37,75738,34101,16409,17435
46113,15100,30.7,63480,22483,7427,7673
46115,2201,35.8,51424,22669,1085,1116
46117,439,53.6,46190,26114,236,203
46118,5207,43.4,56912,26681,2692,2515
46120,6269,42.5,44538,21250,3066,3203
46121,5275,42.3,55995,26837,2503,2772
46122,14314,39.8,63000,29489,7234,7080
46123,32069,36.1,73760,32098,15769,16300
46124,7641,38.3,43172,20792,3775,3866
46125,48,57.5,29688,27508,33,15
46126,4172,41.6,62619,29144,1990,2182
46127,271,53.7,44861,28729,150,121
46128,1757,38.9,54861,22811,945,812
46130,2536,42.1,52460,24782,1283,1253
46131,31072,36.5,51799,24363,15083,15989
46133,897,32.9,39764,18297,434,463
46135,20512,35.1,46754,19110,11444,9068
46140,39070,39.7,57821,27119,19292,19778
46142,29735,40.3,68116,31195,14377,15358
46143,50521,36.1,63265,31776,25219,25302
46144,131,59.2,71250,24602,55,76
46146,72,34.8,110288,54647,62,10
46147,3418,36.6,56542,26449,1719,1699
46148,5342,41.6,46305,23965,2555,2787
46149,2151,43.4,65536,25323,1010,1141
46150,540,52.5,71563,31716,292,248
46151,30628,40.5,50314,24796,14809,15819
46155,136,32.5,84500,27624,74,62
46156,1519,39.7,47835,20328,763,756
46157,3879,38.8,59875,26448,2004,1875
46158,22442,43.2,59243,28197,11288,11154
46160,6849,39.8,50426,21799,3406,3443
46161,2534,42.4,55531,27260,1370,1164
46162,346,37.8,75179,22485,159,187
46163,11486,43.1,71441,31619,5741,5745
46164,3998,48.2,55059,30865,2068,1930
46165,1452,42.3,58528,27646,768,684
46166,2143,42.1,45521,22052,1097,1046
46167,6662,38.9,75000,26976,3281,3381
46168,31696,37.7,61181,27333,15988,15708
46171,1665,45.6,56964,27352,767,898
46172,2455,40.8,50843,22575,1257,1198
46173,11398,40.7,43793,22840,5618,5780
46175,707,41.6,48688,21936,378,329
46176,27766,39.6,45812,22770,13432,14334
46180,1164,35.5,51250,21029,601,563
46181,4394,42.1,59861,26406,2312,2082
46182,1702,45.2,57819,25648,993,709
46183,263,21.5,-666666666,27112,157,106
46184,12358,34.2,64045,23313,5885,6473
46186,1961,40.9,66800,27951,969,992
46201,31369,33.5,26391,14151,15254,16115
46202,15966,31.9,31698,29540,8581,7385
46203,37400,34.1,30481,15017,18306,19094
46204,5825,31.7,39826,34526,3951,1874
46205,26487,34.1,36429,23873,12750,13737
46208,22779,31.1,31999,21368,10535,12244
46214,24240,34.6,41095,22550,11653,12587
46216,1653,44.5,44479,30634,656,997
46217,28722,37.3,60254,29154,13786,14936
46218,29589,37.4,25666,14227,13820,15769
46219,34377,39.3,41332,21623,16593,17784
46220,34838,34.8,62063,39545,16949,17889
46221,26345,33.9,48294,20849,13102,13243
46222,33954,31.8,27581,14120,16325,17629
46224,35147,31.6,30660,17850,17484,17663
46225,7008,35,24548,13780,3541,3467
46226,45341,32.9,34368,17999,21748,23593
46227,58348,32.9,37380,20162,27760,30588
46228,14611,40.4,58208,31851,7304,7307
46229,28640,34.6,44626,23239,13278,15362
46231,11476,33.5,63340,23031,5571,5905
46234,26291,36.1,66186,29509,12838,13453
46235,30524,28.3,36213,16951,14368,16156
46236,27509,40.3,80833,38140,13491,14018
46237,40329,34.2,57266,26472,19404,20925
46239,26317,31.9,67494,26237,12970,13347
46240,18808,38.2,53699,38645,9007,9801
46241,30955,33.7,34600,16220,15669,15286
46250,17861,32.6,53568,40258,9150,8711
46254,37545,30,40046,21931,17234,20311
46256,23078,41.6,71759,41833,11047,12031
46259,12161,36.8,85700,32732,5697,6464
46260,33273,34.5,41826,29025,15467,17806
46268,26488,33.3,41718,24922,12074,14414
46278,7814,39.3,106738,55128,3821,3993
46280,6963,35.9,61230,33316,3579,3384
46290,343,42.4,151557,64234,163,180
46301,550,58.6,69896,45769,275,275
46303,13784,36.3,57960,24849,6868,6916
46304,24282,38.9,69149,32365,12211,12071
46307,60191,40.1,69071,31288,29965,30226
46310,13311,40,60539,26863,6707,6604
46311,21917,40.8,76034,33877,10929,10988
46312,29584,29.8,27583,13497,13569,16015
46319,18032,36,53826,25037,9005,9027
46320,15440,29.4,26763,14173,7261,8179
46321,23445,44.5,72583,37099,11311,12134
46322,23544,41.9,61353,29560,11004,12540
46323,22561,34.6,45478,19994,11100,11461
46324,23359,33.2,42421,19447,11336,12023
46327,11435,30.5,30275,12711,5784,5651
46340,1093,35.4,75587,26145,615,478
46341,10422,40.2,60725,25844,5225,5197
46342,31156,39.3,55855,25059,15324,15832
46345,337,33.8,48125,18592,143,194
46346,1600,30.5,35163,14422,709,891
46347,4860,38.2,64912,25476,2570,2290
46348,1034,40.6,65375,34010,498,536
46349,3461,44,52217,25006,1921,1540
46350,43335,39.8,48132,24703,21521,21814
46356,17503,36.7,64002,25080,8528,8975
46360,43882,40.9,42396,22557,21793,22089
46365,1185,37.8,59836,20625,592,593
46366,5673,41.4,42170,20482,2891,2782
46368,38517,38.3,54264,24801,18782,19735
46371,3636,39.8,68962,24619,1945,1691
46373,14089,42,95733,38724,7327,6762
46374,826,46,30298,18445,360,466
46375,23626,41.8,74276,35163,11515,12111
46376,372,35.5,39250,17870,181,191
46377,405,34.5,70956,26034,187,218
46379,210,18.4,2499,12896,67,143
46381,372,31.5,57885,19415,157,215
46382,2200,39.3,69727,26183,1113,1087
46383,40009,35.4,55374,26868,19626,20383
46385,38675,39.1,68473,30808,18523,20152
46390,2517,42.3,64881,26949,1238,1279
46391,10275,35.1,68448,16689,7317,2958
46392,7834,37.2,64250,25540,4094,3740
46393,411,35.6,66563,23201,252,159
46394,12289,39.2,48580,22929,5847,6442
46402,6603,38.6,16497,13240,2976,3627
46403,12223,38.9,32069,21595,5210,7013
46404,16988,41.8,25000,15089,7574,9414
46405,11500,37.9,39908,17250,5757,5743
46406,9898,38.5,30826,14310,4636,5262
46407,12798,36.2,19758,13291,5434,7364
46408,16820,38.3,35153,18860,8186,8634
46409,9150,30.6,29735,13055,4464,4686
46410,39023,35.7,48865,22948,19069,19954
46501,3892,35,47500,21281,1829,2063
46502,479,22.6,63561,19972,187,292
46504,3544,40.5,43679,22252,1734,1810
46506,10037,35.7,46618,20625,4847,5190
46507,8786,42.1,50992,27660,4360,4426
46508,140,27.7,65417,18881,54,86
46510,3142,40,64352,26339,1643,1499
46511,4292,43.3,53281,26223,2145,2147
46514,40147,38.7,44390,22551,19422,20725
46516,34372,33,35670,17495,16708,17664
46517,22891,36,41247,19635,11400,11491
46524,2541,32,60033,19849,1263,1278
46526,33137,33.4,47863,21721,16222,16915
46528,25001,32.7,51351,20643,12574,12427
46530,29699,41.4,87971,38906,14483,15216
46531,1365,45.3,53375,24896,720,645
46532,1983,40.9,48688,20046,967,1016
46534,11272,40.9,37731,18955,5619,5653
46536,3454,42.1,40755,21030,1870,1584
46537,468,35.5,42500,17362,205,263
46538,3897,42.1,51711,27744,1888,2009
46539,1950,33.8,46920,23943,982,968
46540,11559,31.4,55424,23976,5905,5654
46542,3764,33.3,51090,20845,1852,1912
46543,4140,23.3,64667,20357,2226,1914
46544,31130,37.4,41927,22785,14571,16559
46545,24723,36,34995,21410,11263,13460
46550,12608,32.3,49720,19108,6707,5901
46552,6865,42.2,55701,25349,3449,3416
46553,3389,31.9,53343,19468,1578,1811
46554,4933,39.6,48273,21373,2491,2442
46555,2991,43.6,47118,21829,1516,1475
46556,7027,20.2,29688,5173,3514,3513
46561,13482,39.4,57990,22925,6527,6955
46562,4937,36.5,49825,19709,2558,2379
46563,23742,38.7,45000,21809,12013,11729
46565,8356,25.7,48634,19493,4412,3944
46567,9417,43.3,59181,30689,4762,4655
46570,1189,37.7,41635,21310,579,610
46571,5398,22.8,47933,15907,2659,2739
46573,3492,41.1,50542,22006,1693,1799
46574,7644,45,45515,23528,3865,3779
46580,21263,39.6,45297,25064,10605,10658
46582,12280,36.1,54755,26195,6025,6255
46590,4899,33.9,54750,27874,2155,2744
46595,73,46.1,34091,21075,33,40
46601,5851,35.7,16806,13850,3145,2706
46613,11196,30.3,28777,12656,5577,5619
46614,30780,41.5,47569,27757,15220,15560
46615,15869,33.1,39333,21299,7360,8509
46616,5232,34.9,36060,20645,2598,2634
46617,9947,33,48726,27706,4686,5261
46619,21045,35.5,35858,16544,10545,10500
46628,26475,35.9,41005,20593,12783,13692
46635,5719,45.7,62573,28260,2778,2941
46637,14748,33.2,45857,23409,7161,7587
46701,7798,38.8,47272,22878,4019,3779
46702,2142,43.6,43059,20035,1120,1022
46703,18016,37.3,46909,22257,8938,9078
46704,194,35.4,31089,13796,117,77
46705,1625,34.5,43977,20322,855,770
46706,19363,38.8,48743,25303,9488,9875
46710,4446,43.5,55902,25123,2353,2093
46711,7813,29,41559,20305,3804,4009
46714,14414,41.1,46298,24409,7157,7257
46721,5026,36.4,44120,20176,2459,2567
46723,7162,39.6,58016,27318,3590,3572
46725,23109,41.2,51802,24931,11328,11781
46730,1277,44.4,34297,19737,670,607
46731,605,45.1,52313,26159,305,300
46732,3128,31.9,44578,19954,1577,1551
46733,18411,40.7,49288,22643,9006,9405
46737,7012,44,51696,28668,3506,3506
46738,7777,36.8,42893,20278,3792,3985
46740,4534,25.7,43955,14348,2316,2218
46741,4798,33.1,53549,18652,2436,2362
46742,3332,49,52625,27569,1810,1522
46743,1938,33.5,66250,24408,934,1004
46745,1931,42.6,70000,31570,986,945
46746,4051,36.7,45948,18871,2134,1917
46747,2923,44.9,45792,22411,1525,1398
46748,5371,33.6,70045,30539,2768,2603
46750,27432,39.7,44853,22075,13147,14285
46755,15239,38.4,44872,21232,7366,7873
46759,635,37.7,36763,17349,270,365
46760,1363,45.2,46548,20251,686,677
46761,11998,32.5,42937,19089,5833,6165
46763,1919,42.1,54417,30560,1022,897
46764,1211,41.2,44868,23460,632,579
46765,5457,40.4,69095,26522,2856,2601
46766,720,39,32422,18053,337,383
46767,8280,30,43340,18082,4302,3978
46770,2883,41.3,56293,27433,1512,1371
46771,0,-666666666,-666666666,-666666666,0,0
46772,3488,19.6,47059,13989,1616,1872
46773,3743,42,50144,24039,1926,1817
46774,16550,37.5,51715,24122,8042,8508
46776,1516,49.5,45478,22083,765,751
46777,6271,41.9,47120,22998,3057,3214
46779,2087,43.5,45625,23566,1082,1005
46781,825,43.8,45875,22589,374,451
46783,6144,39.8,76536,30726,3228,2916
46784,2141,45,49120,26349,982,1159
46785,1992,33.9,58448,21116,1107,885
46786,371,14.4,18393,4623,158,213
46787,3946,36.6,54000,23532,1968,1978
46788,2798,37.7,55191,23638,1463,1335
46791,696,40.5,66563,31479,364,332
46792,3503,40.7,49911,26248,1811,1692
46793,4404,36.3,48693,21457,2275,2129
46794,2124,37,45341,18550,1043,1081
46795,5481,44.4,51368,24419,2806,2675
46797,4129,37.5,59673,25824,2082,2047
46798,2107,35.2,68313,27370,1128,979
46799,169,33.6,51667,19770,88,81
46802,11136,30.4,26558,15280,6189,4947
46803,9314,26.8,21790,10650,4579,4735
46804,27105,39.6,62367,34366,12632,14473
46805,21166,32.6,34692,19266,9879,11287
46806,24414,28.7,27640,12628,11797,12617
46807,15819,30.1,43131,19196,7809,8010
46808,18939,33.8,39452,19432,9235,9704
46809,8186,41.6,36020,20531,3912,4274
46814,12993,38,113338,52955,6304,6689
46815,27158,37.3,56669,25894,12934,14224
46816,17688,37.8,34840,17988,8606,9082
46818,19746,35,55848,24470,9757,9989
46819,9407,38.5,46016,23341,4494,4913
46825,28800,36.8,51069,25950,13920,14880
46835,32855,36.7,56960,30883,15823,17032
46845,21528,38.5,83284,36399,10633,10895
46901,38943,40.7,37072,20926,19216,19727
46902,35465,41,44997,26001,16692,18773
46910,3373,38.4,40056,18352,1749,1624
46911,1398,37,59737,23785,730,668
46913,1201,40.9,55114,26322,691,510
46914,1665,48.9,48917,24238,876,789
46915,745,42.7,40956,23615,342,403
46917,2205,38.5,51875,22609,1110,1095
46919,2472,40.3,48633,23700,1235,1237
46920,1068,38.1,59906,24221,521,547
46922,0,-666666666,-666666666,-666666666,0,0
46923,7749,42.8,48000,25680,3714,4035
46926,1767,44.6,50982,21058,919,848
46928,4812,44.1,47936,22116,2495,2317
46929,3455,39.6,50254,21692,1717,1738
46930,139,47.3,44375,20932,69,70
46931,153,20.5,48750,14871,82,71
46932,4017,40.5,64515,28854,1867,2150
46933,6707,40,41947,20580,3273,3434
46936,6215,42.5,58056,25707,3122,3093
46938,2954,39.7,44701,20455,1445,1509
46939,2122,40,41081,19481,1106,1016
46940,2733,42.2,55766,24396,1339,1394
46941,1026,35.8,41042,20369,560,466
46943,153,33.9,30893,14470,64,89
46946,96,30.6,29167,9771,35,61
46947,28874,38,38946,20592,14578,14296
46950,715,46,53850,21760,323,392
46951,1812,44.3,36713,20636,929,883
46952,19915,44.9,39296,25174,9040,10875
46953,24258,36.8,34356,16578,11568,12690
46957,571,48.2,40694,19156,257,314
46958,323,52.7,51328,38229,240,83
46959,667,47.4,50917,18355,357,310
46960,1066,41.9,41964,21955,540,526
46961,81,61.4,36125,17696,42,39
46962,10098,35.8,46118,18872,4910,5188
46967,127,31,25500,10635,61,66
39365,7098,39.1,33491,19837,3412,3686
39366,1275,23,21964,13127,529,746
39367,14705,38.5,31505,20132,6970,7735
39401,44309,28.9,27342,16053,21525,22784
39402,39090,33.4,54592,32562,18073,21017
39406,2072,19.7,-666666666,2650,885,1187
39421,3468,37.8,26576,14697,1815,1653
39422,5491,34.7,29595,16750,2606,2885
39423,2722,41.6,32386,13876,1175,1547
39425,1704,39.7,53375,25375,809,895
39426,15889,41.9,49264,22744,7856,8033
39427,1532,43.9,25192,17624,716,816
39428,9683,38.7,32030,15719,4884,4799
39429,17909,36.4,29058,17661,8622,9287
39437,13484,36.2,35782,18270,6506,6978
39439,4340,44.2,33489,16031,2080,2260
39440,20414,34.1,29326,19265,9830,10584
39443,22142,40.1,43546,22300,11092,11050
39451,7697,34.5,43250,12809,5357,2340
39452,27266,37.3,47533,20160,13930,13336
39455,9679,39.3,28806,15501,4986,4693
39456,1296,37.1,21455,12774,684,612
39459,3713,33.3,42264,16285,1720,1993
39461,409,49.3,31827,12589,169,240
39462,1563,32.5,32292,13634,835,728
39464,2552,36.6,43125,19118,1282,1270
39465,21371,35.8,52021,22055,10161,11210
39466,28072,39.5,40047,19998,13497,14575
39470,13394,37.8,38561,19700,6757,6637
39474,5801,41.9,25592,14963,2905,2896
39475,12295,35.7,51124,21681,6214,6081
39476,6752,41.3,36195,18693,3410,3342
39477,664,46.8,29423,19901,295,369
39478,2153,34.8,36964,23896,1129,1024
39479,5255,41.4,41793,20252,2583,2672
39480,3340,39.3,44357,18670,1702,1638
39481,1789,41.6,41563,16640,954,835
39482,8821,33.8,47550,20797,4166,4655
39483,5760,40,27726,17067,2783,2977
39501,21865,30.7,25435,14425,10442,11423
39503,48348,33.6,46853,23222,24335,24013
39507,15754,40,44392,25322,7682,8072
39520,14877,38.4,38471,19691,7068,7809
39525,8777,49.3,68161,31848,4269,4508
39530,8366,36.5,29732,18672,4415,3951
39531,17668,34.3,37639,22437,9054,8614
39532,34953,37.4,55108,25906,17431,17522
39534,2335,21.3,-666666666,16773,1808,527
39540,8567,34.2,45245,21499,4219,4348
39553,17469,35.1,44475,20877,8097,9372
39556,7661,40.5,46066,20853,3813,3848
39560,16987,37.8,50177,24793,7475,9512
39561,2197,32.4,60278,26696,1128,1069
39562,17019,39.8,46290,22950,8299,8720
39563,13786,40.8,38086,20119,7068,6718
39564,38187,36.5,59528,29982,18573,19614
39565,19040,37.1,54159,21758,9807,9233
39567,10787,40.1,39659,25685,5304,5483
39571,13143,42,52426,24814,6430,6713
39572,1430,40.9,36429,14786,598,832
39573,7832,40.1,44573,21917,3949,3883
39574,12299,37.7,47242,20332,5983,6316
39576,5910,40.3,31948,21618,3032,2878
39577,10866,38.7,37857,15891,5283,5583
39581,11576,31.6,39050,19666,5832,5744
39601,23907,37.8,33346,18639,11688,12219
39629,6716,37.9,43293,21998,3157,3559
39630,1337,32,26750,15566,599,738
39631,3478,42,30230,18274,1583,1895
39633,1360,33.6,37135,15059,551,809
39635,111,64.1,-666666666,16317,59,52
39638,2923,46.3,20949,15116,1472,1451
39641,4428,40.1,35591,21451,2196,2232
39643,1169,42.7,35607,18051,620,549
39645,5195,44,32093,16666,2673,2522
39647,1070,35.7,85179,63396,511,559
39648,22291,35.5,34111,17645,10492,11799
39652,8310,32.7,26345,15162,3858,4452
39653,2854,39.6,34785,23490,1417,1437
39654,5382,39.4,36055,22137,2479,2903
39656,1012,53.4,43616,21986,571,441
39657,1721,42.4,31563,20066,836,885
39661,2691,43.3,29263,15801,1297,1394
39662,1040,48.3,37885,21498,385,655
39663,3028,40.3,33672,18518,1626,1402
39664,2184,42.7,30139,13934,1075,1109
39665,1150,50,42614,18966,582,568
39666,9612,40.2,42969,20465,4479,5133
39667,12543,39.1,32430,16934,6109,6434
39668,227,53.8,53828,30556,69,158
39669,5959,35.5,41069,20596,3492,2467
39701,13835,36.2,21043,17170,5755,8080
39702,22239,36.8,36598,19155,10815,11424
39705,14421,34.5,47457,26283,7187,7234
39730,11667,39.7,32958,17667,5369,6298
39735,4073,38.8,30292,17296,2075,1998
39736,279,25.4,16111,11254,122,157
39737,439,51.2,55938,21559,257,182
39739,2716,35.9,32016,13326,1327,1389
39740,5436,35.3,54756,23464,2665,2771
39741,1340,44.6,36250,19847,652,688
39743,1706,36.9,27623,16417,833,873
39744,5595,41.2,28430,18863,2698,2897
39745,824,40.5,44063,20956,426,398
39746,3264,35.1,47059,18985,1577,1687
39747,1838,51.1,31842,15525,940,898
39750,2899,38.6,35635,18014,1295,1604
39751,1507,35.9,29899,14710,758,749
39752,2603,41,38897,18790,1307,1296
39755,785,45.6,32292,15162,410,375
39756,2361,37.3,43424,15934,984,1377
39759,42474,25.8,30625,21224,21384,21090
39760,0,-666666666,-666666666,-666666666,0,0
39762,2504,19.7,-666666666,3231,1072,1432
39766,2543,44.7,46892,23078,1390,1153
39767,621,45.9,26375,17586,258,363
39769,1990,43.2,40875,19398,1002,988
39771,153,29.7,54583,41139,50,103
39772,1512,47.4,26928,15554,708,804
39773,16658,38.3,30389,18835,7971,8687
39776,1447,43.2,33606,16320,649,798
39813,1933,41.2,23750,21781,913,1020
39815,1702,39.5,29292,13208,769,933
39817,11474,36.1,30907,15507,5585,5889
39819,10510,39.9,29684,20833,5065,5445
39823,8727,38.8,29473,18281,4099,4628
39824,367,31.8,23750,13252,187,180
39825,1386,29.4,26314,13928,735,651
39826,656,32.9,30833,12476,356,300
39827,4020,37.8,31313,16185,2140,1880
39828,15448,36.7,28579,14926,7564,7884
39834,2075,45.9,36250,25408,1008,1067
39836,671,37.2,44432,18063,301,370
39837,6116,43.1,32342,18628,3024,3092
39840,5335,44.5,29157,18836,2647,2688
39841,573,43.6,24091,15014,266,307
39842,8044,39.9,31127,16717,3843,4201
39845,8016,43.9,30307,18167,3736,4280
39846,1745,42.3,23571,13599,743,1002
39851,2233,43.4,19423,12619,1016,1217
39854,2397,43.4,30841,14164,1165,1232
39859,1194,40.9,41200,20723,528,666
39861,1090,41.5,28264,15709,481,609
39862,1177,45.3,40735,21108,450,727
39866,2923,35.1,39167,9257,2405,518
39867,454,40.4,34250,11762,271,183
39870,2477,40.8,26454,15180,1232,1245
39877,452,56.4,23750,16619,270,182
39885,154,28.7,50000,14739,91,63
39886,1600,42.2,28214,16322,803,797
39897,3403,42.3,35129,16387,1602,1801
40003,2367,36.8,64071,26095,1271,1096
40004,28815,35.6,43936,24538,14230,14585
40006,4820,38.7,49453,21771,2434,2386
40007,85,35.5,39063,22262,34,51
40008,3677,41,42997,21731,1846,1831
40009,1543,36,36150,16990,786,757
40010,542,41.7,77708,29533,296,246
40011,2217,40.4,50897,23376,1106,1111
40012,629,37.3,32857,16271,269,360
40013,5546,39.4,53472,24204,2738,2808
40014,20153,39.6,85036,34723,10098,10055
40019,3725,35.4,33851,18707,1715,2010
40020,124,40.3,52917,24709,53,71
40022,813,46.4,59107,29384,411,402
40023,4384,41.4,92375,39058,2279,2105
40025,74,74.5,109896,127193,39,35
40026,5449,36.5,94174,37103,2579,2870
40031,23006,39,68181,25445,13120,9886
40033,12372,38.9,38920,19825,6105,6267
40036,276,35.1,34375,21647,140,136
40037,2747,39.6,39594,18007,1438,1309
40040,456,39.9,45179,18047,201,255
40041,323,80.3,25575,18940,62,261
40045,3612,43.4,49091,20965,1962,1650
40046,2118,39.6,58047,24036,1191,927
40047,18708,37.9,62323,27351,9259,9449
40048,101,76.5,-666666666,5924,0,101
40049,109,85.1,-666666666,8882,8,101
40050,1593,36.6,38289,19365,767,826
40051,4472,40.2,38942,18664,2376,2096
40052,534,25.7,30781,11287,313,221
40055,1862,43.3,60074,28724,1004,858
40056,3471,42.3,65417,33452,1693,1778
40057,3647,41.7,50660,21420,1852,1795
40058,87,68.1,26875,17103,38,49
40059,17330,43.7,112377,64566,8599,8731
40060,1115,44.2,40813,18390,555,560
40062,426,49.5,30938,32054,229,197
40063,761,30.7,-666666666,3535,741,20
40065,28694,37.2,53081,25163,13673,15021
40067,5459,40,83168,36361,2463,2996
40068,2152,46.2,50347,26259,1089,1063
40069,8294,40.5,41016,20470,4108,4186
40070,524,38.2,63309,19836,301,223
40071,14424,40.6,66023,26805,7206,7218
40075,1207,44.5,43850,22650,677,530
40076,2033,48.7,51389,26139,1043,990
40077,475,51.2,41298,23929,246,229
40078,2273,42.7,41250,20364,1266,1007
40104,1203,47.3,40469,28786,600,603
40107,2013,44.7,46719,22240,1016,997
40108,11583,39.4,53306,22305,5699,5884
40109,2468,34.5,57868,21561,1255,1213
40110,16,-666666666,-666666666,,0,16
40111,1706,45.3,33250,16929,842,864
40115,724,47.4,26750,13323,329,395
40117,2553,39.2,65750,24076,1375,1178
40118,9452,35.9,40702,19241,4369,5083
40119,1664,55.2,43869,23242,790,874
40121,10555,22.5,51711,18231,6311,4244
40140,423,27.5,46786,13536,226,197
40142,2500,36.5,30000,16448,1206,1294
40143,6725,40,43750,18162,3396,3329
40144,1730,40.7,34261,17158,794,936
40145,996,30.7,37054,13011,478,518
40146,4350,38,40342,19540,2026,2324
40150,3744,45.4,48782,21843,1866,1878
40152,382,70.1,51779,24526,208,174
40155,1100,31.5,28676,13914,609,491
40157,755,46.1,46546,18835,380,375
40160,23361,33.2,45476,22632,11372,11989
40161,118,45.7,42614,16781,66,52
40162,5985,40.6,60893,23218,2973,3012
40165,34077,39.1,53522,23228,16924,17153
40170,306,48.9,43056,15735,195,111
40171,230,51.8,52321,25513,142,88
40175,13198,39.6,51091,24614,6512,6686
40176,967,37.5,46510,22253,545,422
40177,1469,40.4,29013,19061,649,820
40178,460,31.7,46813,22379,223,237
40202,6442,34.5,16069,16973,4141,2301
40203,18884,34,15535,12557,9298,9586
40204,14426,38.2,46275,40277,7281,7145
40205,23865,42.9,67446,40908,11169,12696
40206,18778,38.8,43036,31576,9022,9756
40207,29805,41.6,70654,48299,13958,15847
40208,14482,24.7,25760,15776,7458,7024
40209,586,37.1,37218,17891,259,327
40210,15544,30.7,20069,11143,7276,8268
40211,22297,35.7,23790,13649,9928,12369
40212,18359,36.3,27212,14095,8661,9698
40213,15921,35,34769,22039,7748,8173
40214,46134,38,39447,20714,22595,23539
40215,22747,31.6,27615,14572,11130,11617
40216,40903,38.7,38829,19961,19262,21641
40217,12813,38.3,40651,23101,6583,6230
40218,29834,35.4,33906,20598,14145,15689
40219,39577,35.8,39601,20178,18941,20636
40220,33525,40.1,51405,29854,16095,17430
40222,21628,42.6,59135,42398,10102,11526
40223,21610,42.5,71014,42609,10244,11366
40228,15771,40.1,59005,26586,7329,8442
40229,36741,34.2,50154,21997,18096,18645
40231,0,-666666666,-666666666,-666666666,0,0
40241,29783,40.8,75259,41989,14540,15243
40242,11193,38.5,63429,31669,5246,5947
40243,10509,45.6,61691,33767,5223,5286
40245,30743,39,96089,45939,15112,15631
40258,27394,38.6,47924,22199,13037,14357
40272,37708,37.8,48747,22516,18277,19431
40280,450,21.9,42917,13999,297,153
40291,34087,39,64342,29549,16427,17660
40299,38530,39,69207,32477,18926,19604
40310,682,34.1,27875,13671,308,374
40311,7296,39.8,43287,20371,3604,3692
40312,6647,36.4,19464,12772,3065,3582
40313,3853,28.3,33976,15302,1883,1970
40316,376,24.3,29091,17415,194,182
40322,3284,41.3,29167,14114,1609,1675
40324,42552,34.9,62548,27948,20644,21908
40328,1017,39.2,39212,20949,494,523
40330,18977,42.3,44504,23897,9199,9778
40334,114,23.5,-666666666,3442,57,57
40336,13139,41.8,28902,16312,6541,6598
40337,5516,38.1,31088,17745,2726,2790
40339,0,-666666666,-666666666,-666666666,0,0
40342,21305,38.3,53193,24225,10315,10990
40346,688,34.1,28462,17972,390,298
40347,2806,40.7,60881,28415,1386,1420
40348,730,45.7,39333,16557,341,389
40350,106,63.3,32014,17549,55,51
40351,19590,32.9,36019,17453,9504,10086
40353,20682,39.2,38715,21304,10158,10524
40356,41331,36.6,49537,26725,20256,21075
40358,802,47.5,38239,17665,437,365
40359,6899,41.3,38143,20588,3338,3561
40360,6905,38.4,35759,18843,3387,3518
40361,18259,40,40893,23035,9040,9219
40363,0,-666666666,-666666666,-666666666,0,0
40370,2349,39.8,59000,25901,1267,1082
40371,2935,35.4,25408,11919,1499,1436
40372,2270,48.3,54583,25780,1115,1155
40374,1707,47.1,30950,14930,837,870
40376,14,-666666666,-666666666,,0,14
40379,3545,41.1,51175,24417,1832,1713
40380,5921,40.5,32308,17798,3211,2710
40383,22196,41.8,58845,30100,11162,11034
40385,2950,39.2,43553,18775,1401,1549
40387,2009,46.2,29153,17656,1023,986
40390,7154,30.6,44453,18586,3529,3625
40391,35298,40.6,45765,24512,17385,17913
40402,2106,47.6,22540,17344,965,1141
40403,24471,36.2,42468,19705,11975,12496
40404,664,20.1,-666666666,3513,297,367
40409,3626,41.9,30647,16661,1740,1886
40419,4250,39.4,29183,15612,2162,2088
40422,24399,41.2,42995,23268,12031,12368
40434,88,32.8,-666666666,49308,73,15
40437,5756,39,43608,19036,2661,3095
40440,2300,33.6,36250,14692,1160,1140
40442,1156,37.1,29667,13098,482,674
40444,13701,41.8,45032,21985,6618,7083
40445,883,45,15167,11336,439,444
40447,7744,41.5,25144,15977,3990,3754
40448,0,-666666666,-666666666,-666666666,0,0
40456,9913,40,32413,17451,4969,4944
40460,856,47.7,24526,11328,394,462
40461,3291,34,44469,24493,1856,1435
40464,926,47.5,31250,20249,454,472
40468,2057,44.5,27716,17408,1000,1057
40472,1473,47.1,30202,17482,757,716
40475,56351,33.2,41654,22603,27113,29238
40481,342,38.1,45833,18251,197,145
40484,10924,40.1,33734,17747,4999,5925
40486,3191,29.7,32210,13653,1434,1757
40489,4437,41,31225,15628,2360,2077
40502,26931,39.1,60331,44595,13106,13825
40503,27755,37.9,52303,29305,13679,14076
40504,25884,31.9,32317,20311,13661,12223
40505,26212,38.6,33619,19089,12681,13531
40506,2128,18.9,-666666666,4258,884,1244
40507,1677,41.5,19636,38824,999,678
40508,24968,22.9,20412,15327,12467,12501
40509,34413,33.3,66806,36328,16683,17730
40510,2193,33.1,111786,32655,1484,709
40511,31143,33.4,49941,24873,16046,15097
40513,11109,43.5,110824,51333,5393,5716
40514,14934,36.8,79836,36143,7171,7763
40515,34375,34.7,68195,35501,16449,17926
40516,2596,42,60833,33060,1250,1346
40517,35333,31.8,39482,23035,16270,19063
40601,49984,40.4,46063,26336,24135,25849
40604,437,36.4,-666666666,6097,423,14
40701,28275,40.5,32458,18236,13335,14940
40729,6261,37.2,32743,16624,3121,3140
40734,3349,43.4,18436,13055,1662,1687
40737,1377,38.4,26348,15105,564,813
40740,3319,33.7,35774,16389,1616,1703
40741,22623,37.7,35812,20768,10828,11795
40743,410,46,72009,30127,245,165
40744,17272,39.4,39560,21876,8685,8587
40759,3084,32.6,22556,11004,1446,1638
40763,561,42.1,20333,12270,305,256
40769,18135,36.9,27221,14298,8840,9295
40771,1152,44.4,29583,15771,636,516
40801,484,47.5,16071,9033,253,231
40806,2826,33.1,31607,14492,1400,1426
40807,425,50.3,51000,25669,190,235
40808,73,21.5,92500,20021,29,44
40810,1151,47,24336,14553,593,558
40813,649,50.4,21019,13945,269,380
40815,1389,45.6,21875,15008,724,665
40816,33,73.1,-666666666,6915,0,33
40818,50,67,11550,23746,32,18
40819,821,42.5,42458,20979,403,418
40820,357,42.7,14306,11768,221,136
40823,4247,42.7,24675,15859,2113,2134
40824,774,38.9,25313,12968,406,368
40826,1190,22.3,30833,10182,540,650
40827,555,42.2,33068,21760,214,341
40828,3561,39.4,23476,12935,1771,1790
40829,295,38.3,17010,12940,173,122
40830,325,32,33214,15625,177,148
40831,5337,41,26296,20030,2326,3011
40840,254,57.5,74306,27610,114,140
40843,290,43.5,14946,8699,103,187
40844,38,52.8,-666666666,34871,27,11
40845,508,50.5,31304,13498,256,252
40847,256,27.6,16071,8635,74,182
40849,391,30.1,40859,11671,209,182
40854,1200,37.1,25375,17409,585,615
40855,920,39.8,26964,14099,437,483
40856,970,49.7,40123,15090,473,497
40858,596,37,23182,16450,287,309
40862,818,51.3,45313,19583,407,411
40863,554,39.6,26042,14597,291,263
40865,352,54.4,34728,24894,166,186
40868,1264,30,27625,12267,651,613
40870,292,40.2,65735,26640,150,142
40873,2205,43.3,30880,18298,1139,1066
40874,541,42.8,8974,10025,236,305
40902,1057,49.7,26833,14162,491,566
40903,759,51,24643,13197,399,360
40906,11614,38.7,22418,13985,5764,5850
40913,144,48.5,13958,14409,63,81
40914,467,32.4,39265,14404,245,222
40915,1535,30,31848,12968,770,765
40921,385,27.9,26029,10006,218,167
40923,1037,26.6,18955,13108,455,582
40927,199,44.4,14702,12832,108,91
40935,2634,39,23063,14174,1373,1261
40939,218,43.9,16081,22368,119,99
40940,572,37.6,20962,8294,274,298
40941,121,22.6,16023,9812,57,64
40943,795,40.1,24688,11789,447,348
40946,154,45.3,40640,14030,49,105
40949,615,42.8,46250,26508,349,266
40953,945,41.4,30721,13138,425,520
40958,347,45.6,23611,12290,196,151
40962,18774,37.8,22324,14000,10223,8551
40964,303,33.5,28640,8929,136,167
40965,13352,39.4,24898,14310,6202,7150
40972,1166,37.2,21544,11564,589,577
40977,10452,40.3,27542,16425,5403,5049
40979,255,14.6,34107,10380,108,147
40982,418,37.8,15144,11083,246,172
40983,720,20.9,14089,6250,427,293
40988,641,39.3,27218,12927,285,356
40995,8,-666666666,-666666666,,8,0
40997,348,30.1,18350,7136,116,232
41001,16510,37.4,70621,27201,8484,8026
41002,2482,42.3,33889,18982,1145,1337
41003,2324,39.2,42232,20912,1185,1139
41004,4356,37.9,41985,21013,2171,2185
41005,24406,34.9,69810,27518,11923,12483
41006,4239,41.4,54167,26310,2086,2153
41007,3684,41.3,56824,25873,1767,1917
41008,7523,35.4,35898,19060,3722,3801
41010,3662,33.4,49741,22549,1786,1876
41011,25513,37.2,39397,26295,12947,12566
41014,7728,33.2,30958,17679,3549,4179
41015,20175,40.4,50105,26513,10039,10136
41016,5832,35.7,41944,24884,3093,2739
41017,39281,38.8,67235,35421,18996,20285
41018,27386,34.9,51623,25189,13511,13875
41030,6181,33,46432,19505,3021,3160
41031,15999,41.9,34930,21530,7753,8246
41033,1881,42.3,54138,24329,1057,824
41034,967,40.2,43533,22623,501,466
41035,10571,37.7,49328,21175,5391,5180
41039,2739,40.5,32500,22770,1311,1428
41040,7680,39.2,40352,21541,3695,3985
41041,7477,41.2,32664,19626,3620,3857
41042,49747,36.4,53637,26282,24349,25398
41043,1660,44,57218,27822,912,748
41044,983,35.1,31458,16995,496,487
41045,1409,34.7,49750,19052,761,648
41046,1991,24,37585,13209,1101,890
41048,14717,33.9,94868,34882,7544,7173
41049,1968,37.8,32738,17107,971,997
41051,28453,31.8,69901,25145,13760,14693
41052,65,47.9,-666666666,30378,27,38
41055,2002,36.6,51563,23857,906,1096
41056,14082,41.5,39554,23425,6881,7201
41059,3131,39.5,65469,29731,1657,1474
41062,64,34.3,-666666666,9344,23,41
41063,3035,44.1,52383,22027,1506,1529
41064,1834,46.3,34432,18542,930,904
41071,21073,35.1,41054,22467,9995,11078
41073,5810,37.7,53396,26881,2889,2921
41074,5482,30.8,36962,17595,2641,2841
41075,16399,39.6,59733,33155,7999,8400
41076,16920,38.9,61696,30240,8317,8603
41080,1753,50.5,71875,35151,900,853
41083,998,44.3,52270,21629,554,444
41085,718,27.8,31776,12922,325,393
41086,2724,38.4,50650,22516,1458,1266
41091,16622,37.6,95101,36406,8437,8185
41092,3653,38.6,50650,23786,1686,1967
41093,2925,39.5,32550,16552,1443,1482
41094,13987,35.6,70143,28732,7032,6955
41095,2967,46.8,40651,20710,1328,1639
41097,7338,37.8,44144,19601,3712,3626
41098,2096,48.2,40849,32046,1072,1024
41099,908,19.8,-666666666,3813,365,543
41101,19425,40.4,34959,24622,9091,10334
41102,21060,43.1,44382,25813,10675,10385
41121,1499,44.1,61932,27074,861,638
41124,1374,34.3,36250,15251,636,738
41129,10018,41.7,48875,24859,5107,4911
41132,407,50.2,25357,18403,203,204
41135,190,46.4,35536,16679,75,115
41139,8135,43.4,40292,22490,3747,4388
41141,2126,35.6,26208,12295,1023,1103
41142,51,8,-666666666,,13,38
41143,14272,38.1,38956,20081,6992,7280
41144,10535,41.6,43113,19467,5329,5206
41146,256,44.9,24583,11794,130,126
41149,538,38.4,17500,9158,274,264
41159,366,51.8,23333,14037,229,137
41164,13532,41.5,34716,17731,6915,6617
41166,996,28.8,19485,11857,547,449
41168,3147,40.6,44659,22901,1418,1729
41169,5769,42.1,55794,23985,2933,2836
41171,4737,40.1,23811,13631,2866,1871
41174,1166,35.8,24063,11820,526,640
41175,6043,41.2,36319,18454,2848,3195
41179,7555,41.3,27740,16158,3745,3810
41180,1145,50.4,17799,15318,621,524
41183,1407,44.6,43472,22285,662,745
41189,2222,47.6,31964,20704,1224,998
41201,291,33,44875,24558,136,155
41203,745,41.7,27540,15721,367,378
41204,770,41.1,45135,16021,416,354
41214,434,35.3,24241,9429,196,238
41216,1117,38.9,35625,16790,509,608
41219,2051,39.5,38107,17165,1118,933
41222,2469,40.5,31733,15296,1202,1267
41224,6628,38.8,26611,15667,3806,2822
41226,112,39,81500,27768,38,74
41230,11658,39.9,33720,17968,5695,5963
41231,699,36,40682,20443,389,310
41232,597,40.9,36944,18410,279,318
41234,346,55.4,39688,23123,184,162
41238,1071,39.3,34741,27937,473,598
41240,7899,39.5,32718,22015,3664,4235
41250,1022,37.4,23889,19062,550,472
41254,650,33.1,23295,17554,389,261
41255,1105,38.3,25313,14545,631,474
41256,1973,47.2,35469,22002,933,1040
41257,202,50.7,18466,9624,101,101
41260,683,36.8,25313,18257,341,342
41262,1887,30.2,24593,14372,980,907
41263,420,41.5,22310,15896,219,201
41264,142,57.4,23281,28268,93,49
41265,2050,37.5,38796,16302,1043,1007
41267,1125,38.9,27656,14052,601,524
41268,282,65.7,21991,17901,148,134
41271,292,38.2,28472,17554,136,156
41274,474,32.5,39155,20788,256,218
41301,6057,42.4,22520,14586,3002,3055
41311,7429,41.2,22578,13538,3949,3480
41314,5266,42.4,21667,13919,2644,2622
41317,304,36.5,26875,12867,166,138
41332,1141,42.8,26830,12517,666,475
41339,10543,41.5,22490,15154,5294,5249
41348,1489,35,25615,14290,751,738
41352,721,44.3,22750,15102,429,292
41360,409,42.5,31944,10117,166,243
41365,478,32.4,58310,19815,196,282
41366,10,-666666666,-666666666,,0,10
41367,202,45.5,34391,11886,100,102
41385,291,36.8,21875,8635,152,139
41390,56,44.4,8125,3548,24,32
41397,0,-666666666,-666666666,-666666666,0,0
41408,381,29.8,12750,8739,110,271
41421,96,48.9,47917,27809,40,56
41425,983,40.2,28362,16176,458,525
41464,713,39.6,20417,8602,363,350
41465,11734,39.6,27294,15795,5800,5934
41472,11240,38.6,33209,16470,6522,4718
41501,24221,39.6,35061,21807,11977,12244
41503,600,38,24389,22850,227,373
41512,959,50.9,30685,17382,514,445
41513,555,49.5,27348,19735,272,283
41514,2978,40.7,30951,18418,1451,1527
41517,55,51,106406,86158,14,41
41519,1203,40.8,39313,22221,540,663
41522,5239,42.6,34375,18968,2493,2746
41524,419,47.7,36417,27726,247,172
41526,108,35.9,14514,31045,72,36
41527,833,41.1,70455,31941,416,417
41528,603,45.6,27596,20431,286,317
41531,878,40.5,25764,16888,462,416
41534,180,49.4,34643,19074,94,86
41535,446,57.3,38583,18918,209,237
41537,5538,42.6,28981,16411,2635,2903
41538,34,62.3,-666666666,23485,21,13
41539,1775,36.3,29250,17463,926,849
41540,235,40.2,62672,24235,129,106
41543,547,34.2,24917,11222,264,283
41544,1001,38,32723,16061,452,549
41547,267,51.2,26597,13532,119,148
41548,711,47.5,26378,15352,351,360
41553,2895,41.5,19248,13827,1417,1478
41554,1180,44.9,32333,14361,572,608
41555,862,33.8,21583,10540,428,434
41557,2003,35.2,45234,19307,934,1069
41558,697,47.7,29625,17421,385,312
41559,311,41.2,43594,18785,157,154
41560,317,36.4,32000,15144,167,150
41562,2616,40.3,31402,17439,1249,1367
41563,515,38.9,34306,15064,199,316
41564,1312,34.3,41806,16302,653,659
41566,659,32.3,46500,17725,349,310
41567,191,47,34167,22927,86,105
41568,705,36.9,30809,14615,340,365
41571,538,40.9,19306,15779,304,234
41572,3504,42.3,39557,19124,1700,1804
41601,546,48.8,37472,30499,273,273
41602,363,48.8,51331,21791,166,197
41603,1365,42.2,30268,17611,766,599
41604,433,43.8,16280,11320,232,201
41605,647,38.6,47500,17450,307,340
41606,596,58.3,42682,25355,203,393
41607,522,22,31016,7212,221,301
41612,41,58.6,22981,12380,20,21
41615,580,34.7,65669,25743,327,253
41616,744,50,45789,22387,368,376
41619,560,47.5,30833,20919,313,247
41621,504,30.6,33893,14198,225,279
41622,392,55.7,32806,11205,228,164
41630,1293,39.8,31105,18632,699,594
41631,1258,41.2,31625,18107,622,636
41632,732,43.9,17054,10603,383,349
41635,2894,38.7,25620,17268,1428,1466
41636,912,55.1,29612,17462,442,470
41640,961,44.4,29432,24227,432,529
41642,523,44.6,9622,16030,219,304
41643,301,44.6,80296,14647,124,177
41645,1228,26.7,34688,19934,608,620
41647,1528,35.6,34598,16625,725,803
41649,3004,41.4,25458,15356,1527,1477
41650,423,42.6,13683,10849,203,220
41653,12465,36.7,28458,17912,5947,6518
41655,702,47.2,40759,25869,358,344
41659,303,60.7,38684,38250,140,163
41660,882,45.1,14960,8727,482,400
41663,613,41.8,59034,22415,260,353
41666,951,39.5,28040,14584,447,504
41667,655,39.6,29643,11173,335,320
41669,1172,35.5,22031,8749,734,438
41701,17468,41.9,38021,20957,8476,8992
41712,293,34.9,26328,14964,121,172
41713,0,-666666666,-666666666,-666666666,0,0
41714,243,53.9,43583,16758,114,129
41719,832,56,22523,12974,447,385
41721,622,44,28833,13536,321,301
41722,1636,38.9,30234,15640,882,754
41723,1601,31.7,33056,13522,730,871
41725,87,57.2,24050,20734,67,20
41727,672,24.1,45074,12679,224,448
41729,281,44.5,16524,6691,121,160
41731,1141,42.7,22167,16990,498,643
41735,130,43.6,10809,8512,57,73
41739,115,62,59395,36417,32,83
41740,951,40.1,45474,24782,503,448
41745,43,19,-666666666,16086,22,21
41746,800,39.1,20625,13256,467,333
41749,3298,46.6,24388,17867,1493,1805
41751,444,39.7,63676,20816,256,188
41754,446,29.5,35208,11792,195,251
41759,365,32.8,54427,22641,201,164
41760,13,31.5,-666666666,,8,5
41762,219,60.4,21179,19578,92,127
41763,645,41.6,36827,16535,318,327
41764,771,47.7,28125,18040,443,328
41766,161,28.9,81078,29543,95,66
41772,307,28.8,43194,15988,207,100
41773,1564,37.8,23309,14005,729,835
41774,2230,49.6,31310,18494,1214,1016
41775,62,51.3,24375,25631,38,24
41776,1470,33.1,36215,14787,755,715
41777,1092,42.1,34964,17394,571,521
41804,1059,51.1,34432,14807,646,413
41810,509,33.6,69493,20219,320,189
41812,337,53.6,22813,17060,109,228
41815,471,39.2,24512,22346,254,217
41817,332,22.8,64432,22066,124,208
41819,231,46.1,14542,20071,109,122
41821,809,35.9,27750,15202,447,362
41822,2322,40.1,27478,17928,1108,1214
41824,1047,44.1,27083,15610,449,598
41825,456,39,26838,17274,251,205
41826,911,52.9,33565,15920,391,520
41828,1041,37.9,36739,17867,559,482
41831,896,39.2,34539,20259,410,486
41832,608,26.9,28889,14341,286,322
41833,185,62.6,11397,15455,128,57
41834,844,30.2,33250,19642,408,436
41835,967,50.9,43690,19524,499,468
41836,793,51.6,32863,19943,322,471
41837,478,49,30714,24147,250,228
41838,374,33.8,17386,15709,200,174
41839,1319,40.1,24063,14458,648,671
41840,1556,33.4,27212,13750,865,691
41843,704,39.4,25813,17373,355,349
41844,1765,32.3,31250,13174,861,904
41845,83,57.3,14183,8424,20,63
41847,449,54.9,33140,18594,204,245
41848,18,-666666666,-666666666,,18,0
41849,189,23.4,61208,24758,141,48
41855,628,39,40074,15187,338,290
41858,7737,41.6,33281,20496,3503,4234
41859,355,46,45455,20572,185,170
41861,198,31.2,61429,25043,103,95
41862,849,45.5,35250,16093,405,444
42001,28249,42.4,48113,31070,13346,14903
42003,29181,42.4,37621,20729,13942,15239
42020,2299,42.1,52381,26744,1130,1169
42021,1708,34.7,36622,15763,764,944
42022,50,48.7,-666666666,37458,26,24
42023,2412,47.4,38867,24267,1190,1222
42024,1577,38.6,42375,22902,775,802
42025,19744,43.2,42310,21348,9609,10135
42027,2063,45.7,43218,26262,1112,951
42028,610,32.8,36125,21705,295,315
42029,6311,45,49011,25158,3157,3154
42031,3251,49.1,32123,18442,1542,1709
42032,238,49.3,30962,19411,125,113
42035,947,37.9,52368,20068,456,491
42036,1014,44.6,51719,20428,517,497
42037,0,-666666666,-666666666,-666666666,0,0
42038,5303,45.6,38397,21568,3112,2191
42039,1795,39.3,40536,20003,894,901
42040,1293,32.3,54407,23471,634,659
42041,4628,43.9,34102,19574,2308,2320
42044,2868,49.7,53605,29136,1339,1529
42045,1817,49.9,32168,19535,835,982
42047,138,49.9,47625,24428,69,69
42048,2436,41,33229,16592,1302,1134
42049,1927,35.9,39647,19640,894,1033
42050,3102,44.3,30379,17761,1546,1556
42051,2714,40.5,41630,22024,1281,1433
42053,4803,39,52786,25675,2473,2330
42054,1108,37.4,62805,20907,644,464
42055,2643,57,49364,24584,1254,1389
42056,2524,41.1,44202,21002,1274,1250
42058,2191,37.5,45090,17555,1119,1072
42060,207,11.7,37083,11332,105,102
42061,92,42.2,124063,50265,28,64
42064,8301,43.1,33622,20533,4151,4150
42066,23807,39.4,37281,20158,11579,12228
42069,848,40.7,41739,22417,422,426
42071,29425,31.5,37095,21121,14058,15367
42076,1039,53.2,26678,22748,534,505
42078,1953,47.1,32404,20236,966,987
42079,1494,39.5,35265,20544,683,811
42081,2640,45.3,44609,22389,1273,1367
42082,1655,53.9,35795,21344,776,879
42083,349,53.3,41010,19705,174,175
42084,149,41.4,22188,16950,81,68
42085,760,41.8,34464,19752,402,358
42086,4054,44.9,63007,30851,1954,2100
42087,2262,40.3,42727,26958,1099,1163
42088,2563,40.7,45156,21452,1266,1297
42101,56169,28.6,35462,16930,27401,28768
42102,37,-666666666,-666666666,,28,9
42103,20264,39.3,59942,34081,9905,10359
42104,30185,35.2,50544,28420,14442,15743
42120,2698,38.2,31848,14803,1315,1383
42122,4360,43.3,75788,30165,2294,2066
42123,910,47.9,36300,16060,458,452
42124,89,22.6,-666666666,3609,60,29
42127,5939,38.3,37093,20743,2880,3059
42129,6812,42.4,32611,17958,3337,3475
42130,125,26.8,32292,12662,81,44
42133,1291,45.6,35282,18269,628,663
42134,16660,39,38370,19203,8087,8573
42140,1280,43.9,27235,18678,670,610
42141,31166,39.7,39271,19850,15049,16117
42151,172,39.7,62750,16175,104,68
42153,169,60.3,27500,20541,78,91
42154,677,46.7,27212,15098,331,346
42156,199,64.7,36458,35295,82,117
42157,245,52.3,28664,29123,103,142
42159,1251,46,52639,27392,726,525
42160,1845,41.3,47411,18243,900,945
42163,94,17.1,-666666666,4599,26,68
42164,16772,39.3,41839,19629,8177,8595
42166,2528,38,29893,15103,1270,1258
42167,8241,42.6,30026,16271,4124,4117
42170,1329,46.3,43750,21604,697,632
42171,6683,35.5,44304,21472,3347,3336
42202,2582,38.9,32052,17344,1166,1416
42204,533,30.6,50216,16633,286,247
42206,5668,39.8,45882,19301,2901,2767
42207,1606,36.9,40278,21182,839,767
42210,3897,43.4,29469,16745,1935,1962
42211,13083,45.8,44226,24876,6540,6543
42214,490,55,42407,26701,237,253
42215,1351,40.2,54978,34589,716,635
42217,3886,39,43750,19860,2083,1803
42220,7061,36.9,41092,17514,3490,3571
42223,20509,21.8,40726,15729,11841,8668
42232,504,46.5,48977,22399,252,252
42234,2673,31.8,43000,16426,1324,1349
42236,648,48.1,45000,25473,259,389
42240,43718,35.6,38883,21623,21301,22417
42254,198,38,36667,19158,99,99
42256,4546,44.9,40274,21027,2414,2132
42259,1122,39.1,26389,19498,594,528
42261,11047,39.7,37132,18234,5486,5561
42262,8343,24.7,35997,16708,4240,4103
42265,1484,30.3,34551,18311,666,818
42266,2336,33.1,43095,20753,1168,1168
42273,357,52.6,48750,29025,178,179
42274,2287,35.5,54615,23467,1238,1049
42275,684,35,23526,14960,339,345
42276,13649,42.9,33900,19244,6703,6946
42280,487,32.3,30500,12632,202,285
42285,388,42.7,58125,26207,120,268
42286,1039,40.2,48382,24391,626,413
42301,42625,39.2,44849,22450,21111,21514
42303,38735,38.6,44872,23042,18055,20680
42320,8512,41.9,40369,18818,4311,4201
42321,245,44.5,8472,5560,99,146
42322,0,-666666666,-666666666,-666666666,0,0
42323,865,40.7,41189,22633,413,452
42324,1380,42.2,36055,17048,683,697
42325,2495,38.7,33807,25022,1242,1253
42326,735,38.4,22386,13820,331,404
42327,4175,38.7,41394,21699,2102,2073
42328,1521,41.4,42977,19696,796,725
42330,9801,40.1,35272,16811,5494,4307
42332,175,43.5,37625,13855,84,91
42333,1110,37.4,29088,13710,567,543
42337,1632,45.2,30000,19216,709,923
42338,115,43.6,49545,28833,56,59
42339,767,49.7,46250,19074,368,399
42343,1937,39,28214,21660,986,951
42344,1157,31.1,27298,14346,561,596
42345,10978,41,43676,23099,5285,5693
42347,6056,39.7,40497,19266,2834,3222
42348,5525,40.1,51857,21847,2889,2636
42349,1198,44,44432,16669,604,594
42350,1509,43.7,37689,20180,693,816
42351,3676,42.1,55920,25382,1850,1826
42352,1921,41,27321,17170,888,1033
42354,244,35,40500,20486,113,131
42355,1828,40.6,54263,23622,902,926
42356,131,79.8,-666666666,9522,0,131
42361,442,36.5,58553,23805,226,216
42366,5847,43.2,63170,26182,2953,2894
42367,582,48.2,36875,20118,298,284
42368,1243,42,43819,20946,629,614
42369,344,44,31875,14765,163,181
42370,0,-666666666,-666666666,-666666666,0,0
42371,538,44.8,55761,24191,299,239
42372,1645,45.6,38929,18557,832,813
42374,150,50.6,30750,24021,64,86
42376,6069,38.2,51111,22124,2904,3165
42378,3104,35.7,49600,19489,1583,1521
42404,2874,36.8,42955,19655,1392,1482
42406,3971,36.6,53704,21869,1984,1987
42408,6416,44.2,37781,23161,3187,3229
42409,2498,37.1,45167,21677,1268,1230
42410,1488,36.5,36190,15449,716,772
42411,1687,49.3,38824,24134,931,756
42413,3559,41.4,72500,27954,1860,1699
42420,37541,39.9,40122,23005,17860,19681
42431,26453,39.7,39377,22236,12809,13644
42436,1011,49.3,56111,26754,560,451
42437,8464,36.5,40726,19041,4668,3796
42440,725,41.8,26944,15770,336,389
42441,1681,32,46909,23378,727,954
42442,3474,41.9,45179,19576,1706,1768
42445,11064,41.3,36187,19722,5297,5767
42450,3706,47.7,31555,20340,1874,1832
42451,1082,39.1,38242,17173,688,394
42452,2308,39.3,65655,22329,1132,1176
42453,635,35.1,35625,16042,289,346
42455,3332,38.1,44974,20553,1736,1596
42456,1438,39.6,47930,21130,698,740
42458,1184,35,72623,24229,567,617
42459,4855,34.7,37854,19649,2249,2606
42461,1369,36.6,43162,17784,630,739
42462,1004,47.8,63355,27295,444,560
42463,131,47.9,45673,20631,62,69
42464,2150,39.6,28977,16700,1109,1041
42501,17964,38.4,28507,17348,8126,9838
42503,23981,41.9,40180,23967,12061,11920
42516,583,33.4,30893,14584,333,250
42518,3052,46.3,34773,23687,1440,1612
42519,2747,51.5,26055,18135,1478,1269
42528,1608,42.3,33060,17935,885,723
42533,904,41.3,36071,15857,421,483
42539,9833,42.2,28784,14863,4823,5010
42541,784,33.4,65938,22955,395,389
42544,5971,46.3,35982,23201,2924,3047
42553,4591,37.4,40769,19863,2275,2316
42565,639,49,33382,20223,321,318
42566,504,48.2,23611,19103,250,254
42567,5911,42.5,27673,14508,3094,2817
42602,10215,40.4,27575,16782,5044,5171
42603,123,45.9,18942,12123,70,53
42629,5471,42.2,32236,16371,2625,2846
42631,85,-666666666,-666666666,,34,51
42633,19865,40.8,28921,16235,9897,9968
42634,1465,48.3,19980,11476,842,623
42635,5078,34.5,17311,8650,3424,1654
42638,225,41,9067,9591,108,117
42642,11772,40.8,29154,17826,5865,5907
42647,4468,35.6,27398,13741,2206,2262
42649,2365,41.6,23561,13487,1275,1090
42653,4210,39.1,19784,12775,1879,2331
42701,48299,38.5,47822,26056,23226,25073
42712,1572,43.4,32225,18084,827,745
42713,1318,41.2,35192,16992,656,662
42715,359,56.1,31979,16040,178,181
42716,1890,37.5,39018,16945,902,988
42717,6711,43.4,30985,16875,3252,3459
42718,23950,40.3,36873,18756,11543,12407
42721,4119,38.6,29400,16843,1886,2233
42722,634,44.9,41302,16779,298,336
42724,4591,39,57565,27027,2256,2335
42726,4796,41.1,32340,19394,2544,2252
42728,15973,39.3,31981,17128,7970,8003
42729,1548,43.2,35195,16513,793,755
42731,153,68.2,34773,52349,79,74
42732,1964,43.9,42188,18490,1017,947
42733,1604,39.7,42545,19036,839,765
42740,1833,47.3,57692,23509,910,923
42741,591,44.7,39583,19224,242,349
42743,9069,43.7,33784,18609,4418,4651
42746,2284,43.6,40016,17413,1225,1059
42748,8147,42.8,37573,20315,4122,4025
42749,5148,37.8,32284,18621,2374,2774
42753,694,32.5,38350,15450,300,394
42754,15476,38.3,31861,19096,7637,7839
42757,2850,46.5,45160,24304,1319,1531
42758,120,26.8,85500,25546,54,66
42762,531,42.3,30500,15664,342,189
42764,462,55.7,50761,17778,185,277
42765,6032,40.2,26807,15111,3062,2970
42776,2939,26.7,40557,16007,1446,1493
42782,1073,43,26776,13200,529,544
42784,2913,37.1,35000,16734,1408,1505
42788,366,40,50688,30012,209,157
43001,2295,46.2,76806,34306,1189,1106
43002,2184,32.9,85338,46269,851,1333
43003,2591,38.3,51189,21206,1268,1323
43004,24350,32.8,71060,34318,11671,12679
43005,178,44.7,19946,13975,92,86
43006,566,33.4,36932,16199,330,236
43008,2456,38,27663,15995,1214,1242
43009,2188,39.5,66136,23253,1169,1019
43010,363,27.2,31827,13455,151,212
43011,7447,39.3,67312,28675,3808,3639
43013,863,45.6,74792,46360,409,454
43014,3790,32.9,44700,19385,1869,1921
43015,49491,36.3,63130,30625,24232,25259
43016,34316,34.4,86446,43821,17013,17303
43017,38568,37.1,94704,49122,19055,19513
43019,9156,37,60690,24673,4422,4734
43021,10615,40.3,118929,41434,5326,5289
43022,4196,22.5,63792,20001,2031,2165
43023,12710,36.6,93932,35558,6006,6704
43025,5817,47,52058,29032,2797,3020
43026,58097,34.3,76813,33049,28221,29876
43028,7686,40.5,58581,28033,3875,3811
43029,509,34.1,33056,19391,276,233
43030,180,54,-666666666,27844,120,60
43031,12447,38.9,72934,29791,6163,6284
43032,118,51.5,24013,14861,72,46
43033,405,41.9,53929,21781,220,185
43035,25705,33,101295,37674,13166,12539
43036,313,32.4,36471,16093,182,131
43037,377,49.5,31250,18480,187,190
43040,32066,36.3,61164,25839,14378,17688
43044,5035,42.4,53456,26769,2627,2408
43045,1790,41.4,65139,25847,919,871
43046,3345,47.6,51294,29854,1675,1670
43050,28612,41.9,42576,23495,13733,14879
43054,20873,34.4,103491,57616,10345,10528
43055,60396,38.6,41981,22534,29099,31297
43056,16911,40.5,48504,26924,8209,8702
43060,2456,38.9,54917,30317,1229,1227
43061,3781,43.6,76094,36804,2005,1776
43062,27354,38.2,69257,29700,13841,13513
43064,12987,39.6,72665,31743,6252,6735
43065,40008,36.2,110031,47078,19549,20459
43066,1346,49.1,90089,35738,766,580
43067,1139,41.2,89118,29509,619,520
43068,52605,34.9,54176,26874,24786,27819
43070,109,78.1,63000,25338,52,57
43071,2363,41.5,48750,19121,1171,1192
43072,5922,40.3,54679,22158,3117,2805
43074,12107,42.2,72243,30954,6143,5964
43076,9316,48.7,50440,26502,4854,4462
43077,264,31.8,55417,18658,144,120
43078,20937,41.3,44259,23172,10133,10804
43080,5947,39.1,55036,23657,3024,2923
43081,56325,36.1,68306,33759,27051,29274
43082,30353,41,110137,47726,14631,15722
43084,854,42,43875,22625,437,417
43085,23107,37.4,77156,41100,10975,12132
43101,385,32.8,30921,12942,206,179
43102,4606,35.3,58391,22043,2434,2172
43103,11440,34,56566,24165,5538,5902
43105,8518,38.9,69216,28703,4312,4206
43106,1651,32.7,44167,16809,864,787
43107,3400,45.1,56725,22402,1530,1870
43109,143,52.3,16936,22242,34,109
43110,33926,34.7,60809,27869,16778,17148
43111,161,22.8,28148,14013,89,72
43112,4310,43.7,72461,29217,2220,2090
43113,23401,42.2,47336,24110,11280,12121
43115,1513,32.9,47100,19788,710,803
43116,1263,32.4,91250,30951,616,647
43117,0,-666666666,-666666666,-666666666,0,0
43119,27892,32.3,56506,24629,13494,14398
43123,58964,38.5,60863,28313,28761,30203
43125,12088,39,54850,28287,5856,6232
43126,388,33.4,37917,20724,187,201
43127,83,49.8,23750,22757,34,49
43128,2306,37.7,39808,19228,1195,1111
43130,59486,39.4,43234,22623,29852,29634
43135,4242,38,38710,17788,2087,2155
43136,635,34.7,52083,21441,267,368
43137,1873,46.4,48530,24998,1069,804
43138,18797,41.3,39735,21079,9063,9734
43140,24114,38.7,54462,21393,14401,9713
43142,177,30.3,32500,13958,109,68
43143,5473,42.9,51651,24850,2627,2846
43144,462,44,45250,18504,224,238
43145,1461,49.6,55556,29128,731,730
43146,13080,38.2,71917,23412,8346,4734
43147,39513,39,86510,34144,19524,19989
43148,2245,31,46071,19070,1009,1236
43149,3234,37.7,56458,22199,1706,1528
43150,2700,32.5,54219,21731,1297,1403
43151,304,28.5,59583,18033,165,139
43152,883,35.9,25833,15196,397,486
43153,969,36.4,52614,18386,504,465
43154,3230,34.3,51277,24109,1518,1712
43155,2174,47.9,58207,25103,1142,1032
43156,235,37.5,31250,15736,122,113
43157,606,32.6,27614,13239,263,343
43158,312,51.2,53125,19190,172,140
43160,22281,41,35968,20722,10914,11367
43162,6904,42.4,55965,27564,3350,3554
43164,2477,34.5,51292,21525,1367,1110
43201,29389,22.4,21086,15825,16164,13225
43202,20340,27.6,40904,26199,11187,9153
43203,7297,32.3,18763,12932,3533,3764
43204,40262,32.8,40815,20817,20149,20113
43205,12434,34.8,24779,17684,6631,5803
43206,22723,35.5,40720,30821,11156,11567
43207,46253,37.3,39348,18652,22683,23570
43209,28232,37.6,54653,36338,13777,14455
43210,10860,19.3,17137,3393,5594,5266
43211,21997,29.7,21908,11443,10065,11932
43212,18266,30.7,51585,39152,8935,9331
43213,31510,35.9,34521,22237,14960,16550
43214,26441,41.2,60547,36470,12781,13660
43215,12410,30.8,44985,43646,6549,5861
43217,2593,22.8,30556,10691,1361,1232
43219,28137,31.5,34267,17684,12979,15158
43220,25362,37,58199,42755,12523,12839
43221,33315,36.4,81343,43434,16096,17219
43222,4597,26.9,20989,10764,2133,2464
43223,25786,33.8,31143,14346,13041,12745
43224,36772,34.4,33598,18175,17563,19209
43227,22350,37.3,35995,17997,10464,11886
43228,52522,30.9,39894,20660,25043,27479
43229,47084,34.2,37518,20696,22910,24174
43230,52819,36.4,65785,34721,25333,27486
43231,18998,33.1,44962,22922,9024,9974
43232,42762,33.5,37971,18910,20196,22566
43235,40709,35.9,64666,36396,19488,21221
43240,3730,31.9,65236,34056,1574,2156
43302,54800,40.2,39591,19377,29571,25229
43310,3516,38.5,54552,22369,1821,1695
43311,19361,38.5,46706,23146,9253,10108
43314,3093,37,59605,26028,1492,1601
43315,7166,42.4,51624,22553,3487,3679
43316,5951,40.4,40528,21038,3080,2871
43317,188,32.8,40769,16089,93,95
43318,4294,29.3,42277,17824,2118,2176
43319,850,43.8,68550,30869,384,466
43320,1572,39.7,59688,22552,781,791
43321,257,36.5,36591,16176,101,156
43322,383,41.3,41125,19513,189,194
43323,782,37.1,53162,18636,367,415
43324,2297,51.4,58438,28655,1161,1136
43326,13399,39.6,39402,20389,6480,6919
43330,98,34.4,35833,26020,42,56
43331,4479,53.9,36729,22214,2196,2283
43332,1638,46,39423,23274,798,840
43333,897,43.7,44063,24870,528,369
43334,6457,44,52593,23237,3280,3177
43336,0,-666666666,-666666666,-666666666,0,0
43337,1363,43.1,56875,23619,666,697
43338,10368,40.3,47999,21678,5149,5219
43340,2164,27.2,52727,16223,1093,1071
43341,1113,39,58674,31211,553,560
43342,3171,38.6,66853,26249,1538,1633
43343,1551,26.5,38772,16166,843,708
43344,5484,35.1,50739,24150,2902,2582
43345,863,47.1,39107,19900,434,429
43347,1484,35,54397,22198,706,778
43348,1949,39.2,32609,17690,970,979
43351,10691,42.8,41850,22940,5138,5553
43356,994,46.9,53904,34540,493,501
43357,4577,39.6,58692,25998,2107,2470
43358,3125,34.2,51995,20580,1607,1518
43359,719,44.6,62549,24342,370,349
43360,1469,35.2,56250,24952,697,772
43402,32020,28.8,39315,24729,15807,16213
43403,5842,19.4,-666666666,2812,2530,3312
43406,1745,36,47434,19589,840,905
43407,881,41.8,51734,19419,372,509
43408,290,35,36250,16971,137,153
43410,10410,40.1,48679,24672,5190,5220
43412,4304,42.6,64013,30401,2144,2160
43413,1408,41.7,63250,21102,787,621
43416,3005,40.8,51250,22932,1296,1709
43420,30461,41.5,44250,22230,14856,15605
43430,4828,43.5,64783,29419,2519,2309
43431,4517,39.7,42981,20650,2362,2155
43432,1350,45.8,71593,27676,684,666
43433,96,22.6,-666666666,7668,64,32
43434,250,30,36250,12001,91,159
43435,1264,39.7,52227,25576,723,541
43437,473,32.2,39688,16829,216,257
43438,177,60.2,50625,51033,99,78
43439,90,64.4,23482,10586,35,55
43440,4897,57.6,53490,36255,2434,2463
43442,1153,41.5,43950,20743,612,541
43443,1801,37.5,59330,27089,949,852
43445,1171,41.8,49811,23143,602,569
43446,135,66.2,61250,54827,69,66
43447,3466,40.4,53480,26210,1459,2007
43449,8584,44.7,51891,25536,4533,4051
43450,3827,42.9,56591,25588,1904,1923
43451,1001,38.4,55313,26741,499,502
43452,13659,46.1,48135,27572,6621,7038
43456,536,54.9,47344,38389,287,249
43457,1343,42.9,46518,20190,665,678
43458,312,44,47500,22847,166,146
43460,6334,39.2,49888,26882,3070,3264
43462,1075,45.1,49414,26875,570,505
43463,16,-666666666,-666666666,,8,8
43464,1464,44.3,52838,23999,764,700
43465,5267,40.8,45549,23294,2723,2544
43466,2381,34.2,63975,25211,1289,1092
43467,104,31.1,26932,20797,39,65
43468,403,52.7,70781,23064,193,210
43469,3043,39.7,53988,27681,1482,1561
43501,712,45,51053,20523,393,319
43502,6765,38.5,50997,26416,3023,3742
43504,1345,48.4,69263,31441,738,607
43505,61,42.1,37083,24221,37,24
43506,14604,42.5,43868,22785,7134,7470
43511,757,46.9,53056,29064,403,354
43512,28349,39.6,48614,23512,14176,14173
43515,8213,39,52026,25296,4051,4162
43516,2938,36.2,48966,21586,1418,1520
43517,3755,42.2,51250,25428,1783,1972
43518,2831,41,43092,19897,1382,1449
43519,89,62.1,29688,21134,49,40
43521,2786,47.5,41757,22663,1424,1362
43522,3000,42.5,58854,28339,1461,1539
43523,0,-666666666,-666666666,-666666666,0,0
43524,1207,46.6,59444,21751,587,620
43525,1179,30.7,61786,26579,551,628
43526,5598,35.3,41168,18710,2700,2898
43527,2219,41.3,53409,22685,1092,1127
43528,16076,40.1,56861,33613,8132,7944
43529,250,34.2,48750,15858,127,123
43531,134,55.2,23563,11684,81,53
43532,4295,34.5,49274,20432,2108,2187
43533,1475,39.4,51875,22567,775,700
43534,1822,38.3,41250,18617,931,891
43535,712,39.2,42330,21031,353,359
43536,607,35.9,47159,17572,320,287
43537,26812,40.6,60078,31617,13366,13446
43540,1669,37,66507,25610,711,958
43541,152,38.8,35179,16070,71,81
43542,4020,39.8,112653,39406,1826,2194
43543,8105,38.5,40980,19633,3951,4154
43545,14320,41.1,50507,24961,7067,7253
43547,378,59.7,49500,22390,187,191
43548,608,47.6,53636,23415,308,300
43549,1443,42.1,60469,24072,762,681
43551,36884,40,66847,34567,17784,19100
43553,192,45,37222,16916,79,113
43554,2640,40.5,41888,21063,1312,1328
43555,106,57.5,44479,27265,71,35
43556,2075,35.2,46541,21096,970,1105
43557,3262,40.3,48306,19011,1934,1328
43558,13077,44.6,54557,26392,6730,6347
43560,32422,40.2,75869,35555,15822,16600
43565,368,40.1,50500,21602,198,170
43566,8038,41.2,71631,31745,3889,4149
43567,13007,38.6,51935,23820,6462,6545
43569,2904,38.8,49554,21694,1511,1393
43570,3252,42.1,47889,22916,1518,1734
43571,7037,39,75625,29715,3257,3780
43604,9017,28.3,12149,12540,4146,4871
43605,27546,31.7,24933,12858,13796,13750
43606,24628,33,40306,24691,11647,12981
43607,24717,30.4,24565,14346,12081,12636
43608,15988,34.4,26510,12404,8172,7816
43609,23343,32.7,25139,14178,11868,11475
43610,4695,36.8,26791,18194,2237,2458
43611,19176,40.3,41233,21249,9425,9751
43612,31144,32.8,39165,18312,15602,15542
43613,31616,36.9,44883,22147,15490,16126
43614,29803,40.2,46019,25352,13804,15999
43615,39363,35.9,38409,25036,17512,21851
43616,21034,43,55451,28161,10220,10814
43617,6882,46.8,76304,39504,3187,3695
43619,7789,40.3,50895,23686,3763,4026
43620,5907,41.5,17174,18050,2888,3019
43623,20387,42.8,45513,30188,9603,10784
43701,55568,40.6,37061,20739,26897,28671
43711,29,13.7,-666666666,,20,9
43713,7193,43.6,42645,22655,3656,3537
43716,1604,49.5,46094,23333,822,782
43717,227,40,23542,13018,126,101
43718,3727,41.3,48431,21213,1983,1744
43719,2694,36.4,42313,19803,1294,1400
43720,989,53.1,34625,22540,544,445
43721,34,-666666666,-666666666,,17,17
43722,360,38.4,29565,12872,170,190
43723,4821,38.7,32716,17253,2345,2476
43724,9312,41.9,38350,18297,5869,3443
43725,20308,43.4,37602,22317,9966,10342
43727,1330,40.8,62966,20707,649,681
43728,1204,40.9,33529,15180,576,628
43730,2575,33.9,39306,15884,1238,1337
43731,5792,37.4,36559,16960,2907,2885
43732,1876,46.3,45952,23731,961,915
43733,275,25.3,26402,18390,233,42
43734,1273,35,55592,26339,516,757
43735,286,48.8,40550,15888,134,152
43736,61,49.1,23438,15703,33,28
43738,142,36.4,43750,18616,69,73
43739,1898,33,52262,21587,967,931
43740,497,38.5,23750,13826,265,232
43746,1594,49,57889,30129,734,860
43747,1216,29.5,46037,15617,626,590
43748,2818,42.8,42679,17793,1525,1293
43749,2398,39.9,28795,16433,1108,1290
43750,109,55.4,64250,26232,43,66
43754,1624,38,57721,23442,856,768
43755,1399,49.6,47273,24039,749,650
43756,5282,47.7,32631,19076,2521,2761
43758,3517,39.5,43438,19770,1831,1686
43759,41,46.2,29583,23949,14,27
43760,1427,42.9,57364,26162,677,750
43761,83,45.2,-666666666,24983,42,41
43762,5851,28.6,49659,19170,2748,3103
43764,8327,34.8,37334,18388,3870,4457
43766,1618,37.9,28641,13856,759,859
43767,1439,37.8,46830,19891,724,715
43768,290,39.1,43125,19280,133,157
43771,1807,41.4,37097,17300,870,937
43772,1765,50.3,41250,19625,906,859
43773,3155,37.2,41236,18422,1654,1501
43777,4621,35.1,33519,15350,2306,2315
43778,1702,37.7,53333,19372,846,856
43779,815,54.7,38015,20098,484,331
43780,1750,42.7,37647,20176,836,914
43782,738,35.9,32604,14805,368,370
43783,4977,37,48750,19795,2437,2540
43786,26,50.5,32083,19773,13,13
43787,2487,44.7,35409,19705,1223,1264
43788,967,41.3,54500,19357,532,435
43793,4969,50,34980,22010,2407,2562
43802,1072,41.1,42500,17251,468,604
43804,3750,25.4,36841,12923,1917,1833
43805,66,55.9,49018,30027,44,22
43811,708,39.5,40242,18387,320,388
43812,19637,42.1,36449,20966,9465,10172
43821,4164,38.8,42052,20450,2001,2163
43822,5048,43.2,46094,19720,2592,2456
43824,3387,33,44741,17551,1737,1650
43830,6374,35.5,51648,23722,3102,3272
43832,7585,43.9,43813,19816,3854,3731
43836,142,55.1,42083,26485,68,74
43837,1943,40.1,45357,18989,964,979
43840,1098,47.3,50568,23956,589,509
43842,197,39.3,51339,18923,94,103
43843,1576,30.9,44531,15867,773,803
43844,3628,41.3,48889,20358,1872,1756
43845,4828,42.8,45303,19911,2350,2478
43901,2427,50,42863,24722,1255,1172
43902,204,72.8,46199,26554,97,107
43903,2116,49.2,38969,20081,1091,1025
43905,187,37.9,20139,14845,108,79
43906,8497,43.3,34176,19583,4106,4391
43907,6107,43.4,40696,20126,2912,3195
43908,1696,45.9,37721,19269,836,860
43910,3411,45.1,53427,24838,1676,1735
43912,6972,44.3,31004,19679,3392,3580
43913,1542,47.6,40275,22135,682,860
43914,11,-666666666,-666666666,,5,6
43915,1477,47.5,38438,22131,667,810
43917,3116,48.4,42650,21361,1470,1646
43920,23340,43.4,35817,21384,10823,12517
43925,168,22.7,-666666666,22334,140,28
43926,246,36.5,38750,20756,123,123
43927,59,30.9,-666666666,18819,35,24
43928,117,32.2,-666666666,,89,28
43930,819,47.5,47500,23801,449,370
43931,132,52.6,52625,21293,57,75
43932,898,34.7,38523,19006,505,393
43933,2162,44.3,42163,20910,1142,1020
43934,237,60.1,14091,14876,77,160
43935,8733,43.6,34268,22301,4132,4601
43938,5551,43.5,42367,20468,2827,2724
43939,558,40.1,33750,19670,213,345
43940,451,44.8,50650,21772,173,278
43942,2486,37.4,46504,24053,1308,1178
43943,3368,45.4,39306,21880,1620,1748
43944,2578,46.4,42193,22500,1335,1243
43945,3169,39.5,39394,22161,1623,1546
43946,2369,45.9,41760,20951,1199,1170
43947,5202,48.3,43879,24039,2387,2815
43948,539,49.1,39531,19033,261,278
43950,16670,42.7,51570,25427,9351,7319
43951,221,62.7,21076,18786,100,121
43952,18558,40,32045,19679,8583,9975
43953,11823,47.1,45035,27850,5647,6176
43961,266,50.1,27188,19479,107,159
43962,136,27.3,27500,16035,72,64
43963,1314,44.5,37629,21445,590,724
43964,9354,44.1,44468,22505,4439,4915
43967,0,-666666666,-666666666,-666666666,0,0
43968,7163,43.9,37889,21396,3529,3634
43970,0,-666666666,-666666666,-666666666,0,0
43971,1175,43.2,36250,21195,570,605
43972,172,46.5,105900,25737,85,87
43973,2323,36.4,34342,15167,1163,1160
43974,76,33,26563,19837,51,25
43976,1707,47.6,42969,24403,799,908
43977,2342,43.9,42930,22866,1194,1148
43983,469,43,23618,13390,257,212
43985,177,24.6,43125,15080,84,93
43986,2245,37.1,37266,16213,1158,1087
43988,2189,47.6,33343,21542,1068,1121
44001,20358,44.3,63722,27999,9972,10386
44003,4962,41.4,38076,17425,2414,2548
44004,33250,42.1,34150,19659,15791,17459
44010,1891,36.6,64286,23627,941,950
44011,21440,40.8,82603,41876,10538,10902
44012,22708,42.5,80271,40049,11160,11548
44017,19266,38.4,56199,25641,9463,9803
44021,6052,39,56767,23196,2985,3067
44022,16655,47.6,87135,62552,7969,8686
44023,17374,45.5,98562,47952,8375,8999
44024,23430,44,64572,31427,11389,12041
44026,11218,46.9,77316,34517,5481,5737
44028,8380,45.2,69007,30338,4292,4088
44030,16875,39.5,39432,17936,9435,7440
44032,1628,35.3,44032,15786,777,851
44035,63911,38.8,43449,22006,31074,32837
44039,30216,41.8,67127,30428,14850,15366
44040,3191,50.4,121136,67742,1672,1519
44041,14766,43.2,44287,21602,7499,7267
44044,15509,42.5,63834,22733,9752,5757
44045,375,38.1,48750,19988,179,196
44046,2339,41.3,66890,26826,1165,1174
44047,9208,43.9,48197,23606,4406,4802
44048,2843,46,45559,20711,1221,1622
44049,286,34,49286,23877,166,120
44050,6323,42.3,64514,26776,3151,3172
44052,29946,35.2,29448,16665,14015,15931
44053,17551,44.1,43855,25609,8228,9323
44054,12707,43.1,51077,24649,6300,6407
44055,20373,33.7,30792,15156,9473,10900
44056,11326,43.5,80953,39062,5562,5764
44057,19780,41.3,50648,24345,9724,10056
44060,60780,45,64446,32721,29182,31598
44062,15293,25,46379,15350,7639,7654
44064,1676,41.9,65972,28804,876,800
44065,4487,46.7,56005,32006,2170,2317
44067,20457,43.6,67917,33964,9606,10851
44070,32818,45.3,59288,30095,16043,16775
44072,4227,50.9,64115,49214,2108,2119
44074,11829,31.6,55634,22586,5661,6168
44076,4599,30.8,40805,16807,2160,2439
44077,56334,38.7,55681,27036,27760,28574
44080,129,47.8,70069,32082,60,69
44081,6779,43,61217,26565,3402,3377
44082,1354,34.5,39122,16310,681,673
44084,3623,43.5,52406,25350,1931,1692
44085,3227,46.8,49805,23191,1750,1477
44086,2277,45.9,54213,26377,1103,1174
44087,20030,40.4,67840,36104,9692,10338
44089,15938,46.5,51442,27395,7755,8183
44090,11467,42.2,59867,25984,5565,5902
44092,16754,43.4,47352,26450,7987,8767
44093,1104,37.8,32344,20559,446,658
44094,35334,44.1,56278,33286,17444,17890
44095,33613,43.9,50685,26653,16456,17157
44099,1836,36.7,60658,19460,1082,754
44101,715,18.1,-666666666,5630,89,626
44102,44026,33.2,24609,15648,21310,22716
44103,17990,41.7,18411,12804,8636,9354
44104,23307,28.6,14603,9194,10378,12929
44105,37857,35.9,25441,14418,17803,20054
44106,26373,28.7,22602,21901,12073,14300
44107,51899,34.8,43190,27810,25192,26707
44108,25355,36.9,23174,17488,12064,13291
44109,41372,36.4,30139,16725,20263,21109
44110,21133,37.7,21764,13134,9784,11349
44111,40321,38.8,39473,22172,19690,20631
44112,22593,41.8,22220,14776,10511,12082
44113,18933,32.4,32682,28065,10392,8541
44114,5130,32.9,22180,28836,2634,2496
44115,7502,23.5,12457,12536,3356,4146
44116,20170,46.2,67645,45136,9434,10736
44117,10367,46.8,26028,20746,4512,5855
44118,39767,34.9,54635,30846,18230,21537
44119,12435,41.3,42590,24044,5887,6548
44120,36313,39.5,29643,25540,16277,20036
44121,33252,37.2,53095,26685,15463,17789
44122,34654,45.8,74054,48811,15735,18919
44123,16675,40.2,40819,23685,7867,8808
44124,37971,44.1,55969,38421,17619,20352
44125,28633,40.7,43693,22187,13162,15471
44126,16641,41.9,52988,30495,7997,8644
44127,4581,37.9,17891,12213,2298,2283
44128,29667,42.4,32691,18297,13260,16407
44129,29260,38.1,50296,23623,14237,15023
44130,50416,44,48212,26547,24251,26165
44131,20361,48.3,66845,33940,10060,10301
44132,14883,34.4,37229,21115,6708,8175
44133,30335,43.6,66609,34268,14922,15413
44134,37945,43.7,49141,24806,18232,19713
44135,28131,39.7,38039,20237,13829,14302
44136,25775,42.9,71537,36334,12492,13283
44137,23080,40.7,36689,19417,10347,12733
44138,21907,42.6,68311,31333,10681,11226
44139,24154,43.5,96750,46768,11831,12323
44140,15550,43.7,83679,43498,7428,8122
44141,13875,47,89920,49412,6902,6973
44142,19126,43,49010,23893,9184,9942
44143,24044,48.5,60265,34714,11236,12808
44144,21654,40.4,41674,22879,10511,11143
44145,32552,45.1,76358,46684,15078,17474
44146,29676,43.1,41850,23537,13920,15756
44147,19331,42.1,76021,37217,9206,10125
44149,18894,46,82540,38854,9179,9715
44201,6456,47.5,54871,24706,3203,3253
44202,19598,45,79805,40071,9415,10183
44203,41346,41,44205,22680,19712,21634
44212,43937,39.3,65113,28682,21425,22512
44214,2083,40.7,60169,25555,931,1152
44215,2288,40.2,51048,25747,1205,1083
44216,9665,42.3,66565,28818,5093,4572
44217,4031,39.4,48719,21028,1952,2079
44221,29875,37.3,45773,23968,14594,15281
44223,18266,42.4,58071,31553,8699,9567
44224,38443,40.2,63111,32582,18212,20231
44230,8161,46.2,51944,28081,4053,4108
44231,8625,40,49814,22192,4310,4315
44233,7714,46.7,78507,37644,3883,3831
44234,4234,35.2,56103,24306,2102,2132
44235,2070,31.9,52069,18959,985,1085
44236,25277,43.3,112794,49253,12370,12907
44240,41288,27.5,41997,24181,19890,21398
44241,16214,37.6,60196,27341,7968,8246
44243,4239,19.4,-666666666,3285,1639,2600
44250,1163,43.3,34313,20652,629,534
44251,905,52.6,73021,47881,447,458
44253,3241,46.5,74662,29826,1722,1519
44254,4809,43.3,47569,22958,2443,2366
44255,8416,41.6,51950,24615,4114,4302
44256,62303,40.2,71378,32693,30597,31706
44260,13152,42.4,56798,26052,6507,6645
44262,4981,42.8,64628,35059,2512,2469
44264,2571,47,75134,36924,1266,1305
44265,0,-666666666,-666666666,-666666666,0,0
44266,33702,40.3,48952,22933,16648,17054
44270,8784,40.4,49835,25333,4142,4642
44272,5115,38.1,62083,24053,2483,2632
44273,6704,44.5,65368,30043,3295,3409
44274,143,46.4,23472,15656,46,97
44275,3264,39.3,59583,24577,1717,1547
44276,1879,40.2,52330,24753,950,929
44278,17844,45.8,55360,28370,8594,9250
44280,4476,48.2,71929,34967,2197,2279
44281,30231,40.3,60860,29567,14670,15561
44285,68,36.2,-666666666,13018,46,22
44286,5942,48.4,84179,44236,2888,3054
44287,7806,38.4,49839,20342,3990,3816
44288,3829,37.5,39653,17979,1851,1978
44301,15700,33.1,35821,20217,7693,8007
44302,6119,36.1,25500,17517,2929,3190
44303,7635,44,48065,34225,3762,3873
44304,5611,21,20114,10999,3303,2308
44305,21899,37.6,36944,18868,10872,11027
44306,22348,32.7,25128,13889,10448,11900
44307,5830,42.6,15900,14921,2594,3236
44308,735,36.3,8536,9887,431,304
44310,23362,35.6,31668,16762,11869,11493
44311,9107,23.3,15945,10106,4451,4656
44312,31874,42.9,46260,23540,15669,16205
44313,24611,41,48852,31436,10920,13691
44314,18950,38.7,34268,17697,8803,10147
44319,22616,44.3,54834,29480,11406,11210
44320,21228,39.3,31559,18168,10023,11205
44321,14933,38.4,75000,39404,7414,7519
44333,18541,48.2,77530,47435,8793,9748
44401,2818,47.9,61654,27498,1491,1327
44402,2924,40.6,56074,22466,1485,1439
44403,4003,50.8,40272,24401,2029,1974
44404,1708,50,48189,21101,849,859
44405,8138,40.5,32835,17781,4050,4088
44406,21622,44.3,67320,36541,10714,10908
44408,10422,46.2,48480,22758,5041,5381
44410,17331,46.2,52778,29519,8260,9071
44411,2082,41.2,54103,21930,970,1112
44412,2620,43.9,58929,29145,1334,1286
44413,7588,42.3,41274,21337,3626,3962
44417,1596,45,55250,24604,744,852
44418,1464,39.3,71667,25389,769,695
44420,15368,41.2,44234,22574,7186,8182
44423,2893,38.1,47992,19744,1377,1516
44425,14675,46.2,43161,24308,7161,7514
44427,1510,37.8,51607,18869,682,828
44428,2873,48.7,44082,22167,1449,1424
44429,2551,46.8,49432,27572,1313,1238
44430,5520,36,39753,17199,3420,2100
44431,4597,44.5,42426,21118,2359,2238
44432,13213,42.7,45636,19245,7957,5256
44436,3692,46.7,49435,24627,1765,1927
44437,4127,40.7,49105,23892,2011,2116
44438,4443,44.2,30574,17334,2196,2247
44439,61,34,-666666666,,15,46
44440,4915,44,56116,27044,2503,2412
44441,1630,42.6,55625,30360,734,896
44442,4132,48.8,51481,33144,2003,2129
44443,1945,44,38750,21387,936,1009
44444,10489,44.3,43864,22812,5094,5395
44445,3175,46.5,46190,25028,1568,1607
44446,20310,43.9,37428,20627,9756,10554
44449,1292,46.5,53413,21798,647,645
44450,2733,38.6,52567,19102,1433,1300
44451,3146,49,61236,27487,1619,1527
44452,2861,47.3,37238,20653,1445,1416
44454,900,46.1,45676,22761,416,484
44455,1836,41.6,62625,25213,1004,832
44460,26710,42.4,44775,23107,13065,13645
44470,3859,45.3,51815,23795,2010,1849
44471,11024,41.6,37282,19408,5387,5637
44473,3769,48.9,43622,26993,1762,2007
44481,10819,46,48076,23076,5885,4934
44483,26047,42,36937,20592,12202,13845
44484,23136,43.7,47857,26119,10646,12490
44485,15777,37.4,27814,15604,7178,8599
44490,814,35.8,34643,18510,409,405
44491,3248,34,57083,19841,1758,1490
44493,43,-666666666,-666666666,,21,22
44502,10219,34.4,22695,11516,4862,5357
44503,914,41.3,10587,9383,617,297
44504,5303,34.3,31132,17931,2531,2772
44505,20138,40.6,29777,16502,10518,9620
44506,1965,45.4,16185,10689,1011,954
44507,5536,37.9,20432,11168,2578,2958
44509,12532,39.2,26125,17505,5753,6779
44510,2543,35.5,13917,9907,1286,1257
44511,19935,45,39966,22525,9321,10614
44512,34019,43.6,46577,28733,15921,18098
44514,22095,47.2,56379,33374,10772,11323
44515,27381,42.8,42678,23338,13143,14238
44601,34527,40.4,36595,18897,16872,17655
44606,7571,28.2,50354,17290,3953,3618
44607,114,51.1,85526,30132,56,58
44608,2638,39.3,52500,23210,1345,1293
44609,4127,41.5,45958,21281,2066,2061
44610,298,22.7,50911,16947,244,54
44611,1886,43,53638,24031,971,915
44612,5379,42.6,54714,28009,2676,2703
44613,2247,41.7,39743,21275,1036,1211
44614,12454,42.3,53766,24762,6087,6367
44615,11144,39.9,42314,19469,5498,5646
44618,6771,42,53963,25377,3271,3500
44620,1717,44.3,42425,24070,853,864
44621,4652,40.9,42869,20478,2332,2320
44622,18427,41.9,45166,24054,8596,9831
44624,6179,23.1,54479,15291,3043,3136
44625,1278,32.6,37228,17362,677,601
44626,2957,46.4,59483,27214,1591,1366
44627,7799,20.1,45913,12698,4085,3714
44628,1026,38.9,43370,17375,518,508
44629,2707,35.9,43545,19101,1427,1280
44632,10012,40.5,59798,28510,4807,5205
44633,2816,29.9,56944,20476,1499,1317
44634,2127,44,53750,23328,1037,1090
44637,2674,39.7,43698,20883,1229,1445
44638,1581,44.4,55298,24668,699,882
44640,269,30.1,26894,12729,203,66
44641,20377,44.7,53795,26392,9690,10687
44643,3305,44.9,51769,25993,1764,1541
44644,4683,49.1,45394,26451,2391,2292
44645,2502,45,62644,29279,1236,1266
44646,46219,42,46571,25477,22781,23438
44647,18850,42.3,44608,22360,9284,9566
44651,707,35.9,42917,18320,377,330
44652,0,-666666666,-666666666,-666666666,0,0
44653,752,33.1,40179,18140,403,349
44654,19256,30.2,44866,17755,9697,9559
44656,3009,43.5,48457,20644,1547,1462
44657,10943,41.7,47277,21313,5232,5711
44659,168,28.2,36250,17694,63,105
44661,260,29.5,31776,11690,148,112
44662,9461,45.4,44214,22149,4553,4908
44663,25049,43,42778,22680,12478,12571
44666,3264,38.4,55500,26136,1692,1572
44667,14249,37.8,44322,20975,7277,6972
44669,1240,51,59559,31617,631,609
44670,315,48.2,55772,24298,190,125
44671,274,54.5,38750,26245,105,169
44672,4769,48.3,35817,22059,2057,2712
44675,2179,51.4,46818,26679,1203,976
44676,4807,40.3,54632,21227,2273,2534
44677,2523,40.2,52014,22477,1249,1274
44678,28,-666666666,-666666666,,15,13
44680,4285,45.1,48500,23903,2153,2132
44681,7697,32,48101,19843,3704,3993
44682,935,38.9,53456,26764,435,500
44683,8292,39.6,34218,16920,4000,4292
44685,28116,41.2,68935,30378,14119,13997
44687,161,73.2,-666666666,16478,117,44
44688,3067,45.3,42839,20615,1625,1442
44689,525,35.7,34549,18683,257,268
44690,181,23.7,33618,14738,67,114
44691,42807,39.5,45997,24785,20826,21981
44693,52,40,18036,13448,21,31
44695,1640,46.9,38500,25309,827,813
44697,181,51.9,61875,34833,97,84
44699,607,52.8,33333,22379,320,287
44702,1014,47.2,14152,16368,438,576
44703,8862,32.3,24739,14930,4465,4397
44704,3826,35.5,24266,13106,1845,1981
44705,18581,37.3,31549,15824,8788,9793
44706,18558,39.6,39471,18808,9057,9501
44707,8794,39.4,23343,16288,3941,4853
44708,25341,42.8,44731,26042,11700,13641
44709,19019,41.2,42849,24673,8497,10522
44710,9640,34.5,33140,16338,4580,5060
44714,9249,44.2,43781,23904,4551,4698
44718,11642,48.2,73935,47371,5519,6123
44720,39118,43.7,58949,31937,19113,20005
44721,13381,40.3,57786,26473,6545,6836
44730,6339,41,51512,22897,3166,3173
44802,953,43.5,60179,26535,474,479
44804,1097,38.2,60625,29494,541,556
44805,32524,39.1,45644,23367,15872,16652
44807,2461,40.8,53750,22277,1261,1200
44809,171,57.4,58750,28399,74,97
44811,12944,38.5,49561,23700,6378,6566
44813,7478,41.4,46120,23287,3756,3722
44814,2800,41.2,63438,24073,1317,1483
44815,568,51.4,37813,19999,286,282
44816,55,69.6,-666666666,30107,19,36
44817,1587,41.1,55772,24501,756,831
44818,2490,40.4,50417,23078,1305,1185
44820,17763,45.1,40250,21890,8728,9035
44822,3053,39.7,55958,22485,1647,1406
44824,3673,46.7,51594,27700,1822,1851
44825,58,23.1,45833,15571,20,38
44826,1578,47.3,51442,22344,806,772
44827,7053,40.4,42260,21712,3571,3482
44828,23,70.6,-666666666,26870,14,9
44830,18665,38.9,40328,19870,9125,9540
44833,16997,41.2,38371,18883,8075,8922
44836,2752,38.4,49833,20884,1374,1378
44837,4522,35.5,52364,22076,2264,2258
44838,165,58.4,39732,21356,75,90
44839,12586,45.8,54200,30147,5980,6606
44840,3721,35.9,52000,21014,1769,1952
44841,724,38.9,58438,25598,394,330
44842,5513,41.6,45016,19850,2770,2743
44843,2487,38.9,53281,26522,1333,1154
44844,450,44.8,52321,25189,204,246
44846,3148,45.4,69214,33868,1562,1586
44847,3655,39.1,51920,23341,1924,1731
44849,2386,34.5,51029,21215,1245,1141
44850,35,69.5,21354,27860,12,23
44851,5169,37.9,46919,21065,2535,2634
44853,1308,41.1,59306,29269,720,588
44854,1712,42.7,45776,23990,767,945
44855,1351,36.6,52083,22393,604,747
44856,79,55.9,25625,21158,50,29
44857,23499,39.6,45048,22746,11404,12095
44859,1161,43.3,45125,19513,523,638
44861,47,33.4,75500,32745,33,14
44864,3195,41.8,48153,20648,1663,1532
44865,3519,36.8,47778,21967,1750,1769
44866,2426,37.7,51190,16239,1201,1225
44867,2294,42.1,59268,27746,1280,1014
44870,41126,40.7,40944,23915,20153,20973
44874,373,30.2,36250,12918,173,200
44875,13700,42,44636,24050,6764,6936
44878,3074,34.9,51337,20406,1390,1684
44880,3118,39.2,43368,17246,1538,1580
44881,28,54.4,-666666666,16504,18,10
44882,2916,44.6,56337,28979,1505,1411
44883,29438,39.8,40847,22109,14436,15002
44887,1192,43.6,77361,27978,634,558
44889,6699,43.9,62926,25599,3432,3267
44890,11348,37.6,49393,21416,5568,5780
44901,2552,30.7,-666666666,864,2543,9
44902,5392,37.7,28955,13845,3082,2310
44903,24720,42.4,40825,22322,12076,12644
44904,14135,42.2,56010,27645,6559,7576
44905,14188,39.5,41196,18405,8273,5915
44906,17031,44.9,35317,22243,7949,9082
44907,14572,42.6,36924,22868,6538,8034
45001,570,37,38571,16042,349,221
45002,13227,36.1,60718,27560,6731,6496
45003,645,41.4,49219,23553,344,301
45005,29997,40.5,52016,24292,14776,15221
45011,68475,34.4,60757,25664,33863,34612
45013,53697,41.4,51452,25062,25747,27950
45014,44172,38.8,56054,28561,21755,22417
45015,11893,36.6,39538,19899,5748,6145
45030,17854,39.1,61960,27785,8765,9089
45032,291,39.9,50833,26943,171,120
45033,389,21.5,44306,18222,212,177
45034,1051,35.5,86510,32053,584,467
45036,38476,36.9,68633,27591,21263,17213
45039,23034,34.7,81812,37521,11153,11881
45040,51469,36.8,88395,39258,24848,26621
45041,0,-666666666,-666666666,-666666666,0,0
45042,26623,43.4,48481,25764,13074,13549
45044,52064,35.2,46006,22741,25615,26449
45050,9080,35.5,66682,28285,4336,4744
45051,179,83.5,-666666666,6709,9,170
45052,4720,44.5,74725,31864,2474,2246
45053,3075,46.1,77361,31705,1541,1534
45054,2209,41.1,67721,35873,1094,1115
45056,27537,21.7,40507,19709,13729,13808
45062,658,44.1,38068,19890,305,353
45064,2827,44.2,55170,23848,1451,1376
45065,5065,35.1,46133,26512,2488,2577
45066,24517,39.1,95500,38336,12120,12397
45067,13886,32.2,58853,23860,6806,7080
45068,10760,41,70797,30337,5594,5166
45069,49559,38.6,84010,37794,24327,25232
45070,230,41.3,42500,22657,123,107
45101,2504,42.1,28094,16352,1272,1232
45102,22586,34.8,56737,24764,11484,11102
45103,31906,38.4,56301,27235,15858,16048
45106,12486,40.5,47603,21476,6063,6423
45107,8768,41.8,48605,22061,4582,4186
45111,423,36.6,73077,24600,235,188
45112,52,52.3,26875,11652,27,25
45113,3581,44.9,63714,30571,1836,1745
45115,60,44.2,16389,20320,37,23
45118,3769,39.5,50441,20824,1988,1781
45120,2964,41.8,48438,22714,1374,1590
45121,9280,41.1,37376,20051,4464,4816
45122,11388,38.5,52507,22148,5750,5638
45123,8680,39.9,33649,17078,4300,4380
45130,3904,44.5,58036,21117,1968,1936
45131,273,46.3,21607,13726,153,120
45132,222,34.8,30833,14799,107,115
45133,22816,42.3,38369,19563,11248,11568
45135,4811,35.8,49567,22734,2366,2445
45140,52417,38.3,82772,38345,25937,26480
45142,4530,34,44399,18126,2260,2270
45144,4736,42.3,35625,18058,2208,2528
45145,0,-666666666,-666666666,-666666666,0,0
45146,1800,40.9,60607,23005,897,903
45147,240,41.4,52473,28124,93,147
45148,1448,37.7,52143,18740,772,676
45150,31776,41.6,59718,28036,15528,16248
45152,11644,41.3,68166,31111,5621,6023
45153,1706,40.2,70893,32199,861,845
45154,9573,35.9,41921,21202,4657,4916
45155,251,36.5,38125,18600,123,128
45156,119,38.6,23125,17056,64,55
45157,9723,41.3,53576,25681,4747,4976
45158,436,30.7,54583,19777,207,229
45159,3598,34.3,41618,17056,1754,1844
45160,743,43.2,20625,16343,269,474
45162,2496,44.8,54688,31564,1237,1259
45164,331,28.5,42750,14695,170,161
45166,186,59,52981,16432,67,119
45167,3467,47.5,44417,22623,1747,1720
45168,1642,34.9,51058,25477,884,758
45169,4886,36.9,42683,19410,2399,2487
45171,6401,38.9,44461,22211,3159,3242
45172,133,50.3,50625,27864,66,67
45174,2271,39.9,115357,58026,1211,1060
45176,8947,39.6,53693,21970,4606,4341
45177,21955,39.6,44059,23719,10395,11560
45202,12537,33.1,42546,41205,6861,5676
45203,2121,34.3,9475,15831,1194,927
45204,6996,28.2,25377,14402,3856,3140
45205,20678,29.8,29097,13380,9616,11062
45206,10648,36.7,27453,30652,5300,5348
45207,8137,22.6,24198,14617,3777,4360
45208,18659,35.1,78316,55266,8399,10260
45209,9529,31.4,52428,44181,4688,4841
45211,36846,36,40379,22465,17864,18982
45212,22032,35,38190,23379,10698,11334
45213,12294,38.5,51436,26632,6107,6187
45214,8341,30.1,15413,12440,3759,4582
45215,30003,39,45021,28685,14329,15674
45216,9628,38.6,30413,19310,4377,5251
45217,6944,35.8,43152,22044,3161,3783
45218,3838,39.7,54813,26859,1849,1989
45219,17673,21.6,22599,12892,9839,7834
45220,14792,28.2,30140,30131,7538,7254
45223,12147,31,25070,20430,5876,6271
45224,19907,45.7,44235,25241,8916,10991
45225,8807,27,15035,10249,4057,4750
45226,5651,32.6,65590,49977,2834,2817
45227,18267,37.5,47450,30261,8453,9814
45229,12076,37.4,20618,19332,5528,6548
45230,27142,40.5,65611,38647,13105,14037
45231,40728,38.5,44057,23141,19083,21645
45232,6944,22,12534,10021,2606,4338
45233,15674,40.8,74819,33703,7623,8051
45236,23962,42.4,52276,32196,11271,12691
45237,19833,40.7,32299,23800,9086,10747
45238,45376,37.2,47251,24315,21197,24179
45239,28010,35.7,45447,26222,13105,14905
45240,26829,36.7,49152,22680,12817,14012
45241,23515,45.3,68212,40849,12030,11485
45242,21971,44.5,76441,48220,10934,11037
45243,14384,44.9,101497,66374,7299,7085
45244,28583,38.4,90023,40258,13545,15038
45245,19487,38.7,64413,33126,9495,9992
45246,15146,36.3,47114,25804,7224,7922
45247,22620,45.1,71388,35779,11003,11617
45248,25562,42.4,64074,31599,12188,13374
45249,13421,40.7,77346,46691,6587,6834
45251,21500,38.1,53806,23812,10151,11349
45252,4681,51.3,82976,40915,2418,2263
45255,21803,43.1,68016,36086,10116,11687
45301,96,64.8,40430,22120,56,40
45302,4271,34.8,67344,24208,2118,2153
45303,1962,42.4,40455,20806,995,967
45304,7673,38.4,52708,23416,3797,3876
45305,11154,36.8,74160,31660,5468,5686
45306,2491,36.5,53090,24706,1239,1252
45307,311,35.7,31696,14011,130,181
45308,4397,38.6,50186,22207,2180,2217
45309,12505,45.2,47417,26859,6149,6356
45310,197,44.7,48750,27740,107,90
45311,6648,46.5,51393,24865,3313,3335
45312,1410,39.7,57697,22061,717,693
45314,5882,21.4,55000,17230,2851,3031
45315,3854,47.4,77181,38477,1921,1933
45316,179,36.8,36607,16300,91,88
45317,913,45,76953,29393,452,461
45318,5362,41,52975,26100,2693,2669
45319,345,39.6,42031,27397,157,188
45320,15384,36.9,46282,22962,7274,8110
45321,975,40.9,54107,22345,463,512
45322,22118,41.1,49653,24949,10549,11569
45323,5261,48.4,50208,29835,2559,2702
45324,40356,31.1,43020,22763,19549,20807
45325,2389,46.2,54630,26975,1148,1241
45326,1016,44.7,54135,25302,483,533
45327,9165,42.1,60802,30622,4604,4561
45328,692,30.4,43750,14939,339,353
45330,742,39.7,48750,18605,397,345
45331,22344,45.7,37069,22624,10719,11625
45332,726,25.9,34375,16682,343,383
45333,1174,38.7,68365,25106,592,582
45334,2231,36.6,57857,23621,1036,1195
45335,6772,40.1,53413,24745,3162,3610
45336,168,32.6,49583,18414,82,86
45337,1503,45.8,61895,29360,748,755
45338,5056,42.6,51176,24825,2569,2487
45339,1347,48.4,48750,23353,710,637
45340,708,41.4,62917,25105,357,351
45341,3542,42.5,37902,20184,1836,1706
45342,36006,39.5,51265,28135,17252,18754
45344,17238,40.7,48085,22768,8841,8397
45345,6120,39.4,43088,20724,2931,3189
45346,2249,31.8,53929,20463,1119,1130
45347,4619,41.2,50604,22466,2372,2247
45348,663,33.5,43710,23493,375,288
45349,478,34.8,55625,19419,215,263
45350,131,35.8,74375,22224,73,58
45351,236,44,52031,24910,125,111
45352,183,49.6,40446,20245,98,85
45353,216,39.8,41917,17772,109,107
45354,584,45.7,43750,25255,304,280
45356,25504,39.6,38959,21032,12275,13229
45358,423,33.8,39886,19068,182,241
45359,1904,35,46385,21551,950,954
45360,488,33.1,34464,16413,273,215
45361,276,30.4,33889,17210,139,137
45362,1203,39.1,49313,29927,621,582
45363,1768,33.3,67050,26471,884,884
45365,30409,39.5,45084,23545,15010,15399
45368,4725,40.6,50875,23081,2284,2441
45369,3735,40.6,60870,24143,1901,1834
45370,2480,46.9,83194,42222,1232,1248
45371,18802,42.9,62750,30305,8944,9858
45372,526,33,47031,19451,248,278
45373,35078,40.2,54383,25913,17555,17523
45377,15008,42.8,55634,28039,7274,7734
45378,407,31.7,57031,19616,221,186
45380,5497,38.2,55598,25582,2630,2867
45381,5356,45.4,43979,22784,2705,2651
45382,1468,36.9,51641,20721,719,749
45383,7214,39.8,52485,24288,3562,3652
45384,1439,20,133839,6358,555,884
45385,38313,40.9,49370,26577,18362,19951
45387,5152,50.9,63086,38759,2507,2645
45388,1022,32,64038,20979,582,440
45389,485,40.7,34444,16625,239,246
45390,3355,40.1,41061,17541,1624,1731
45402,10505,39.3,21038,16581,5395,5110
45403,15645,31.2,27757,14540,7670,7975
45404,10230,40.4,23976,15357,5135,5095
45405,19049,35.8,27521,16429,9293,9756
45406,20536,39,28244,18186,9886,10650
45409,17107,20.7,47780,15794,8486,8621
45410,15667,33.9,30542,17152,7992,7675
45414,20567,42,40670,23951,9600,10967
45415,12187,47,55356,29061,5834,6353
45416,6249,37.6,34386,17420,2730,3519
45417,31027,37.4,24623,13646,13649,17378
45418,1687,33.6,65188,22874,803,884
45419,14845,38.2,66277,42448,7409,7436
45420,26155,36.2,36365,20868,13071,13084
45424,50366,37.4,55219,25737,24567,25799
45426,14625,43.6,37604,21391,6424,8201
45428,318,61.6,-666666666,14130,295,23
45429,25155,47.1,54651,35265,12210,12945
45430,7472,45.1,69907,34023,3641,3831
45431,27037,35.2,55797,30291,13411,13626
45432,15102,42.2,54170,29202,7511,7591
45433,2498,24.4,79803,30560,1385,1113
45434,11838,43.4,94451,44167,6089,5749
45439,9886,34.1,37547,18398,4662,5224
45440,20627,40.7,58920,33919,9906,10721
45449,18610,39.3,40360,22742,8514,10096
45458,29482,42.7,70188,39776,14042,15440
45459,28111,48.9,66046,39305,13448,14663
45502,16169,46.1,65760,29970,8090,8079
45503,32978,41.7,44541,23899,15527,17451
45504,18252,37.2,45296,23561,9037,9215
45505,19275,38.8,27188,16178,9064,10211
45506,13996,37.3,31990,17644,6507,7489
45601,57449,39.7,42526,20663,30828,26621
45612,5662,40.7,38321,19410,2943,2719
45613,3661,35.5,42550,15365,1928,1733
45614,4832,40.8,41417,21421,2233,2599
45616,1426,43.8,31471,17494,730,696
45617,122,6.8,-666666666,,41,81
45618,16,50,67917,48588,9,7
45619,8749,38.3,41250,20587,4502,4247
45620,1004,45.9,35083,18386,456,548
45621,409,37.4,26806,14307,175,234
45622,299,42.8,60714,20840,172,127
45623,3127,40,45167,19946,1780,1347
45624,28,-666666666,-666666666,,13,15
45628,4703,44.2,52905,28300,2276,2427
45629,3674,39.5,44236,18648,1918,1756
45630,243,60.1,22163,11656,93,150
45631,15500,41.4,41456,23886,7483,8017
45634,2183,32.8,31250,16458,991,1192
45636,167,68.2,43438,13513,35,132
45638,21933,38.8,37655,20001,10339,11594
45640,16468,40.2,37500,20895,8348,8120
45642,0,-666666666,-666666666,-666666666,0,0
45644,4632,39.4,49405,26435,2292,2340
45645,3249,46.9,53125,26743,1666,1583
45646,361,41.3,82604,28220,165,196
45647,2537,38.4,49420,19710,1395,1142
45648,12880,38.6,41063,19828,7034,5846
45650,207,44,34904,18678,114,93
45651,5943,39.6,39745,18962,3069,2874
45652,3927,35.9,31768,24587,2070,1857
45653,4377,39.1,47687,22442,2117,2260
45654,828,49.2,25556,19215,422,406
45656,6295,37.6,35913,18610,3078,3217
45657,2757,30.1,27176,12258,1490,1267
45658,2133,44.7,32361,17768,1083,1050
45659,2782,43.5,36635,18910,1469,1313
45660,8557,39.3,34067,17584,4135,4422
45661,6998,40.7,39545,18565,3727,3271
45662,29505,38.3,30483,18302,13944,15561
45663,6657,39.1,38017,17383,3084,3573
45669,10193,43.5,48768,25285,4923,5270
45671,439,36.4,33571,12558,196,243
45672,1436,43.6,35990,20405,621,815
45673,407,36.3,58274,16792,228,179
45674,757,20.3,35139,9112,375,382
45678,1306,46,40066,19870,698,608
45679,2764,43.9,33990,19802,1433,1331
45680,12140,40.5,40387,21170,5684,6456
45681,1897,40.7,41125,18994,916,981
35150,19594,40.8,32767,19774,9028,10566
35151,7621,44.3,45122,20528,3724,3897
35160,24935,38.5,32004,18026,12090,12845
35171,3591,35.9,49141,22579,1692,1899
35172,3163,43.7,40833,21369,1581,1582
35173,25294,41.4,76698,33385,12178,13116
35175,5017,40.9,49597,23094,2526,2491
35176,824,57.9,30069,26547,394,430
35178,3539,42.5,51434,21308,1828,1711
35179,9334,39.4,43252,24138,4506,4828
35180,14377,38,52030,25208,7079,7298
35183,502,33.9,48295,18012,203,299
35184,6719,39.2,41122,16812,3329,3390
35186,4461,44.9,52097,31521,2327,2134
35187,24,59.5,40750,14742,15,9
35188,2300,42.9,48942,25161,1079,1221
35203,3457,37.6,18894,19930,2106,1351
35204,10899,42.6,20894,14058,5537,5362
35205,19755,30.7,32131,27125,9863,9892
35206,17619,38,32001,16230,8202,9417
35207,8963,37.3,23167,12539,4731,4232
35208,14167,38.2,34720,17630,6442,7725
35209,28683,29.2,45224,29434,13361,15322
35210,14117,45.1,51546,28785,6951,7166
35211,26414,39.2,25729,17567,11517,14897
35212,13046,32.1,28010,16501,6173,6873
35213,13988,36.2,94504,65381,6383,7605
35214,18962,41.7,43263,20070,8479,10483
35215,46629,33.4,41762,19729,21062,25567
35216,36494,33.6,53846,33719,18071,18423
35217,13290,40.3,27013,15836,5877,7413
35218,7494,39.8,23415,14091,3650,3844
35221,4975,42.2,25150,14989,2102,2873
35222,8120,38.1,44214,33165,3878,4242
35223,10536,44.1,120943,72730,4936,5600
35224,6185,35.3,31408,15972,2724,3461
35226,32299,37.3,83644,40040,15235,17064
35228,9903,36.3,32013,16200,4362,5541
35229,1420,19.9,-666666666,2848,584,836
35233,917,25.7,49423,28660,515,402
35234,6066,41.4,21867,11664,3027,3039
35235,19873,36.3,49336,24269,8958,10915
35242,50052,38.9,83616,48248,24329,25723
35243,16826,37.9,68700,47113,8274,8552
35244,32586,36.8,82465,39965,15493,17093
35254,1094,20,16563,7841,574,520
35401,36782,23.1,23372,11555,17518,19264
35404,21276,27.9,39024,19232,10912,10364
35405,42602,30.9,46433,23119,20072,22530
35406,14963,40.4,75081,45906,6774,8189
35441,1018,43.9,30052,17446,471,547
35442,5485,34.7,20648,11883,2524,2961
35443,1769,39.2,18788,14309,855,914
35444,3894,32.7,51083,20971,2127,1767
35446,1675,34.7,37750,18509,952,723
35447,3365,40.8,30821,17313,1792,1573
35452,3571,37.7,54274,24225,1774,1797
35453,11288,35.3,50338,22109,5267,6021
35456,2983,47.5,41967,20363,1379,1604
35457,83,-666666666,-666666666,,43,40
35458,394,54.7,55250,29323,171,223
35459,798,42.1,31667,13229,360,438
35460,303,40.5,23750,15157,189,114
35461,1812,46.2,36343,18818,835,977
35462,4750,47.2,28462,16044,2323,2427
35463,1618,36.9,58750,23334,766,852
35464,851,19,18879,7750,345,506
35466,5501,42.5,38256,20458,2624,2877
35469,117,58.2,24653,30710,39,78
35470,5528,30.6,21150,13776,2494,3034
35473,16094,36,53700,25424,7262,8832
35474,5666,41.4,43432,22127,2855,2811
35475,14315,33.9,69924,28117,7642,6673
35476,7111,32.1,34057,18141,3331,3780
35477,136,49.2,11938,9599,49,87
35480,1234,35.9,51923,34907,734,500
35481,3748,45.9,28846,18989,1708,2040
35490,4182,34.4,54284,20960,2106,2076
35501,11077,37.1,38181,20623,5237,5840
35503,7742,44.1,38493,21868,3833,3909
35504,13536,44.8,40483,24867,6446,7090
35540,2502,46.3,40086,19645,1249,1253
35541,3109,49.3,44625,27197,1563,1546
35542,1377,43.3,44759,23388,683,694
35543,1752,34.5,25143,13235,870,882
35544,1151,36.8,49188,22399,465,686
35545,74,55.6,29722,17154,47,27
35546,4011,40.2,32623,16666,1889,2122
35548,1830,43.6,32179,18367,867,963
35549,4679,43.4,34963,19848,2281,2398
35550,5180,39.5,34714,20037,2607,2573
35552,973,48.4,30806,16497,449,524
35553,4596,42.2,33180,17317,2130,2466
35554,1142,34.6,29135,18615,509,633
35555,10003,43.6,34026,18486,4987,5016
35559,35,31.9,19063,16166,19,16
35563,4416,48.5,42083,20853,2039,2377
35564,2185,44.8,25957,20776,1075,1110
35565,12391,42.7,26928,17199,6342,6049
35570,11432,40,31910,17777,5764,5668
35571,814,42.9,26716,18413,412,402
35572,1351,35.8,35540,13244,528,823
35574,1176,47.3,33036,17797,561,615
35575,1027,48.6,55074,21968,521,506
35576,2739,46.3,33302,19882,1343,1396
35577,24,67.5,17000,24671,12,12
35578,5489,41.5,30474,15957,2598,2891
35579,3166,41.9,42974,18468,1499,1667
35580,4315,41.4,38966,18520,2055,2260
35581,4982,37.8,35889,18530,2509,2473
35582,4055,43.7,34447,20082,1960,2095
35584,519,47,26522,14001,298,221
35585,1224,47.6,49662,28462,605,619
35586,4482,47.7,32373,19294,2089,2393
35587,1297,36.3,42791,19128,712,585
35592,4420,38.9,36374,18127,2240,2180
35593,2313,39,48261,23204,1200,1113
35594,7615,41.8,35200,22560,3814,3801
35601,34236,35.4,35087,20033,16957,17279
35603,30396,41.5,52382,29928,14725,15671
35610,2177,44.5,37381,20372,1091,1086
35611,25791,39,39507,22834,11435,14356
35613,21373,39.1,70542,26686,12393,8980
35614,8342,36,42619,22260,4047,4295
35615,0,-666666666,-666666666,-666666666,0,0
35616,4245,44.7,34519,19266,2023,2222
35618,1852,37.9,27128,17377,798,1054
35619,4992,41.9,46696,21734,2331,2661
35620,8361,40.2,43605,20676,4107,4254
35621,2821,43.1,39360,19949,1583,1238
35622,7109,44.6,40603,18803,3298,3811
35630,33178,35.7,31100,20548,14995,18183
35633,20624,43.2,45877,24220,10232,10392
35634,9227,46.1,56162,32161,4625,4602
35640,25913,37.3,50889,22726,12949,12964
35643,2777,44.7,32267,18046,1176,1601
35645,15463,37,55715,23573,7778,7685
35646,4146,42.5,33545,19739,1981,2165
35647,1019,37.3,39444,19910,498,521
35648,3111,48.1,52951,25604,1500,1611
35649,93,55.1,165000,62992,53,40
35650,14166,43.1,36534,20798,6996,7170
35651,1392,33.4,45766,21128,683,709
35652,7882,45.5,44880,24493,3802,4080
35653,11916,35.6,34217,17144,5702,6214
35654,8195,37.3,38032,18752,4242,3953
35660,9046,36.3,34304,19792,4329,4717
35661,17926,39.9,48865,23430,8773,9153
35670,7485,46.2,44741,23999,3827,3658
35671,2061,46,41038,29929,956,1105
35672,5798,40.3,42019,21899,2936,2862
35673,8060,34.3,47339,21066,4163,3897
35674,17685,44.7,37586,22097,8382,9303
35677,1620,39.7,46146,19024,748,872
35739,5990,35.8,42985,23060,2899,3091
35740,3413,40.9,37538,20052,1638,1775
35741,3087,47.7,92198,58005,1482,1605
35744,2895,44.4,28656,17298,1503,1392
35745,239,57.6,31417,22654,142,97
35746,768,51.4,55549,34071,435,333
35747,5703,41.2,52740,24667,2874,2829
35748,6030,46.1,62787,30324,2885,3145
35749,20362,36.5,83463,33640,10412,9950
35750,12267,39.3,49826,24140,6143,6124
35751,377,25,34318,26295,195,182
35752,1898,49,24670,19170,1070,828
35754,5243,38.3,51178,25269,2400,2843
35755,554,50.6,29844,20861,312,242
35756,9747,36.3,77449,32931,5045,4702
35757,13997,38.1,88578,34329,6775,7222
35758,43105,37.3,90256,41364,21102,22003
35759,7213,38.9,81044,31619,3347,3866
35760,5141,42.8,41962,22953,2472,2669
35761,11025,36.9,54856,26438,5132,5893
35763,15178,38.4,101759,41989,7568,7610
35764,681,32.5,22813,16254,297,384
35765,3604,45.8,39000,21396,1869,1735
35766,154,42.3,43333,25266,91,63
35768,12310,40.4,36108,18773,6121,6189
35769,9682,48.2,49583,27069,4481,5201
35771,3708,33.7,30491,17323,1791,1917
35772,4682,40.5,36967,18989,2313,2369
35773,12601,33.8,51595,22550,6648,5953
35774,133,17.8,2499,4409,72,61
35775,514,42.8,28144,19908,317,197
35776,3876,36,35833,17021,1854,2022
35801,22253,44,59352,41807,11040,11213
35802,20752,46.1,62784,42938,9721,11031
35803,26306,43.9,71904,36190,13248,13058
35805,22145,31.7,24873,14315,11145,11000
35806,19260,34.7,69644,39856,9569,9691
35808,1475,22.5,59286,25982,941,534
35810,31080,35.1,36194,17886,15020,16060
35811,26993,36.3,54949,28137,13161,13832
35816,14274,27.2,25749,16452,6963,7311
35824,6066,33.6,75313,45993,2765,3301
35896,636,19.8,-666666666,1958,164,472
35901,20451,39.3,32213,20762,9683,10768
35903,18189,39.8,34444,19652,8907,9282
35904,13519,41.8,32741,17757,6320,7199
35905,6281,43.5,46309,22702,2855,3426
35906,10059,40.1,45111,22760,4742,5317
35907,8339,40.7,70147,26791,4194,4145
35950,21496,32.3,34274,16203,11027,10469
35951,12839,35.7,37210,19602,6052,6787
35952,7675,41.6,35650,17993,3809,3866
35953,6548,39.7,46500,22494,3010,3538
35954,12487,40.1,33533,17759,6223,6264
35956,8716,40,46844,19615,4349,4367
35957,15906,35.2,37546,17492,7787,8119
35958,3162,43.3,50404,23253,1708,1454
35959,4479,47.1,32975,22681,2213,2266
35960,10364,47.6,37287,23983,5055,5309
35961,7162,36.2,34583,16763,3526,3636
35962,7925,38.3,36730,16832,3744,4181
35963,1681,37.9,26850,13698,936,745
35966,3602,42.7,40268,18425,1743,1859
35967,16265,38.4,37527,18630,7886,8379
35968,3483,48.1,32500,20084,1832,1651
35971,5794,36.4,36477,15803,2959,2835
35972,1134,39.9,40625,19921,620,514
35973,3281,37.8,31346,15360,1652,1629
35974,1482,41.2,38438,17004,642,840
35975,1119,39.5,46902,22982,555,564
35976,16523,46.8,42240,25328,7778,8745
35978,5321,44.6,38054,20389,2628,2693
35979,1316,29.4,33750,13896,635,681
35980,5972,34.8,36144,16907,2930,3042
35981,3044,39.4,35893,16746,1453,1591
35983,3837,42.5,36488,22215,1958,1879
35984,1962,47.8,37279,26821,879,1083
35986,7551,37.3,39882,18941,3626,3925
35987,2637,42.8,46364,20927,1299,1338
35988,2060,39.1,39303,15413,975,1085
35989,3274,39.3,34456,20094,1639,1635
35990,59,12.8,-666666666,8681,46,13
36003,1978,42.2,34375,19641,1029,949
36005,1699,42.4,46923,22464,859,840
36006,1636,41.5,43417,21702,808,828
36009,2685,43,38864,29053,1304,1381
36010,4654,39.5,29353,16507,2202,2452
36013,510,41.4,83750,42842,285,225
36016,4985,40.2,29469,15040,3162,1823
36017,3106,38.4,36100,12520,2307,799
36020,1100,36.8,47857,20642,563,537
36022,11733,38.5,64167,24818,5904,5829
36024,5250,45.6,50325,25210,2308,2942
36025,7059,33.5,43750,10592,5120,1939
36026,790,59.1,65333,36057,383,407
36027,16347,37.7,35891,18637,7838,8509
36028,1784,48.9,34679,22987,979,805
36029,786,45,36176,18833,330,456
36030,431,31,32625,16961,199,232
36031,58,15.9,-666666666,5447,38,20
36032,2207,37.2,28348,16217,1055,1152
36033,3996,49,24954,14862,1868,2128
36034,760,48.3,36250,19560,344,416
36035,1766,46,40161,20385,900,866
36036,1889,46.3,43977,25057,928,961
36037,13711,39.4,30256,18646,6422,7289
36038,108,64.5,73586,31669,55,53
36039,233,40.5,27313,11751,144,89
36040,3735,39,16528,12094,1824,1911
36041,1029,42.6,48250,21208,592,437
36042,1359,39.4,31167,15862,644,715
36043,3114,47.1,51000,26558,1520,1594
36046,1715,39.4,46172,22148,890,825
36047,1182,51.1,25286,20018,590,592
36048,1365,39.8,22279,15478,678,687
36049,5798,37.7,36761,19700,2763,3035
36051,2170,45.6,38819,23102,1140,1030
36052,1161,39.9,130286,39240,732,429
36053,2089,41.8,24732,13583,961,1128
36054,15069,34.5,55593,23494,6672,8397
36064,7270,36,90636,40766,3463,3807
36066,18527,36.1,63828,28579,9115,9412
36067,27388,36.7,51204,23192,13213,14175
36069,1537,53.6,34435,22075,707,830
36071,918,37.8,44722,20346,461,457
36075,2188,45.5,54519,23075,1065,1123
36078,13463,39.3,45500,22873,6354,7109
36079,9618,34.3,37886,20291,4676,4942
36080,2369,31.8,45469,20791,1061,1308
36081,16127,28,30657,21428,7724,8403
36082,1233,20,-666666666,2982,505,728
36083,8725,42.9,27249,18044,4000,4725
36088,4678,23,28958,13472,2010,2668
36089,8049,38.9,28627,15963,4374,3675
36091,4314,39.2,45833,20156,2040,2274
36092,20010,39.5,49012,21529,9138,10872
36093,10370,40.3,78375,34797,4935,5435
36104,8929,30,18043,14655,4714,4215
36105,11351,41.2,34125,17785,5328,6023
36106,14829,35.2,58185,34112,6767,8062
36107,8261,31.7,30062,16681,4073,4188
36108,21025,34.6,23925,13909,9770,11255
36109,24107,41.9,50310,26593,11678,12429
36110,12760,33.6,31281,14954,5967,6793
36111,12814,36.4,53339,31210,5785,7029
36112,394,21.1,65278,16779,219,175
36113,1621,33.9,76250,19961,1262,359
36115,724,21.5,50417,17039,418,306
36116,46139,30.4,42861,20751,20823,25316
36117,51223,34,62260,33307,24904,26319
36201,19500,37.9,22054,13312,9288,10212
36203,18951,39.4,49490,24172,8922,10029
36205,466,58.6,36755,29508,232,234
36206,11501,36.7,41020,20054,5912,5589
36207,20218,41.4,44176,25114,9623,10595
36250,4928,39.6,50316,23602,2468,2460
36251,4909,43.7,29844,18664,2373,2536
36255,852,34.8,37216,16687,440,412
36256,1848,42.4,35473,17636,846,1002
36258,1282,43.2,44643,23707,777,505
36260,3920,44.9,43333,19599,1926,1994
36262,1302,40.5,36295,18167,716,586
36263,761,41.4,39149,16100,406,355
36264,8737,40.8,33399,17217,4034,4703
36265,21146,30.7,39753,20143,10158,10988
36266,6255,44.4,34207,19063,3059,3196
36267,32,53.5,-666666666,,21,11
36268,5068,39.3,38821,18642,2418,2650
36269,1159,36.9,35703,20631,666,493
36271,5908,38.8,46861,19892,2869,3039
36272,12722,41.4,37973,18717,6315,6407
36273,3608,43.5,52500,22450,1817,1791
36274,11045,39.7,33826,21155,5145,5900
36276,2314,34.6,38819,17142,1210,1104
36277,4827,44.2,43925,25346,2096,2731
36278,4001,46.7,33967,21572,2126,1875
36279,2735,38.7,50183,21583,1412,1323
36280,3977,42.4,38333,17262,1913,2064
36301,36679,38.2,37708,20305,17547,19132
36303,30596,38.2,38694,23475,14415,16181
36305,14767,38,62592,34182,7161,7606
36310,6762,49.3,33882,18925,3355,3407
36311,2669,46.2,42865,20157,1233,1436
36312,6428,41.6,42108,21349,3137,3291
36313,377,46.4,32446,21489,144,233
36314,381,55.7,65521,28016,189,192
36316,1283,47.5,49405,25671,643,640
36317,306,51.5,42125,22276,148,158
36318,1223,52.7,44743,22438,608,615
36319,2278,47.7,32153,21743,1188,1090
36320,3757,40.2,36164,19279,1822,1935
36321,1487,42.1,40288,19933,702,785
36322,8840,35.4,43015,20860,4204,4636
36323,8353,44.4,35658,20678,4032,4321
36330,35391,35.6,50835,25148,17570,17821
36340,6508,39.1,37227,20571,3155,3353
36343,1296,52.6,31333,21588,616,680
36344,5332,44,31867,19734,2539,2793
36345,7896,38.6,53114,25122,3554,4342
36346,1207,46.9,40938,22885,603,604
36350,7034,35.6,43406,21069,3452,3582
36351,4087,34.9,38359,18092,2217,1870
36352,5240,37.9,48529,23326,2746,2494
36353,1919,42.7,38009,20657,969,950
36360,19674,42.6,41725,24590,9438,10236
36362,4844,22.2,52620,17761,2766,2078
36370,929,43.9,44018,21152,478,451
36371,667,33.2,61576,27505,320,347
36373,598,56.1,40541,20582,302,296
36374,1036,37.9,57875,23660,527,509
36375,7530,37.5,43047,20651,3732,3798
36376,2179,41.9,32019,18877,1069,1110
36401,7550,43.2,22131,14208,3600,3950
36420,10593,39.4,36213,20935,5089,5504
36421,8588,46.6,40030,22884,4458,4130
36425,1149,34,34792,13696,452,697
36426,15261,41.7,31815,17412,7557,7704
36432,2590,38.1,24239,12198,1418,1172
36435,521,47.5,21429,12884,292,229
36436,339,49.4,65402,20615,198,141
36439,449,28.4,40156,19585,203,246
36441,3708,40.2,32653,17544,1946,1762
36442,4263,38,29646,16466,1955,2308
36444,688,50.1,25341,11978,348,340
36445,4745,47.3,31523,16167,2357,2388
36446,406,41.3,24643,15252,203,203
36451,4493,44.2,29934,17799,2184,2309
36453,2145,50.8,34083,19502,993,1152
36454,17,69.3,-666666666,49541,6,11
36455,502,35.8,36471,17728,273,229
36456,2106,36.1,34259,16459,976,1130
36460,11730,36.3,29352,15291,5812,5918
36467,10124,44.1,36029,19847,4589,5535
36470,102,52,-666666666,4914,50,52
36471,925,47.9,19564,18117,372,553
36473,212,44.5,18333,65206,92,120
36474,3182,41.3,33930,16138,1476,1706
36475,2103,43.4,32625,14788,923,1180
36476,68,30.3,15625,8254,28,40
36477,4224,42.2,25586,17106,1963,2261
36480,1645,51.9,32574,19818,825,820
36481,284,41,17404,13362,154,130
36482,1184,38.1,8986,10512,497,687
36483,293,38.8,36957,22980,150,143
36502,19672,38.1,29236,15935,10425,9247
36505,1451,39.3,32344,19561,879,572
36507,18235,40.4,39539,19954,8821,9414
36509,2138,34.4,31449,12370,1086,1052
36511,939,44.1,28933,9973,237,702
36512,24,-666666666,-666666666,,0,24
36513,482,29.7,44698,15200,189,293
36518,2493,40.4,33783,23005,1249,1244
36521,5723,33.9,48179,19689,3048,2675
36522,6211,38.9,40290,19506,2809,3402
36523,1837,53.3,47961,27993,955,882
36524,1348,44.7,30777,17192,681,667
36525,1750,39,48919,20870,845,905
36526,29957,37.8,64613,30413,14943,15014
36527,12994,40,75657,35804,6847,6147
36528,1356,48.4,63542,30837,686,670
36529,496,37.9,83750,31480,222,274
36530,7442,42.8,38363,21046,3696,3746
36532,29408,43.3,57584,31533,13860,15548
36535,25821,40.8,43039,23068,12828,12993
36538,355,57.5,16447,14968,126,229
36539,869,39.6,41146,16187,426,443
36540,679,45,42917,21959,327,352
36541,14967,40.4,48531,21740,7528,7439
36542,12678,43.9,47892,26575,5980,6698
36543,101,50.3,-666666666,24444,72,29
36544,10638,39,38265,18555,5236,5402
36545,10309,37.4,26903,19461,4920,5389
36548,1111,51.8,71184,28864,579,532
36549,4841,60.3,43598,27458,2498,2343
36550,75,70.4,38750,22437,35,40
36551,8288,37.9,43537,20291,4219,4069
36553,3405,35.3,37939,15868,1674,1731
36555,858,56,47071,27171,402,456
36556,134,66.3,43506,21804,61,73
36558,3946,42.1,42500,21410,1943,2003
36559,158,60.8,130677,134987,95,63
36560,3621,36.5,34342,14118,1705,1916
36561,6157,49,62829,39439,3117,3040
36562,1389,39.6,45673,17334,619,770
36564,16,-666666666,-666666666,,8,8
36567,13010,39.8,42285,23041,6241,6769
36568,143,36.1,-666666666,14362,73,70
36569,883,51.6,68750,30147,477,406
36571,14706,41,51875,23769,7023,7683
36572,6411,41.8,61652,26723,3223,3188
36574,1570,37.1,43536,17162,703,867
36575,19114,36,52738,22276,9380,9734
36576,3877,39,59236,26612,1709,2168
36578,1414,40.2,32065,20210,764,650
36579,1268,52.2,75417,34676,576,692
36580,6237,41.6,38024,18484,2950,3287
36581,419,19.6,50673,16846,202,217
36582,25368,36.5,42956,19458,12381,12987
36583,703,39.5,27689,11494,357,346
36584,911,37.1,24250,18550,451,460
36585,1093,33.7,48322,18652,621,472
36587,11695,35.5,46480,18669,5792,5903
36590,0,-666666666,-666666666,-666666666,0,0
36602,627,55.4,20227,55415,285,342
36603,11088,35.8,22298,11668,6833,4255
36604,10049,38.6,40037,26126,4787,5262
36605,29613,33.5,27641,15493,13756,15857
36606,20726,31.7,37447,19826,9136,11590
36607,7171,40.6,30509,21240,3110,4061
36608,37296,34,45438,30190,17291,20005
36609,23464,31.2,40817,25190,11078,12386
36610,12297,38.7,16611,10742,5515,6782
36611,6073,32.7,30363,16115,2832,3241
36612,4742,36.7,23750,13046,2350,2392
36613,13204,37.3,41644,18009,6534,6670
36615,234,48.6,19390,17553,122,112
36616,0,-666666666,-666666666,-666666666,0,0
36617,13324,40.8,24146,13232,6068,7256
36618,16743,35.5,47733,20178,8217,8526
36619,15405,37.9,55962,24392,7344,8061
36688,545,20.1,-666666666,3086,191,354
36693,17338,47,55560,31881,8036,9302
36695,46316,37.3,67911,32521,22225,24091
36701,22605,39.4,32136,20992,10440,12165
36703,14310,33.3,19181,12476,6406,7904
36720,586,31.4,15093,7162,369,217
36722,578,48,25811,15501,341,237
36723,124,54.1,6422,7062,28,96
36726,5369,37.6,24309,14476,2303,3066
36727,168,29.2,9083,5582,98,70
36728,409,47.6,15781,14186,250,159
36732,8037,36.5,36649,23919,3579,4458
36736,1756,42.3,28333,17708,934,822
36738,894,41.8,28519,18423,474,420
36740,1666,39.6,27703,12908,740,926
36742,1692,45.4,32156,21292,835,857
36744,7183,41.4,28083,16692,3463,3720
36748,3086,48.5,33822,24513,1411,1675
36749,847,44.4,33889,19670,381,466
36750,3349,33.1,38165,17590,1647,1702
36751,815,39.9,13409,9021,340,475
36752,1777,43.5,41907,21915,724,1053
48124,30922,41.9,58074,30770,15139,15783
48125,20241,39.9,42247,21550,9902,10339
48126,48100,27.3,28335,12387,23688,24412
48127,37050,38.3,43326,21369,17634,19416
48128,10664,38.3,79619,34066,4916,5748
48130,14627,38.3,90966,39327,7130,7497
48131,6303,39.8,50540,24816,3146,3157
48133,5560,43.2,47807,24154,2802,2758
48134,20868,38.6,57660,26692,10732,10136
48135,27499,40.7,52425,23997,13658,13841
48137,4872,46.9,74022,31624,2533,2339
48138,10294,48.3,88238,42685,5188,5106
48139,264,35.4,88087,86676,114,150
48140,3303,40.8,74970,27948,1690,1613
48141,25215,32.9,26512,14259,11445,13770
48143,0,-666666666,-666666666,-666666666,0,0
48144,10164,43.2,67220,30920,4965,5199
48145,3398,44.4,66714,29462,1664,1734
48146,37651,37.3,40700,19455,18117,19534
48150,27327,40.9,63576,29348,13406,13921
48152,30840,45.7,67685,33761,15381,15459
48154,38066,46.1,73843,33107,18646,19420
48157,1405,38.6,46354,26316,692,713
48158,7760,41.6,71332,31194,3945,3815
48159,2422,41.7,60952,27106,1228,1194
48160,13640,40.5,69609,27888,7109,6531
48161,27201,38.5,41499,22462,13391,13810
48162,28592,41.3,47847,24853,13950,14642
48164,9477,40,75034,29096,4748,4729
48165,5886,35.9,57339,29372,2772,3114
48166,11482,36.8,58017,24162,5614,5868
48167,21911,42.5,75438,43823,10453,11458
48168,22320,43.7,122280,55553,10761,11559
48169,20880,44,73476,33567,10780,10100
48170,39578,43.7,80120,41971,19547,20031
48173,12745,40.1,67841,28753,6574,6171
48174,31719,38.3,44550,21344,15272,16447
48176,20923,42.1,85060,37722,10363,10560
48177,267,45,40197,12912,125,142
48178,29815,41.1,72091,34661,14162,15653
48179,3351,41.4,61935,27422,1713,1638
48180,62592,37.3,41933,20101,29757,32835
48182,21455,42.4,64076,29300,10647,10808
48183,42277,41.3,56594,28880,20359,21918
48184,17447,40.1,39614,19996,8627,8820
48185,47787,39.9,42810,25893,21592,26195
48186,35689,36.7,45598,21449,17491,18198
48187,48028,37.3,76430,33436,23459,24569
48188,41460,36.4,88853,35535,21368,20092
48189,13582,39.9,56759,29700,6517,7065
48190,82,56.9,42212,29848,31,51
48191,3736,41.8,72204,25659,1891,1845
48192,25621,41,48664,25287,12393,13228
48193,15398,40.5,50207,24856,6829,8569
48195,29800,41.9,48439,25903,14287,15513
48197,62684,31,48772,26222,30797,31887
48198,38095,34.1,40366,23662,17574,20521
48201,11748,33.7,15139,17732,6149,5599
48202,15866,40.2,18597,16720,7879,7987
48203,26861,39.5,22804,15642,13115,13746
48204,27227,39.7,21075,12531,12266,14961
48205,38688,30,26648,12743,17442,21246
48206,21182,33.7,23630,13081,10054,11128
48207,20439,44.6,22090,19107,9394,11045
48208,9997,35.6,20386,13733,5004,4993
48209,33446,29.1,27358,11703,17006,16440
48210,31895,26.3,24949,9612,15573,16322
48211,6175,34.2,18264,10019,3395,2780
48212,39369,31.1,23694,10716,20451,18918
48213,27981,33.3,22592,11348,12522,15459
48214,22286,41.9,23841,17860,10722,11564
48215,13364,36,20101,12737,6419,6945
48216,5556,36.1,23367,14981,2777,2779
48217,7723,42.6,26705,14855,3788,3935
48218,7857,35.5,26185,13819,3568,4289
48219,47821,36.6,32416,17331,21550,26271
48220,22773,35.7,44986,26577,11383,11390
48221,39455,39.6,38588,20123,18019,21436
48223,24321,35.1,34546,17431,11589,12732
48224,44877,31.7,30457,14826,21079,23798
48225,14692,35.8,44269,20903,6739,7953
48226,5370,40.1,30891,33039,3214,2156
48227,45214,35.5,28994,15072,21024,24190
48228,52191,31,24254,13010,24501,27690
48229,9625,36.9,27818,15357,4874,4751
48230,16860,42.5,96975,51943,7949,8911
48233,0,-666666666,-666666666,-666666666,0,0
48234,35769,35.3,26296,13148,16794,18975
48235,46368,39.3,28897,17256,21321,25047
48236,30358,45,91782,47928,14684,15674
48237,29573,37.1,48261,21768,13348,16225
48238,31109,37.9,23667,13944,15093,16016
48239,36245,39,50113,22814,16965,19280
48240,17212,39.4,47401,22394,8736,8476
48242,0,-666666666,-666666666,-666666666,0,0
48243,0,-666666666,-666666666,-666666666,0,0
48301,14104,46.7,116863,64977,6823,7281
48302,15155,48.9,110034,68419,7074,8081
48304,16667,47.9,104325,63584,8198,8469
48306,27177,42.8,119253,51970,13076,14101
48307,40878,38.5,66263,36870,19813,21065
48309,29555,42.7,84118,39147,14016,15539
48310,43399,39.6,54845,23607,22065,21334
48312,32499,42.1,56379,27436,15858,16641
48313,33692,40.8,59036,28123,16387,17305
48314,20570,41.9,58498,29686,9718,10852
48315,26719,46.8,69171,33030,12705,14014
48316,25854,41.5,69620,32724,12877,12977
48317,26694,36.1,50835,26009,13632,13062
48320,4415,39,51964,30452,2414,2001
48322,31947,44.8,81652,43301,14849,17098
48323,17664,45.5,106563,55385,8563,9101
48324,17010,44.7,98046,52270,8530,8480
48326,21025,33.3,52937,29015,10009,11016
48327,22185,39.4,51596,27494,11164,11021
48328,25223,38.1,44663,26634,12306,12917
48329,24526,42.8,66765,31842,12225,12301
48331,22184,45.8,95571,48237,10789,11395
48334,17506,47.7,64512,41580,7784,9722
48335,22323,37,60923,39754,10532,11791
48336,26619,40.6,54921,29841,13255,13364
48340,25577,30.1,28929,15249,12156,13421
48341,16790,38.5,35262,19976,8573,8217
48342,17854,32,20830,13064,8546,9308
48346,22888,40,61315,30549,11397,11491
48348,23263,41.9,92000,39005,11550,11713
48350,7201,43.3,75401,30761,3577,3624
48353,6444,39.1,72675,29030,3276,3168
48356,8405,42.1,66232,28550,4192,4213
48357,8649,40.5,71979,30024,4665,3984
48359,7882,38.3,58150,30322,3852,4030
48360,11863,38.8,84926,36277,5796,6067
48362,15439,39.1,74823,32885,8045,7394
48363,4842,46.1,92717,45247,2485,2357
48367,4637,44.4,73250,32599,2380,2257
48370,1844,42.9,94028,36603,996,848
48371,22826,39.6,76419,32397,11086,11740
48374,14359,41.2,142875,54121,7369,6990
48375,22189,40,83968,40425,10801,11388
48377,15529,39.6,54622,41057,7509,8020
48380,7388,43.2,89167,37903,3632,3756
48381,12800,42.6,74375,35993,6165,6635
48382,21683,40.9,87835,39583,10859,10824
48383,12279,41.2,68136,29674,5967,6312
48386,18081,42.9,74321,33301,9052,9029
48390,23246,41.8,63641,33624,11204,12042
48393,16560,33.9,47908,28508,8413,8147
48397,0,-666666666,-666666666,-666666666,0,0
48401,1662,43.2,39643,16230,852,810
48411,34,40.3,-666666666,2226,14,20
48412,5792,43.7,54522,24676,2935,2857
48413,7502,43.9,38692,21209,3691,3811
48414,2946,39.2,47545,20622,1482,1464
48415,9639,42.4,55547,23398,4637,5002
48416,4986,38.6,43397,20143,2491,2495
48417,2741,39.8,46382,20065,1397,1344
48418,4387,38.7,58231,22375,2252,2135
48419,2636,46.1,40402,20572,1250,1386
48420,22100,41.4,49566,23472,11106,10994
48421,6836,39.8,58008,24223,3342,3494
48422,6068,41.8,38571,20455,3012,3056
48423,32169,39.6,51156,25557,15227,16942
48426,993,41.1,41563,18626,479,514
48427,2854,45.1,40521,19772,1407,1447
48428,4920,44.3,70281,29697,2696,2224
48429,8127,44.2,42557,21244,3935,4192
48430,36202,41.5,62807,29796,17739,18463
48432,667,49.3,48274,22322,333,334
48433,26450,43.1,59333,28137,12569,13881
48434,63,62.5,35000,21956,33,30
48435,1964,44.7,47500,19340,974,990
48436,3723,44.2,63525,25818,1870,1853
48437,424,53.3,28088,28370,195,229
48438,7063,38.9,76509,33509,3534,3529
48439,48594,39,62245,31543,23568,25026
48440,396,31.3,71076,11434,146,250
48441,3933,47,37862,21964,1969,1964
48442,21401,38.9,66197,28819,10805,10596
48444,9151,39,45932,19329,4348,4803
48445,1381,46.4,32670,18457,710,671
48446,30843,43.9,50587,23726,15554,15289
48449,2990,43.8,46726,23704,1438,1552
48450,4630,50.3,41120,25685,2246,2384
48451,15056,39,66450,27959,7394,7662
48453,5149,38.6,38364,18628,2499,2650
48454,1337,40.1,44773,18800,716,621
48455,8224,43.9,68421,29426,4213,4011
48456,887,39.1,46500,21647,468,419
48457,8150,40.7,42466,20430,4142,4008
48458,21631,38.6,33737,18000,10538,11093
48460,2331,41.7,55104,22695,1185,1146
48461,8556,41.3,48924,20306,4475,4081
48462,13425,42.6,76277,30278,6961,6464
48463,4331,46.1,46812,22283,2113,2218
48464,2019,39.9,54637,21310,1022,997
48465,544,54.8,46477,22705,279,265
48466,1796,38.2,43173,17836,938,858
48467,2327,57.4,38705,24973,1198,1129
48468,1440,55.2,38882,22710,712,728
48469,1175,56.4,44438,25798,601,574
48470,794,39,46771,22598,393,401
48471,5640,44.5,36761,21603,2619,3021
48472,1964,35.9,43500,21226,1018,946
48473,22030,41.7,54990,24706,10571,11459
48475,2527,44,43371,22071,1258,1269
48476,741,38.4,52560,19526,345,396
48502,1068,29.2,28929,10844,795,273
48503,24866,38.4,26494,17894,11927,12939
48504,30615,33.8,28700,14644,14888,15727
48505,23343,34.1,21559,11174,10801,12542
48506,29071,37.7,33023,17042,14542,14529
48507,31512,35.3,32162,16910,14171,17341
48509,9889,43.9,53089,24222,5038,4851
48519,7771,39,41165,20598,3584,4187
48529,9426,38.4,30038,17871,4808,4618
48532,19689,40.5,39197,22929,9139,10550
48551,0,-666666666,-666666666,-666666666,0,0
48553,0,-666666666,-666666666,-666666666,0,0
48554,0,-666666666,-666666666,-666666666,0,0
48601,38232,36.7,26368,14409,17774,20458
48602,29833,34.8,32842,17210,14529,15304
48603,26593,42.4,46645,29760,12107,14486
48604,13217,31.4,41741,17952,6232,6985
48607,1392,48.1,21302,17815,642,750
48609,11952,47,53557,27929,5949,6003
48610,3071,52.9,37015,19626,1447,1624
48611,6937,36.5,61108,25380,3379,3558
48612,9335,46.3,39025,20121,4641,4694
48613,1108,41.3,41964,24088,619,489
48614,1375,36.3,48942,19641,655,720
48615,3112,40.9,45798,21453,1517,1595
48616,7459,42.6,42731,22428,3751,3708
48617,8612,37.4,37963,19703,3933,4679
48618,5521,44.3,41904,20480,2776,2745
48619,390,55.2,42917,24922,195,195
48621,1195,56.5,32188,21226,571,624
48622,6251,45.8,37652,19082,3288,2963
48623,14018,37.8,67509,27628,7676,6342
48624,16032,48.7,36667,20315,8142,7890
48625,13593,46.6,29960,16851,6923,6670
48626,6105,43.7,63406,27545,3052,3053
48627,99,65.5,41023,25344,66,33
48628,2020,47.7,42292,23474,1006,1014
48629,7857,54.4,33143,25134,3925,3932
48630,121,60.4,34444,13670,49,72
48631,4568,46,54752,27471,2332,2236
48632,4778,52.3,34713,18069,2382,2396
48633,241,47.7,30625,20795,88,153
48634,4406,40.8,54935,28803,2192,2214
48635,1640,56.9,37685,21941,857,783
48636,881,54.8,34219,20890,440,441
48637,3308,44.7,48646,24821,1686,1622
48638,13161,41.8,52221,27653,6290,6871
48640,32054,39.8,54446,30881,15796,16258
48642,32933,38.8,54996,31431,15849,17084
48647,4562,43.4,31645,15948,2344,2218
48649,1439,46.9,49886,23206,660,779
48650,7115,44.7,44269,21924,3643,3472
48651,4789,54.3,35065,22601,2205,2584
48652,1450,46,45625,23838,716,734
48653,9901,52.5,37828,23109,4973,4928
48654,2350,49.1,33696,18686,1179,1171
48655,6327,42.9,49337,23847,3324,3003
48656,4104,51.4,28568,18926,2138,1966
48657,8002,43.8,52784,25910,4035,3967
48658,5417,41.9,36302,19186,2884,2533
48659,2781,43.1,44315,19879,1394,1387
48661,10062,47.5,38193,22266,4929,5133
48662,1464,45.6,47250,24863,768,696
48667,0,-666666666,-666666666,-666666666,0,0
48701,1328,40.6,36304,18138,692,636
48703,3020,54.6,37442,22215,1453,1567
48705,461,57.5,30536,17313,234,227
48706,40208,43.6,45237,25165,19414,20794
48708,27205,38.1,37344,19949,13299,13906
48710,0,-666666666,-666666666,-666666666,0,0
48720,1066,50.7,36250,20350,589,477
48721,365,58.5,37188,20196,184,181
48722,3255,42.6,43224,23857,1600,1655
48723,12431,44.7,40869,21700,6136,6295
48724,372,39.8,37750,20436,227,145
48725,2434,50.3,37778,24333,1176,1258
48726,6270,43.1,43480,20270,3219,3051
48727,1344,42.3,43696,17668,716,628
48728,319,57.5,33438,27366,181,138
48729,1539,42.3,40417,17743,792,747
48730,4543,52.6,43561,28121,2190,2353
48731,1718,37.6,42500,19209,880,838
48732,11377,43.3,46291,24282,5575,5802
48733,1752,46.4,40727,19972,889,863
48734,7643,49.7,54603,32224,3560,4083
48735,912,42.9,36591,20102,455,457
48737,1258,57.7,30898,18549,612,646
48738,1290,60,42697,28203,650,640
48739,4165,52.8,34536,19456,2099,2066
48740,2454,53.9,37132,23485,1211,1243
48741,2113,39.9,42784,20238,1072,1041
48742,1505,57.1,40341,23859,741,764
48743,11,69.5,-666666666,18464,8,3
48744,4572,47.3,44228,20301,2245,2327
48745,1481,46.9,37163,16451,779,702
48746,8653,39,47939,19926,4274,4379
48747,1404,44.5,61000,27872,726,678
48748,1706,59.4,34286,19518,887,819
48749,1038,49.2,43715,21716,531,507
48750,8667,50.2,34080,22227,4515,4152
48754,913,43.5,46167,19547,431,482
48755,3045,52.7,43681,25178,1466,1579
48756,4780,42.9,25804,13944,2458,2322
48757,3929,42.6,52386,25352,1957,1972
48759,3249,45.7,44032,22286,1575,1674
48760,1262,37.7,38869,16448,668,594
48761,960,55.9,30450,19578,458,502
48762,1103,55.9,45294,26350,569,534
48763,5370,50.5,42319,22614,2628,2742
48765,650,51.5,31010,17263,343,307
48766,1419,44.1,33313,15756,813,606
48767,2080,42.9,55469,24037,1070,1010
48768,9651,39.3,44164,20323,5032,4619
48770,1980,47.9,29448,15904,996,984
48801,13118,32.7,36051,17904,6249,6869
48806,1697,43.5,45972,21395,848,849
48807,836,42.1,51500,21425,410,426
48808,5707,37.5,65370,30512,2955,2752
48809,10848,37.5,44533,20076,5513,5335
48811,5655,37.6,42679,14120,3790,1865
48813,21058,39.9,52889,23643,10334,10724
48815,2197,34.1,55398,23274,1120,1077
48816,67,37.1,40729,18670,38,29
48817,6397,42.1,44729,21544,2991,3406
48818,2287,47.2,45387,20034,1216,1071
48819,2842,37.4,65417,24237,1475,1367
48820,17032,39.7,74788,35713,8249,8783
48821,5763,48.3,58696,29106,2989,2774
48822,2934,44.3,80804,30068,1542,1392
48823,49813,23.8,39692,27039,24721,25092
48825,13696,19.4,-666666666,2964,6836,6860
48827,16134,37.5,56661,23274,7987,8147
48829,3212,37.5,32917,18038,1600,1612
48831,3438,41,46779,19797,1758,1680
48832,1222,48.7,37155,18566,582,640
48834,2188,40.6,42466,19801,1094,1094
48835,2581,35.3,62583,22708,1344,1237
48836,13825,38.2,60516,24105,6972,6853
48837,18829,42.9,65663,30630,8725,10104
48838,17928,37.7,40731,20694,8994,8934
48840,12939,40.8,56534,33850,6119,6820
48841,1026,36.9,54286,19815,536,490
48842,20285,40.8,56395,28679,9570,10715
48843,43397,38.4,67477,30627,21060,22337
48845,996,38.2,42750,18563,523,473
48846,20655,35.9,40189,16081,12188,8467
48847,5763,41,44853,23875,2822,2941
48848,7589,41.2,64830,28026,3621,3968
48849,5593,40.1,48656,22758,2931,2662
48850,4215,37.2,34407,17596,2211,2004
48851,2493,36.5,53704,22288,1419,1074
48852,75,56.4,31250,27121,44,31
48853,676,37.8,48813,20588,327,349
48854,18616,40.7,63552,29580,9238,9378
48855,14112,40.6,71982,29572,7062,7050
48856,962,34.8,38500,21321,472,490
48857,2678,41.4,58528,22863,1260,1418
48858,49502,22.9,31645,18423,23898,25604
48860,1271,39.9,45536,18333,586,685
48861,1606,33.6,50625,23552,784,822
48864,20058,40.3,73424,41271,9441,10617
48865,1692,42.7,35511,18715,887,805
48866,4999,40.2,51152,21531,2436,2563
48867,27713,38.6,41719,22646,13693,14020
48870,164,42,53214,15680,93,71
48871,1976,45.3,54777,25134,1019,957
48872,7280,41.6,48347,22752,3692,3588
48873,1613,44.2,60217,24948,798,815
48874,212,39.5,33100,18137,95,117
48875,10558,39.1,61212,25881,5222,5336
48876,3956,36.9,56332,25376,2056,1900
48877,2450,42,39180,18541,1280,1170
48878,1550,36.4,41641,25665,697,853
48879,18240,39.3,52996,24911,8819,9421
48880,10554,37.8,32759,13614,6948,3606
48881,5042,38.6,49797,23399,2481,2561
48883,7364,39.2,49088,21505,3556,3808
48884,4514,42.6,40617,18582,2310,2204
48885,937,41,42500,18924,502,435
48886,2203,45,35648,18894,1201,1002
48888,6139,45.6,36831,19434,3039,3100
48889,1364,43.9,40313,19224,657,707
48890,1945,37,47563,23452,949,996
48891,3130,45,42560,19478,1462,1668
48892,4661,36.7,57138,22686,2500,2161
48893,5472,40.1,42272,20778,2701,2771
48894,2030,41.2,64808,26222,986,1044
48895,11299,41.9,76400,38164,5398,5901
48896,138,39,23333,10372,58,80
48897,1505,43.3,53393,26956,743,762
48906,25641,35.3,39930,21355,12836,12805
48910,35218,32.6,39007,20756,16822,18396
48911,39922,31.8,38930,19968,18735,21187
48912,17931,30.7,38387,20895,8388,9543
48915,8870,32.3,37354,20741,4305,4565
48917,32082,41.9,51830,29977,15602,16480
48921,0,-666666666,-666666666,-666666666,0,0
48933,2478,30.5,14817,15382,1379,1099
49001,22581,31.2,32259,17613,11234,11347
49002,19528,37,44526,26901,9830,9698
49004,15575,38.3,46828,23650,7345,8230
49006,26908,23.2,32016,17457,14004,12904
49007,10208,28.6,23367,14508,5305,4903
49008,16599,32.5,44893,29053,7496,9103
49009,43385,36.3,53172,31385,21184,22201
49010,17741,40.2,48013,22848,8866,8875
49011,2151,39.1,52610,23715,1044,1107
49012,3389,47,56950,29822,1772,1617
49013,4890,40.1,35691,16852,2524,2366
49014,21546,37.3,42945,22726,10714,10832
49015,26378,39.9,49877,29642,12537,13841
49017,21560,40.6,43643,22877,10521,11039
49021,6236,42.8,51303,23690,3162,3074
49022,31647,35.8,25948,16398,14675,16972
49024,28561,36.8,61907,31757,13574,14987
49026,2396,45.3,40774,18480,1219,1177
49027,114,47.8,21250,17976,52,62
49028,6438,36.2,39059,18695,3288,3150
49029,1708,42.1,51290,21318,771,937
49030,2356,39.2,40170,18464,1242,1114
49031,7658,46.6,44805,24295,3895,3763
49032,3726,37.6,46339,18879,1794,1932
49033,1931,44.9,56917,25866,980,951
49034,2142,43.8,57014,25306,1014,1128
49036,23706,41.6,42635,21336,12673,11033
49037,22204,35.4,30416,16317,11027,11177
49038,9091,42.1,44913,23509,4609,4482
49040,3311,44.3,44019,19188,1670,1641
49042,4507,41.4,44699,19955,2269,2238
49043,2806,38.2,25500,14505,1414,1392
49045,5826,39.6,40357,18978,2812,3014
49046,7201,47.9,49693,27731,3678,3523
49047,14493,40.7,36846,19383,7151,7342
49048,25434,34.9,41443,20479,12018,13416
49050,1337,47.2,52537,24769,666,671
49051,2747,44.4,64183,31350,1337,1410
49052,1038,43.7,53250,24654,511,527
49053,6724,40.7,55615,25816,3409,3315
49055,6079,45.3,52196,24596,3083,2996
49056,4296,36.6,40610,19789,2131,2165
49057,7145,33.6,35900,15429,3582,3563
49058,19031,40.8,46777,22137,9239,9792
49060,1898,36.6,62995,32053,924,974
49061,1527,41.3,49722,20336,801,726
49064,3698,41.1,43947,19831,1773,1925
49065,6643,40.1,51337,24753,3338,3305
49066,549,45.8,40000,22008,265,284
49067,4446,41.8,49130,23873,2113,2333
49068,14415,42.5,52311,27544,7117,7298
49070,2451,36.5,49213,20367,1305,1146
49071,8710,41,68644,29950,4199,4511
49072,3126,38.2,45163,18638,1577,1549
49073,4689,40.3,42245,20690,2396,2293
49074,208,76.7,19432,20108,23,185
49075,90,33.4,38125,9882,59,31
49076,4316,30.5,49730,19802,2332,1984
49078,8964,40.8,49363,24423,4368,4596
49079,13332,39.9,51765,23514,6645,6687
49080,15624,40.9,53743,25048,7986,7638
49082,6797,40.1,42535,18414,3367,3430
49083,7363,43,73864,40479,3343,4020
49084,5,42.8,-666666666,6260,4,1
49085,23268,43.5,62077,35307,11570,11698
49087,6438,39.3,64710,26444,3233,3205
49088,3747,40.5,62966,26370,1952,1795
49089,1566,44,48375,20103,801,765
49090,14137,42.7,41297,23493,6650,7487
49091,19625,36.4,40714,20608,9615,10010
49092,2118,40.6,41292,21123,1031,1087
49093,18412,39.6,46680,22025,8949,9463
49094,4252,40.5,42266,19614,2042,2210
49095,2048,48.9,50625,25084,1089,959
49096,3285,41.4,52500,23532,1672,1613
49097,10050,41.3,56966,29739,5147,4903
49098,6388,37,42237,18480,3239,3149
49099,5731,42.4,44882,20643,3044,2687
49101,2989,41.1,50313,25011,1412,1577
49102,1504,47.4,58608,21969,753,751
49103,11168,38.2,49005,19953,5684,5484
49104,722,20.6,-666666666,3062,336,386
49106,4407,45.1,50709,29476,2038,2369
49107,10299,42.9,46378,22494,5023,5276
49111,3573,44.9,49375,21176,1876,1697
49112,10253,39.5,49712,21768,5125,5128
49113,1837,44.5,46544,22777,941,896
49115,200,69.7,33875,36084,61,139
49116,414,67.8,62574,42566,201,213
49117,3812,49.8,51496,34933,1861,1951
49119,73,45.2,52917,28740,36,37
49120,37376,40.8,41693,21684,17798,19578
49125,1923,56.3,42228,31275,1020,903
49126,1521,45.6,43958,22415,734,787
49127,10793,44.6,66161,32993,5627,5166
49128,4116,46.6,45035,24972,2066,2050
49129,361,54.1,56000,50399,165,196
49130,2042,49.2,42708,36677,1086,956
49201,44338,40.5,49988,23288,24867,19471
49202,20866,36.1,31164,17319,9688,11178
49203,38660,37.5,40827,21022,18587,20073
49220,2474,46.9,47609,21491,1247,1227
49221,41712,37.2,40642,18924,21461,20251
49224,14539,37.2,32632,17189,7052,7487
49227,1152,42.4,49000,21055,594,558
49228,5735,40,49587,24274,2755,2980
49229,3192,38,65080,29319,1594,1598
49230,10099,48,54497,26827,4989,5110
49232,2980,34.9,40380,16359,1429,1551
49233,2619,48.3,55051,26023,1386,1233
49234,2665,47.3,58250,30245,1377,1288
49235,2250,41,49750,22074,1204,1046
49236,4773,39.4,53984,22915,2591,2182
49237,2807,42.6,52589,23716,1481,1326
49238,1977,38.8,55000,24027,951,1026
49240,9335,41.9,66778,28978,4742,4593
49241,2439,42.9,52750,21112,1198,1241
49242,14872,38.2,38636,20286,7368,7504
49245,4910,35.3,40027,18496,2429,2481
49246,3345,47.2,70611,33774,1761,1584
49247,5622,40.6,43022,20267,2753,2869
49248,817,44.6,44432,22847,384,433
49249,3417,49.4,56250,29095,1551,1866
49250,6183,39.9,42378,19702,3005,3178
49251,6699,39.7,59324,23915,3529,3170
49252,2472,43.9,44188,21260,1223,1249
49253,2989,54.5,45859,28374,1499,1490
49254,3215,44.1,31813,18901,1777,1438
49255,1946,30.5,35353,14763,1019,927
49256,3779,40.1,41736,19802,1845,1934
49259,2242,42.7,56993,26139,1185,1057
49261,406,37.3,58110,18181,159,247
49262,1305,40.6,37202,17466,686,619
49263,11,-666666666,-666666666,,0,11
49264,2138,40.1,59375,24013,1079,1059
49265,5225,42.8,58500,27289,2711,2514
49266,2945,47.3,47303,21058,1516,1429
49267,4087,45.8,55083,28566,1957,2130
49268,885,48.1,59712,22647,397,488
49269,5954,43,48185,24291,3189,2765
49270,5842,43.2,59489,28412,2968,2874
49271,2196,38.1,38243,17425,1082,1114
49272,2309,42.1,52813,23776,1150,1159
49274,3917,37.9,35588,17345,1983,1934
49276,1131,34.3,46500,19622,535,596
49277,3339,42.8,57143,25175,1691,1648
49279,603,47.1,62434,25915,312,291
49282,463,54.1,24167,20309,252,211
49283,4443,26.2,59136,20278,1917,2526
49284,3082,40.6,43966,20993,1677,1405
49285,5788,40.4,54650,24447,2839,2949
49286,14508,42.9,56497,27336,7062,7446
49287,1874,41.9,62269,26677,1003,871
49288,1376,36,35568,17140,703,673
49289,178,39.7,43750,20869,101,77
49301,19366,39.3,118761,51371,9803,9563
49302,8241,39.1,75616,28436,4233,4008
49303,1109,34.8,52031,20295,596,513
49304,4054,50.6,23693,15618,2051,2003
49305,2260,46.1,33125,18171,1124,1136
49306,10450,41.1,76550,32425,5034,5416
49307,20473,24.4,36331,18087,10315,10158
49309,1660,48.9,27865,15549,851,809
49310,3163,34.4,40550,17270,1622,1541
49312,213,58.9,31923,20905,110,103
49315,20135,40.1,64696,29303,9910,10225
49316,20073,37.9,80434,32398,9594,10479
49318,1572,38,49375,20242,834,738
49319,15987,35.2,57622,22064,8168,7819
49320,16,63.5,-666666666,19750,3,13
49321,16115,32,49067,24566,7999,8116
49322,1313,38.8,39500,17357,629,684
49323,9578,33.3,70093,24331,4771,4807
49325,1625,39.2,62083,27878,817,808
49326,3943,41.2,52792,23281,2050,1893
49327,8426,36.5,48913,20125,4355,4071
49328,4195,38.5,52863,21266,2156,2039
49329,8646,33.9,46217,18890,4289,4357
49330,5277,35.3,48944,19788,2712,2565
49331,17266,38,62744,25446,8603,8663
49332,3081,52.2,43831,23497,1521,1560
49333,11239,36.8,62591,24701,5574,5665
49335,534,37.1,71674,20847,272,262
49336,4844,34.4,39858,15807,2387,2457
49337,11682,44.5,40852,22241,5985,5697
49338,1586,40.9,44130,23411,904,682
49339,2453,38.6,53558,22275,1207,1246
49340,2945,41.3,42017,20984,1517,1428
49341,33588,38.2,74626,29768,16118,17470
49342,2018,34,44400,17951,876,1142
49343,5441,40.5,46827,20447,2681,2760
49344,3652,47.2,52389,26657,1869,1783
49345,13572,36.8,56000,25637,6475,7097
49346,5331,50.1,46802,24099,2714,2617
49347,1067,47.4,39297,22114,561,506
49348,12007,38.5,53665,24147,6184,5823
49349,8220,43.4,37453,18977,4212,4008
49401,19903,21.3,43889,16084,9226,10677
49402,1400,54.6,36667,22672,746,654
49403,2221,44.3,65964,30808,1116,1105
49404,8961,34.3,56798,22809,4672,4289
49405,1439,47.6,37969,21200,770,669
49406,778,56,45750,32484,400,378
49408,8944,41.7,39286,20745,4444,4500
49410,2047,44.9,33381,19754,1043,1004
49411,1523,47.1,44450,25531,823,700
49412,11292,42.3,47458,22965,5416,5876
49415,6260,44.3,51587,26853,3244,3016
49417,29759,40.7,53249,28816,14540,15219
49418,27524,36.1,58814,27236,13631,13893
49419,7757,37.8,61465,24998,4006,3751
49420,7408,38.2,34804,16461,3730,3678
49421,5829,42.7,37880,18033,2984,2845
49423,45291,32.6,47522,23356,21834,23457
49424,44524,36.5,55297,25302,22280,22244
49425,3756,33,40341,17022,1878,1878
49426,34183,34.5,70507,27612,16764,17419
49428,26315,36,57859,26127,12639,13676
49431,16935,44.6,41818,24385,8023,8912
49434,6,-666666666,-666666666,,0,6
49435,3286,45.1,63241,28120,1646,1640
49436,1436,54.1,39038,21688,808,628
49437,6990,41.7,49232,23313,3273,3717
49440,1008,41.9,21397,19579,486,522
49441,36322,41.4,42926,24094,17337,18985
49442,42437,34.2,29883,14908,21871,20566
49444,27091,36.2,29588,15912,13370,13721
49445,20655,42.1,54656,26252,9986,10669
49446,2599,41.6,47179,21335,1266,1333
49448,3393,35.6,45909,20631,1682,1711
49449,2382,58.1,51576,28338,1156,1226
49450,2926,36,42179,14549,1499,1427
49451,6129,36.2,51291,20672,3133,2996
49452,1718,39.8,40968,18657,874,844
49453,2704,46.6,60795,34211,1223,1481
49454,4738,40.5,41364,18853,2502,2236
49455,4615,41.3,38083,18323,2272,2343
49456,18976,44.5,57262,32215,8817,10159
49457,10798,39.6,51649,23056,5319,5479
49458,52,64,53750,30210,22,30
49459,1274,45.9,38971,17319,632,642
49460,8473,38.5,65230,26379,4572,3901
49461,8678,45.2,53356,24978,4307,4371
49464,28202,33.9,64517,24303,13913,14289
49503,35157,29.1,32110,19236,17713,17444
49504,39533,33,40808,21940,19718,19815
49505,31380,35.6,44710,23188,15144,16236
49506,33159,32.6,65260,34462,15974,17185
49507,37418,27.7,34774,14871,18452,18966
49508,40609,36.5,48616,23514,19426,21183
49509,26466,32,42181,18165,13583,12883
49512,16269,30.6,46191,25605,7592,8677
49519,28019,32.6,44291,22651,13649,14370
49525,27483,38.6,56890,31286,13181,14302
49534,21528,36.3,58125,27971,10541,10987
49544,8853,38.3,45773,23953,4484,4369
49546,31140,40.7,67412,35169,14729,16411
49548,29775,33.5,39210,18179,14819,14956
49601,21155,41.9,42090,22730,10496,10659
49611,237,47.9,37500,14559,132,105
49612,1151,51.3,46063,23632,608,543
49613,596,59.5,53281,31777,295,301
49614,2890,47.2,45877,22764,1458,1432
49615,4232,53.7,46697,27282,2010,2222
49616,1884,45.7,39145,18568,948,936
49617,3443,50.4,48972,25351,1780,1663
49618,786,45.1,40481,18662,440,346
49619,1007,55.2,31696,18180,523,484
49620,2349,35.7,43882,17554,1120,1229
49621,3006,47.9,52743,26412,1490,1516
49622,2542,49.5,41612,23503,1288,1254
49623,1041,54.4,35590,16084,563,478
49625,1283,50.1,40217,28339,668,615
49626,459,54.5,50833,21956,207,252
49627,144,53.8,59018,34935,67,77
49628,251,46.8,32292,19578,135,116
49629,2251,50.3,46318,26321,1045,1206
49630,1387,56.3,62308,35782,693,694
49631,5659,48,35570,18278,2884,2775
49632,1164,43,38106,17773,573,591
49633,3475,47.1,41728,22758,1793,1682
49634,144,39.9,34750,12079,65,79
49635,3799,52.4,47444,28864,1843,1956
49636,447,59.1,65139,32707,238,209
49637,3013,33.3,44745,19565,1460,1553
49638,831,48.5,34306,19228,424,407
49639,2617,40.7,41570,17687,1248,1369
49640,1406,53.8,45714,25224,681,725
49642,941,52.9,23958,14967,413,528
49643,6204,38,43580,19427,3122,3082
49644,1853,54.6,32716,18568,991,862
49645,1576,47.1,33438,17966,809,767
49646,8207,41.1,39481,20068,4106,4101
49648,2002,55.1,63438,36365,935,1067
49649,8115,35.9,51406,18072,4786,3329
49650,3340,39.2,64409,26979,1635,1705
49651,7739,45.2,38229,19748,3868,3871
49653,1973,49.5,46429,28517,979,994
49654,654,59.5,70833,41245,367,287
49655,3264,41.5,41853,17963,1688,1576
49656,1526,47,29667,14262,836,690
49657,3695,37.2,45625,21410,1896,1799
49659,6922,41.9,38445,17281,3582,3340
49660,13920,46.9,42102,22463,7397,6523
49663,6198,38.6,42605,17146,3136,3062
49664,2054,51.6,47557,28507,990,1064
49665,4323,43.1,39082,17891,2171,2152
49666,86,49.8,-666666666,36315,46,40
49667,503,50,31375,23314,293,210
49668,3562,41,36270,16368,1869,1693
49670,1956,62.7,58190,37675,958,998
49674,70,69.3,43690,20604,26,44
49675,1151,51.2,52639,35416,513,638
49676,3265,48.4,39425,23178,1707,1558
49677,7137,39.6,32955,17527,3448,3689
49679,1473,46.2,41397,18306,707,766
49680,2060,39.5,44155,19264,993,1067
49682,4186,48.7,48237,27316,2057,2129
49683,2103,44.4,37027,19392,1049,1054
49684,38597,42.1,52852,28556,18406,20191
49686,32271,44.7,51104,30748,15395,16876
49688,2621,42.7,48750,20539,1368,1253
49689,1517,53,35694,18595,790,727
49690,6500,45.2,73201,37762,3343,3157
49701,865,47.4,39766,23443,417,448
49705,968,31.6,36563,14040,473,495
49706,4510,41.8,38852,19667,2299,2211
49707,22429,46.3,38416,22672,11023,11406
49709,3693,55.1,34623,19738,1949,1744
49710,468,56,61250,33355,280,188
49712,7848,42.9,46356,23657,3804,4044
49713,1987,42.4,50720,25337,980,1007
49715,3103,41.2,51821,23604,1590,1513
49716,863,43,45982,23607,427,436
49717,142,38.8,61750,85506,66,76
49718,806,54.7,48319,21733,407,399
49719,1342,55.3,36335,24265,713,629
49720,9186,46.7,46145,30612,4481,4705
49721,14315,47.9,36482,22628,7007,7308
49722,220,39.7,41838,23421,91,129
49724,1134,40.1,54417,22644,600,534
49725,655,59.9,35179,24354,335,320
49726,1029,59.9,42802,27000,553,476
49727,7222,46.2,43119,25045,3705,3517
49728,310,59,33750,24271,178,132
49729,1520,45.4,44934,23464,756,764
49730,2044,39.8,51534,21443,1072,972
49733,2042,47.3,38924,20811,1076,966
49735,19658,42.5,48102,24875,9605,10053
49736,504,60.3,37361,21442,239,265
49738,9851,47,39739,21661,5000,4851
49740,6884,52.1,63517,39334,3374,3510
49743,782,48.3,35217,17369,383,399
49744,860,49.8,43787,21023,432,428
49745,1217,48.2,45625,21870,624,593
49746,3742,52.1,39418,20114,1920,1822
49747,1779,52.4,34783,21866,826,953
49748,113,58.3,25313,15518,54,59
49749,4194,49,42006,28831,2139,2055
49751,1765,47.7,42031,21718,880,885
49752,857,40.6,39250,16747,574,283
49753,2097,47.3,40361,19896,1080,1017
49755,1914,46.2,42313,22392,993,921
49756,3736,51.7,34248,19080,1807,1929
49757,516,43.2,47143,28930,194,322
49759,1531,56.4,38611,23626,809,722
49760,608,53.3,45521,22031,297,311
49762,549,57.3,39417,26882,279,270
49764,155,33.3,63542,16550,101,54
49765,4045,49.1,35243,20475,1938,2107
49766,2468,43.9,34744,21201,1191,1277
49768,460,54.2,42778,25859,239,221
49769,1804,38.4,42583,19546,887,917
49770,17038,40.4,52267,31007,8313,8725
49774,2080,47.6,46295,24847,1117,963
49775,76,64.4,38472,27587,41,35
49776,1839,51.4,40286,21116,934,905
49777,1715,58.9,48214,28592,859,856
49779,4676,51.7,40000,23434,2343,2333
49780,1863,41.3,49688,22615,936,927
49781,4303,44.2,39838,23000,2101,2202
49782,610,57.5,43571,25541,322,288
49783,19843,37.1,38118,22311,9992,9851
49788,6415,33.3,39625,9042,4940,1475
49791,251,59.1,43846,20368,117,134
49793,377,51.7,38125,22228,203,174
49795,2062,47.7,37891,21130,1060,1002
49796,361,51.9,65625,36753,171,190
49799,2421,44,38517,18140,1316,1105
49801,11447,44.5,45067,27121,5645,5802
49802,6467,46.3,38262,22914,3116,3351
49805,303,47.3,56875,27557,161,142
49806,521,59.7,41382,29199,244,277
49807,3357,45.3,48264,23245,1738,1619
49808,258,58.5,43125,29241,133,125
49812,939,45.1,38988,19418,487,452
49814,1482,43.8,50278,23547,779,703
49815,580,45.5,40804,20244,311,269
49816,906,52.5,40938,19305,465,441
49817,514,49.5,36250,20528,252,262
49818,978,48.9,43021,20825,505,473
49819,21,73.7,75313,26781,11,10
49820,216,67.1,29625,21099,125,91
49821,1255,52.6,41905,23082,669,586
49822,272,50.4,40096,18320,116,156
49825,295,52,34250,26648,159,136
49826,143,51.8,33542,25076,81,62
49827,959,43,31731,19777,516,443
49829,17445,43.1,34212,20661,8304,9141
49831,704,49,57708,24838,373,331
49833,115,60.7,57750,24561,52,63
49834,276,46.4,24375,17882,143,133
49835,796,55.9,37266,21142,378,418
49836,931,49.7,34375,18782,479,452
49837,9561,47.4,51040,25452,4780,4781
49838,481,53.6,30000,15033,251,230
49839,261,63.7,31167,19814,123,138
49840,830,53.5,38333,24054,438,392
49841,7466,40,43352,21379,4046,3420
49847,922,48.4,36354,20396,438,484
49848,142,57.5,46250,30529,72,70
49849,12604,42.4,43838,23118,5962,6642
49852,97,68.5,27969,19810,45,52
49853,1415,49.3,46333,23382,708,707
49854,6456,49,33125,20806,3155,3301
49855,33767,34.7,45969,24572,17308,16459
49858,11935,46.1,41324,22610,5930,6005
49861,454,59,43021,23330,204,250
49862,4795,44.2,38659,19792,2581,2214
49863,114,33.5,70417,22803,61,53
49864,63,54.5,34063,18189,46,17
49866,7966,39.6,52058,24777,3854,4112
49868,5173,42.6,36297,17456,3098,2075
49870,3382,42.8,39518,20241,1606,1776
49871,611,35.1,32500,15452,353,258
49872,171,40.6,37143,20358,93,78
49873,116,38.3,27292,13156,50,66
49874,1208,46.9,35729,19398,584,624
49876,985,51.1,54085,22705,514,471
49877,39,53.5,59375,24162,20,19
49878,3713,48.4,46709,24115,1959,1754
49879,950,52,34861,21244,427,523
49880,1079,49.1,40000,21323,573,506
49881,341,50.3,49167,20621,175,166
49883,81,52.5,38125,18904,41,40
49884,711,40.8,30278,9827,443,268
49885,1626,48.9,48063,24321,903,723
49886,472,45.6,33750,18092,247,225
49887,2574,50.1,39844,21683,1265,1309
49891,732,54.1,32727,19820,367,365
49892,1929,51.4,52736,27668,1056,873
49893,2008,47.9,59696,27882,1107,901
49894,660,44.4,44044,20173,337,323
49895,785,43.6,51071,20166,578,207
49896,1566,38.1,36779,18476,767,799
49901,273,49.4,32708,23576,111,162
49902,97,58.1,23000,16338,42,55
49903,162,41.6,38125,19209,75,87
49905,1852,34.6,51372,19636,1003,849
49908,3682,35.8,33906,10975,2766,916
49910,391,58,31438,20962,168,223
49911,2744,47,33008,22520,1365,1379
49912,943,53.8,33365,21935,517,426
49913,7599,39.7,32588,17495,3855,3744
49915,554,39.9,26250,17918,279,275
49916,2548,39.7,49853,26050,1366,1182
49917,261,37.5,29063,12457,142,119
49918,124,57.5,35000,30985,58,66
49919,230,54.8,52188,20709,115,115
49920,4224,53.7,39063,21605,2092,2132
49921,260,49.6,28750,16839,130,130
49922,736,43.6,32986,22122,379,357
49925,497,47.2,41250,22953,266,231
49927,424,50.7,30000,16800,201,223
49929,224,46.5,29432,18595,133,91
49930,7026,36.9,33488,22619,3691,3335
49931,9904,22.4,30829,17693,6026,3878
49934,1012,36.6,34345,16496,454,558
49935,6234,51.8,32869,22183,3087,3147
49938,7762,46.5,32512,20423,3857,3905
49942,71,47.8,43375,21842,23,48
49945,2409,50.5,42500,24191,1221,1188
49946,3914,48.1,42165,21908,1780,2134
49947,1772,42.3,36000,12147,1469,303
49948,524,52,36429,22845,305,219
49950,1308,53.3,40990,23595,708,600
49952,125,47.6,36875,15381,87,38
49953,2952,52.9,35000,21829,1470,1482
49955,482,38.4,55800,17095,254,228
49958,1145,43.5,43580,20544,568,577
49959,358,39.6,33333,16893,182,176
49960,129,50.9,25750,17284,65,64
49961,94,62.7,24231,19650,45,49
49962,137,65.9,40000,25074,76,61
49963,978,34.5,30833,15824,572,406
49965,478,56.6,48906,25686,240,238
49967,480,61.4,33409,21082,249,231
49968,2320,51.1,34203,20311,1207,1113
49969,1352,57.6,43875,27180,617,735
49970,235,62.3,55682,26821,116,119
49971,392,60.5,35000,20791,210,182
50001,825,35.3,46908,20904,443,382
50002,1338,41.3,40550,23974,681,657
50003,6921,42,65588,36186,3418,3503
50005,668,50,49239,22550,375,293
50006,1528,40.9,49146,24332,750,778
50007,619,44.6,73750,32623,332,287
50008,920,39.3,37091,18177,432,488
50009,16687,35.4,64798,31113,8026,8661
50010,29802,29.6,48189,28601,15286,14516
50011,1913,19,-666666666,5994,915,998
50012,3699,19.3,-666666666,6220,2286,1413
50014,28064,23,37661,24427,15010,13054
50020,1554,43.2,47143,22354,707,847
50021,21778,33.6,73377,35161,11122,10656
50022,8028,45.4,40703,26177,3883,4145
50023,29494,31.7,76270,32362,14947,14547
50025,3294,47.5,49457,32624,1635,1659
50026,638,46.6,34063,20637,353,285
50027,313,39.2,37500,16547,178,135
50028,1553,46.2,58214,27689,757,796
50029,737,50.1,49891,28283,399,338
50032,429,26.8,17321,16779,221,208
50033,33,45.9,76042,32136,26,7
50034,356,48.7,48438,23781,183,173
50035,5458,31,62389,25050,2700,2758
50036,16052,39.4,49792,27125,7775,8277
50038,114,45.7,47031,28857,51,63
50039,463,46.3,66914,32474,248,215
50041,92,60.3,43571,24537,41,51
50042,342,48.3,35250,20711,140,202
50044,1123,44.8,47411,18463,577,546
50046,1395,38,65781,31627,693,702
50047,5447,38.7,59663,26368,2703,2744
50048,848,45.1,49722,25347,409,439
50049,6754,42.6,42247,20131,3283,3471
50050,553,44.4,44286,24521,280,273
50051,391,48.8,68636,48572,194,197
50052,245,50.2,49375,27505,117,128
50054,3371,37.1,46802,22555,1621,1750
50055,859,41.3,63920,26067,487,372
50056,1349,41.9,53000,25026,732,617
50057,281,25.9,53512,16418,157,124
50058,2042,42.8,48412,26776,1011,1031
50060,2304,45.7,43226,25477,1056,1248
50061,1676,47.8,108095,62293,791,885
50062,640,49.4,35625,23853,302,338
50063,2837,37.4,72283,30235,1468,1369
50064,79,33.8,35417,18286,42,37
50065,522,43.7,43125,21606,244,278
50066,260,30.1,36875,20718,137,123
50067,321,34.7,56875,26369,153,168
50068,416,32.3,44607,21565,201,215
50069,1228,35.2,54000,21735,597,631
50070,1426,42.1,67895,34001,717,709
50071,869,55,52222,31705,442,427
50072,2807,38,62500,27165,1419,1388
50073,1029,34.1,61103,29361,569,460
50074,300,61.4,39808,30400,157,143
50075,918,40.8,54722,27019,430,488
50076,1402,45.5,45109,30641,646,756
50078,115,62.8,44792,22248,53,62
50101,88,40.5,56250,30900,52,36
50102,44,58.8,163011,93264,31,13
50103,373,46.3,41528,22546,197,176
50104,153,35.4,46042,20136,87,66
50105,1389,33.5,80703,26997,764,625
50106,939,43,52986,29065,413,526
50107,1152,40.6,47500,20707,597,555
50108,542,51.1,32974,16522,240,302
50109,2812,35.2,86211,31943,1489,1323
50111,9939,34.8,75816,34299,4577,5362
50112,11752,37.3,49248,24195,5522,6230
50115,2670,42,44120,23073,1293,1377
50116,174,43.3,38333,22395,87,87
50117,205,41.7,73438,30211,94,111
50118,970,45.1,59453,28629,471,499
50119,574,53,54375,28334,297,277
50120,291,40.3,66563,28528,177,114
50122,1648,45.2,55250,25435,821,827
50123,791,51.2,35000,21882,418,373
50124,3662,35,66105,30645,1762,1900
50125,19543,38.3,59072,27390,9173,10370
50126,6770,43.5,46986,25843,3346,3424
50127,0,-666666666,-666666666,-666666666,0,0
50128,362,41.7,46042,36846,187,175
50129,5128,48.2,45933,29027,2431,2697
50130,1517,37.8,58750,28984,734,783
50131,18263,38.1,93308,42317,8746,9517
50132,320,47,41875,20915,178,142
50133,515,33.6,36563,17794,273,242
50134,590,48.2,62813,28422,297,293
50135,1666,42.8,55469,24718,886,780
50136,406,36.7,49167,23725,181,225
50138,11830,37.8,49214,23485,5986,5844
50139,1432,46.6,50074,23060,768,664
55973,298,44.5,64750,31553,149,149
55974,2129,48.4,42500,24941,1093,1036
55975,4435,43,54519,26437,2210,2225
55976,7480,37.5,53616,26641,3583,3897
55977,181,40.2,69167,27001,90,91
55979,1049,32.8,59038,22540,577,472
55981,4131,48.5,45945,29349,1957,2174
55982,431,47.1,61125,31973,227,204
55983,1499,43.5,51212,25981,769,730
55985,2086,33.3,59444,25424,1021,1065
55987,35624,31.5,44620,23098,16989,18635
55990,830,43.9,55417,29831,417,413
55991,1254,47.1,65192,32900,641,613
55992,5069,37.1,57500,26401,2425,2644
56001,46689,27.6,44926,24452,23170,23519
56003,14236,37.2,62726,30022,7021,7215
56007,21131,44.8,39647,24871,10249,10882
56009,1602,45.7,56912,28298,828,774
56010,1204,48.8,52885,29868,617,587
56011,8835,33.7,68508,27937,4105,4730
56013,4406,46.7,43068,25589,2144,2262
56014,714,48.1,41932,25732,343,371
56016,929,37.9,58359,30334,472,457
56017,1627,43.9,62500,29848,846,781
56019,1012,43.1,54875,25477,522,490
56020,122,34.3,44167,22822,58,64
56021,1059,41.2,69167,30927,558,501
56022,85,39.2,30417,18896,41,44
56023,563,48.8,54464,27785,294,269
56024,2841,32.2,69485,26984,1371,1470
56025,507,45.9,62361,32215,268,239
56026,1863,41.5,63542,28458,933,930
56027,1013,38.1,38750,20865,547,466
56028,1160,50.7,72679,33839,536,624
56029,716,48.2,50089,23221,374,342
56031,12289,46.7,47652,27160,6042,6247
56032,305,44.1,49375,26408,151,154
56033,361,48.3,45139,26530,182,179
56034,645,40.2,64063,27155,340,305
56035,506,44,57222,22950,241,265
56036,2028,42.1,52557,26214,1062,966
56037,1509,44.9,64904,27222,748,761
56039,928,41.2,47232,23925,468,460
56041,1025,40.4,56875,29174,524,501
56042,669,50.1,61528,28536,342,327
56043,455,46.9,66042,33508,234,221
56044,2154,43.8,60147,28352,1125,1029
56045,843,40.6,51667,25087,454,389
56046,53,49.8,39167,24813,21,32
56047,153,47.3,58417,24505,68,85
56048,3758,37,54828,25537,1972,1786
56050,1567,44.3,53281,24727,734,833
56051,747,46.9,39464,23251,395,352
56052,909,38.8,53750,25057,475,434
56054,989,38.2,54271,29922,522,467
56055,3917,39.1,66156,28170,2013,1904
56056,71,29.9,52083,30041,40,31
56057,3801,39.8,57000,27087,1881,1920
56058,5837,41.6,55068,27556,2921,2916
56060,453,46,45625,31617,249,204
56062,3180,39.9,53242,27591,1641,1539
56063,2766,43.1,71935,38041,1449,1317
56065,2874,36,53688,23885,1481,1393
56068,1001,46.4,50156,29574,496,505
56069,4428,39,56553,24386,2323,2105
56071,11958,37.5,68770,31304,6012,5946
56072,2112,44.1,54866,24246,1123,989
56073,16637,42.7,49064,27131,8332,8305
56074,2006,40.8,58125,29051,1061,945
56075,262,31.4,47778,16234,134,128
56078,510,34.5,54063,25259,265,245
56080,608,32.3,54000,23340,326,282
56081,6004,38.2,47029,24101,2933,3071
56082,13806,28.5,57841,22684,6727,7079
56083,913,44.8,55234,23080,418,495
56085,5340,43.9,49875,26341,2658,2682
56087,3144,46.2,45590,24801,1489,1655
56088,1880,49,56200,27520,912,968
56089,229,33.3,40795,20127,127,102
56090,724,42.1,51161,25673,365,359
56091,263,50.9,48438,26373,129,134
56093,13316,39,53561,25925,5970,7346
56096,3090,45.3,49831,25321,1564,1526
56097,3732,45.1,44727,24571,1880,1852
56098,2061,46.9,49276,24970,1066,995
56101,5782,47.3,43648,24854,2695,3087
56110,1980,39.9,52222,26952,991,989
56111,467,34.5,75625,36450,256,211
56113,255,42.8,51250,26313,133,122
56114,386,43.4,60250,28059,205,181
56115,1165,48.9,50000,25771,604,561
56116,615,38.1,52917,25668,306,309
56117,398,43.8,61875,24634,195,203
56118,452,35.4,61875,26025,243,209
56119,1128,41.5,53261,25258,571,557
56120,1097,45.7,50703,24761,565,532
56121,623,46.2,46563,24306,329,294
56122,507,46.4,49375,27736,259,248
56123,436,53.2,45625,23813,217,219
56125,64,68.1,23125,18620,32,32
56127,434,47.5,57981,31340,225,209
56128,2075,44.4,50595,23835,1053,1022
56129,745,46.1,45469,24117,366,379
56131,2373,47,47946,25548,1163,1210
56132,527,48.6,53625,29316,262,265
56134,420,36.3,50938,20586,226,194
56136,1039,48.8,44211,25146,498,541
56137,1058,43.6,53036,25630,523,535
56138,900,38.6,48875,24046,431,469
56139,425,49.1,39583,25514,225,200
56140,41,63.8,28125,24695,21,20
56141,332,45,42188,22549,146,186
56142,949,50.9,45625,25596,468,481
56143,4509,44.7,49105,27408,2224,2285
56144,1011,47.6,40156,24931,460,551
56145,614,35.6,51154,23316,325,289
56146,50,49.3,41250,22408,28,22
56147,151,38.3,51250,22953,71,80
56149,1322,45.1,42955,28853,659,663
56150,2720,40.8,50650,25163,1399,1321
56151,842,42.1,55625,29372,442,400
56152,1579,46.3,46523,27780,829,750
56153,140,57,40625,24032,65,75
56155,487,41.4,47375,24754,251,236
56156,6052,43.5,42703,24121,2955,3097
56157,789,35.9,65357,29828,416,373
56158,487,45.1,56250,22991,255,232
56159,3022,41.2,45000,21102,1509,1513
56160,192,36.6,43438,36930,86,106
56161,326,50.1,49318,27994,172,154
56162,309,50.7,43068,26429,157,152
56164,5911,42,47522,26132,2889,3022
56165,376,41,64375,24106,190,186
56166,272,38,48750,21142,152,120
56167,678,42.8,43750,25594,326,352
56168,812,50.1,52604,30784,428,384
56169,753,37.6,57143,27050,361,392
56170,566,44.4,48900,25507,287,279
56171,1770,41,49125,26306,889,881
56172,3157,45.6,55027,27932,1548,1609
56173,430,38.1,51875,20692,225,205
56174,339,47.3,39712,21998,178,161
56175,3088,45.2,46985,25339,1494,1594
56176,1072,43.9,45078,25156,488,584
56177,37,54.5,63000,30992,16,21
56178,1721,44.1,51667,26191,855,866
56180,1407,37,42250,21744,692,715
56181,1148,41.9,43269,21682,590,558
56183,1258,46.8,50565,23455,602,656
56185,526,46.7,42500,22807,247,279
56186,363,40.8,47885,28026,185,178
56187,14186,33,47449,20923,7399,6787
56201,23064,37,44851,25547,11647,11417
56207,233,45.5,53214,25410,122,111
56208,2123,46.7,40670,24148,1045,1078
56209,2245,42.9,54152,29076,1099,1146
56210,17,57.5,250001,88847,9,8
56211,433,53.7,42500,33000,233,200
56212,545,46.4,44688,24247,287,258
56214,679,47.5,45875,26931,333,346
56215,4375,45.7,55040,28531,2254,2121
56216,634,42.1,57763,25077,329,305
56218,565,44.6,45268,21869,305,260
56219,890,43.3,29479,21523,470,420
56220,3033,47.7,46132,23643,1532,1501
56221,823,38.5,51786,24644,417,406
56222,1937,41.2,48125,24434,914,1023
56223,1262,46.8,50000,25680,630,632
56224,366,39.6,57083,29627,202,164
56225,672,50.7,40313,25333,297,375
56226,274,50.6,46250,31112,166,108
56227,208,51.4,62500,34305,112,96
56228,948,48.9,53315,27724,477,471
56229,1770,39.9,63603,30912,927,843
56230,867,34.8,55500,24596,391,476
56231,422,44.5,65750,28785,221,201
56232,2425,48.2,51484,28584,1135,1290
56235,510,49.2,46250,26077,276,234
56236,344,45.3,71607,38344,157,187
56237,663,37.6,55000,23929,362,301
56239,552,34.5,57212,27382,302,250
56240,916,49.5,54350,27681,388,528
56241,3986,44.8,53250,27511,1922,2064
56243,1661,41.4,44609,23331,780,881
56244,1414,31.7,51806,24871,792,622
56245,538,35.7,62143,29385,288,250
56248,763,51.3,49803,26773,390,373
56249,325,46.2,51667,25530,171,154
56251,1086,37.8,55972,23268,515,571
56252,1249,36,47656,21587,617,632
56253,1010,42.8,49667,27076,518,492
56255,314,40,51667,27535,170,144
56256,2526,52.6,50272,28649,1298,1228
56257,517,46.3,36941,25262,243,274
56258,15629,31.5,47605,25578,7633,7996
56260,892,47.1,50469,24474,431,461
56262,790,38.4,45938,24370,399,391
56263,456,46.6,47813,31781,254,202
56264,2181,42.9,54208,27131,1133,1048
56265,7621,42.7,50946,26611,3771,3850
56266,1718,34.6,50893,25703,832,886
56267,6965,30.8,56659,30554,3337,3628
56270,924,29.6,45521,21295,483,441
56271,1250,38.2,52875,24805,645,605
56273,4959,42.7,59596,26583,2470,2489
56274,148,42.5,48500,23642,79,69
56276,318,51.1,38333,22307,188,130
56277,2965,42.8,50579,25611,1481,1484
56278,2876,48.3,45509,24521,1414,1462
56279,1419,34.3,51563,20024,737,682
56280,576,44.3,58889,27650,344,232
56281,602,40.3,59375,30834,305,297
56282,1523,35.6,52639,23738,800,723
56283,6500,46.4,46605,26598,3217,3283
56284,2198,41.2,51190,25188,1038,1160
56285,1149,40.2,47386,22281,581,568
56287,91,38.3,32188,16993,40,51
56288,4612,50.5,63682,36157,2329,2283
56289,671,47.7,57159,26149,335,336
56291,529,40.6,57813,23744,301,228
56292,612,37.5,47917,22816,303,309
56293,1147,42.6,51618,28394,567,580
56294,62,58.6,50000,33121,33,29
56295,352,47.6,43375,22576,191,161
56296,2045,49.2,49213,28068,1046,999
56297,842,40.4,54500,27085,426,416
56301,32766,24.9,49198,23861,16963,15803
56303,25909,35.6,45366,25298,13487,12422
56304,16045,30.8,36565,21246,8302,7743
56307,5094,38.2,60098,26637,2596,2498
56308,24063,44.1,49706,28217,11836,12227
56309,1216,49.9,52465,29791,623,593
56310,5273,40.7,66181,30008,2831,2442
56311,686,52.3,47727,24357,322,364
56312,2335,41.7,52195,25890,1246,1089
56313,79,41.7,27500,15908,42,37
56314,1395,35.4,56983,24239,761,634
56315,1750,45.1,56927,26459,965,785
56316,1456,38.4,45893,23265,773,683
56318,1116,47.3,58125,31110,578,538
56319,1522,38.2,65428,28252,819,703
56320,7949,39.4,64754,29723,3954,3995
56321,1622,19.8,-666666666,13536,1499,123
56323,588,39.8,52800,27369,315,273
56324,1220,40.9,59531,28109,645,575
56325,152,50,46875,26224,78,74
56326,1484,45,44327,26960,728,756
56327,696,46.5,62250,31487,379,317
56328,86,44.2,55833,28843,47,39
56329,7352,36.6,58906,24381,3913,3439
56330,1759,35.1,60515,23488,897,862
56331,1868,35,61713,28371,972,896
56332,1190,47.7,59615,35312,600,590
56334,5382,48.2,48896,28443,2699,2683
56335,185,53.1,49643,23793,97,88
56336,1582,49.7,53438,33116,811,771
56338,1723,46.8,45917,23071,874,849
56339,1143,41.5,42788,20355,552,591
56340,2336,37.1,57109,25983,1184,1152
56342,2729,49.6,41357,23682,1422,1307
56343,930,42.4,48417,24153,461,469
56345,14947,42.6,43013,23994,7397,7550
56347,7092,38.3,46754,21176,3543,3549
56349,768,35.4,60795,26799,415,353
56350,573,51.4,38125,22569,312,261
56352,5976,38.9,50870,22731,3069,2907
56353,8606,38,52729,24945,4367,4239
56354,1354,50.2,49783,26766,707,647
56355,527,42.9,55833,22731,281,246
56356,311,47.3,39750,22424,164,147
56357,1082,37.1,58859,23008,539,543
56358,3353,41.2,49091,20779,1762,1591
56359,4090,38.6,38250,18228,2032,2058
56360,4309,43.5,47958,23074,2190,2119
56361,2358,46.3,40000,21915,1148,1210
56362,5602,47.4,55399,26833,2791,2811
56363,124,28,51250,20093,70,54
56364,5224,38.3,49972,22483,2603,2621
56367,6443,39.3,61677,28594,3494,2949
56368,4534,41.8,60461,26453,2354,2180
56369,575,25.5,41429,15323,253,322
56371,132,52.1,51250,26395,74,58
56373,2913,35.1,55000,24173,1489,1424
56374,9908,25.1,62594,24136,3706,6202
56375,811,40.5,75000,28080,429,382
56376,353,29.4,66806,25223,176,177
56377,17816,34.2,72515,31334,8477,9339
56378,7789,42.4,51311,24971,3970,3819
56379,16187,33,57662,26039,7607,8580
56381,2336,48.7,54875,31268,1161,1175
56382,1631,39.7,50714,21912,863,768
56384,367,39,36833,21697,165,202
56385,1089,38.4,58875,26287,560,529
56386,758,53.4,35417,22634,383,375
56387,6659,32.5,39436,24881,3224,3435
56389,107,32.4,50625,20653,50,57
56401,29231,39.4,44553,24409,14564,14667
56425,7600,38,60509,33647,3722,3878
56431,9132,51.6,45136,26719,4642,4490
56433,1618,49.4,43667,23986,791,827
56434,303,28.1,54583,15737,142,161
56435,2767,44.2,43405,21010,1396,1371
56436,69,54.1,48125,12733,45,24
56437,1380,35.2,37000,17723,727,653
56438,2876,43,46375,21609,1548,1328
56440,1453,37.1,39526,19118,720,733
56441,3492,47.5,30491,23127,1639,1853
56442,2366,59.1,63500,39863,1198,1168
56443,1439,54.9,47000,27487,793,646
56444,2970,56.4,47642,28694,1521,1449
56446,1483,47.3,44015,24520,791,692
56447,1147,54.9,37554,22733,598,549
56448,341,64.6,43542,27818,179,162
56449,2034,37.9,52974,22709,1066,968
56450,1032,54.4,36442,21886,508,524
56452,1908,57,45789,29235,1047,861
56453,855,41,50089,21875,440,415
56455,1640,37.5,46542,20729,768,872
56456,43,27.3,24250,14658,21,22
56458,338,50,42188,24137,173,165
56461,3315,41.8,49946,23533,1663,1652
56464,4336,42.2,41636,22134,2187,2149
56465,2045,48.9,46176,27094,1098,947
56466,3109,41.8,44942,21641,1613,1496
56467,2383,51.5,46029,26775,1232,1151
56468,5214,50.3,60114,32498,2669,2545
56469,893,57.8,45625,26702,451,442
56470,10390,48.2,43961,24361,5177,5213
56472,7393,41.8,49342,26873,3702,3691
56473,3422,42,52604,24701,1777,1645
56474,3378,49.4,43631,25704,1754,1624
56475,1647,36,49048,22349,846,801
56477,2550,43.7,39025,20543,1275,1275
56479,4865,43,37474,21021,2352,2513
56481,2260,43.3,41638,21163,1192,1068
56482,6623,41.6,35060,19901,3276,3347
56484,3315,48.4,48068,26359,1639,1676
56501,16260,44.2,51207,27286,7936,8324
56510,2240,43.5,41500,24173,1075,1165
56511,1899,44.1,59706,31148,1006,893
56514,3621,37.1,59088,28598,1821,1800
56515,3207,54.5,48112,29485,1593,1614
56516,279,37.8,42321,18431,156,123
56517,295,49.6,54375,27546,163,132
56518,356,39.8,44583,21426,175,181
56519,335,50.6,48750,24025,183,152
56520,4021,43.3,49348,24524,1968,2053
56521,916,39.9,45139,20401,477,439
56522,677,40.2,54375,23105,337,340
56523,549,40.1,45938,22201,270,279
56524,751,53.3,46667,26526,402,349
56525,177,36,73333,28615,114,63
56527,813,41.5,40170,19508,428,385
56528,1554,54.6,46319,28350,813,741
56529,4047,32.2,46116,21554,2140,1907
56531,2035,43.4,50658,26992,1024,1011
56533,297,43.6,45714,23576,170,127
56534,1130,48.8,50489,32175,573,557
56535,1425,48.4,50455,25566,702,723
56536,468,42,62500,34743,255,213
56537,18597,43.7,48919,26690,9050,9547
56540,1961,45.3,44280,32051,965,996
56541,36,71.1,60625,16803,24,12
56542,2964,43.3,45875,23455,1484,1480
56543,266,36.3,54167,23215,128,138
56544,5196,40.8,47121,24902,2605,2591
56545,655,47.1,53333,28038,358,297
56546,410,37.9,59500,24500,195,215
56547,2866,34.3,67163,26458,1510,1356
56548,753,46.4,42031,22908,371,382
56549,4410,38.2,62019,28924,2176,2234
56550,364,41.6,49583,24906,182,182
56551,2123,51.7,41875,22322,994,1129
56552,434,42.8,51667,30063,244,190
56553,273,40.1,51458,26487,154,119
56554,2525,43.8,58875,27392,1356,1169
56556,889,50.9,34554,22616,427,462
56557,2839,39,36397,19493,1476,1363
56560,41120,29.9,49574,23611,19997,21123
56565,145,43.3,53295,17874,89,56
56566,567,24.2,30500,14001,284,283
56567,3625,40.9,49200,23396,1846,1779
56568,191,48.5,29375,21377,90,101
56569,1282,34.8,36133,20657,587,695
56570,1260,47.8,48125,21611,690,570
56571,1570,54.6,42875,27335,834,736
56572,5392,47.4,48945,26132,2700,2692
56573,6252,45.6,53817,27354,3049,3203
56574,275,43.8,62083,27827,141,134
56575,694,42.2,32014,20189,345,349
56576,839,52,49107,24605,436,403
56577,17,66.5,-666666666,46735,8,9
56578,848,43.5,51797,24869,452,396
56579,957,46.8,46771,25796,525,432
56580,1290,36.2,70250,29184,656,634
56581,366,39.5,32386,20630,200,166
56583,134,47.5,61250,45127,77,57
56584,1626,44.1,45139,20986,818,808
56585,1051,46.5,45625,24192,513,538
56586,1798,49.4,58304,30548,954,844
56587,1498,49.9,52941,27387,789,709
56588,561,52.5,45313,22717,262,299
56589,2337,36.3,41490,19984,1157,1180
56590,345,51.8,61667,42601,184,161
56591,188,34.4,24583,11617,133,55
56592,610,29.9,41125,17244,328,282
56593,35,21.3,21250,14451,8,27
56594,355,49.8,59821,35819,179,176
56601,33418,34.8,46640,23926,16422,16996
56621,4691,42.2,40160,21299,2386,2305
56623,2491,48.8,40179,21976,1204,1287
56626,282,31,26786,15062,93,189
56627,251,55.2,32917,21625,119,132
56628,1479,58.5,41397,25043,720,759
56629,266,54.2,52321,25226,135,131
56630,1895,39.6,37700,17450,955,940
56633,4465,34.1,37477,18050,2295,2170
56634,1772,37.7,48409,22004,898,874
56636,4974,41.5,42402,20943,2510,2464
56637,226,43.9,36806,18577,119,107
56639,420,52.4,33529,20574,210,210
56641,329,49.6,34167,18476,168,161
56644,837,48.7,43250,20497,427,410
56646,346,47.9,46875,25424,190,156
56647,762,49.2,51932,24899,376,386
56649,9931,44.8,42048,27580,4857,5074
56650,683,51.2,41042,22885,367,316
56651,474,51.2,40250,23474,247,227
56652,439,48,44853,23908,219,220
56653,1433,50.4,41333,22783,778,655
56654,126,48,28295,15424,60,66
56655,1361,60.1,41842,27918,668,693
56657,195,60.8,49141,32393,99,96
56658,0,-666666666,-666666666,-666666666,0,0
56659,53,49.8,48750,36162,32,21
56660,291,43.1,32917,13915,167,124
56661,939,47.3,45938,20009,470,469
56662,500,63.9,40556,25322,277,223
56663,196,53,32019,17663,107,89
56666,855,21.8,11947,5973,451,404
56667,724,42.9,49808,21535,411,313
56668,138,58,49479,34107,81,57
56669,320,59.5,36000,21219,171,149
56670,1720,18.9,31438,10896,894,826
56671,3279,23.5,34099,10937,1806,1473
56672,2114,52.4,35972,23523,1037,1077
56673,759,51.6,50417,28230,446,313
56676,1475,48.5,48676,27623,774,701
56678,1137,43.9,46900,23776,562,575
56680,112,61.7,38125,25361,52,60
56681,310,46,38750,18694,156,154
56683,720,43.2,52857,23384,367,353
56684,266,42.5,36250,22891,149,117
56685,157,58,32188,25573,88,69
56686,1231,42.6,44703,19308,733,498
56687,62,41.5,44375,20119,34,28
56688,142,57.5,30625,26147,93,49
56701,12675,39.2,46701,24941,6263,6412
56710,568,30.8,51579,24898,273,295
56711,39,58.3,26635,40782,28,11
56713,886,52.7,51071,31430,455,431
56714,1179,43.2,45438,23816,640,539
56715,247,48.3,41500,21533,125,122
56716,9306,37.1,50863,24329,4827,4479
56720,46,49.5,31875,18498,26,20
56721,9997,36.1,53446,26509,4920,5077
56722,412,47,65125,30399,228,184
56723,819,38.8,65536,35732,426,393
56724,140,47,52500,20974,65,75
56725,1021,41.8,47857,22879,542,479
56726,1582,42.2,52235,27445,816,766
56727,815,44.1,52188,24987,447,368
56728,1402,47.8,56750,30876,676,726
56729,132,54.8,45000,18827,65,67
56731,69,46.4,67083,26990,37,32
56732,1055,47.5,42566,23008,484,571
56733,432,45.7,58594,34997,245,187
56734,451,48.1,38750,22932,247,204
56735,839,50.1,45625,27127,411,428
56736,1007,53.9,55104,29300,517,490
56737,872,46.4,43636,24259,444,428
56738,1454,35.9,57500,24952,778,676
56741,17,-666666666,-666666666,,17,0
56742,898,40.6,38929,21317,470,428
56744,555,42.2,62292,28654,305,250
56748,795,34.9,49605,22723,439,356
56750,2631,42.4,53272,24359,1349,1282
56751,5501,41.8,54464,25532,2826,2675
56754,503,42,50208,25821,251,252
56755,121,56.2,51250,30087,67,54
56756,743,37.6,47366,23485,348,395
56757,991,43.9,56953,29962,494,497
56758,392,51.1,41250,25144,195,197
56759,377,50.2,58889,28475,199,178
56760,405,34.3,45625,22611,198,207
56761,470,45.4,48750,23537,259,211
56762,2508,44.2,53352,26544,1246,1262
56763,5333,38.3,48596,25476,2634,2699
57001,1730,46.8,55278,24843,918,812
57002,933,29.2,54475,28417,532,401
57003,1936,35.6,67422,31166,1001,935
50140,3059,26.1,35076,15672,1555,1504
50141,640,41.7,52045,25381,352,288
50142,957,39.6,56719,25098,454,503
50143,635,38.6,65114,25060,334,301
50144,2696,41.1,39760,20892,1320,1376
50146,342,42.7,83750,32980,195,147
50147,496,50.3,41071,22807,253,243
50148,352,45.3,32625,19959,196,156
50149,870,39.2,34792,15776,407,463
50150,1113,41.1,39583,24827,566,547
50151,533,56,36071,24344,279,254
50153,897,44.2,68750,29796,474,423
50154,523,35.3,43958,26247,292,231
50155,274,31.2,46111,24800,137,137
50156,4242,42.5,56595,27462,2101,2141
50157,622,51.3,45800,30387,330,292
50158,31589,37.8,49767,23381,15762,15827
50160,515,33.4,55000,27164,232,283
50161,2058,43.4,61719,33077,1039,1019
50162,1227,40.3,58487,25362,649,578
50163,824,42,46111,21829,349,475
50164,514,41.2,43021,20846,260,254
50165,74,39.5,89063,27442,34,40
50166,1606,37.5,65809,25302,770,836
50167,588,48.9,55469,30419,298,290
50168,665,37.9,65486,27795,351,314
50169,3613,38.7,61167,29068,1532,2081
50170,2716,42.6,56027,26294,1451,1265
50171,2943,44.6,58355,28144,1485,1458
50173,842,45.7,58977,26608,451,391
50174,1250,45.7,43938,23579,626,624
50201,8139,40.4,56619,28908,4076,4063
50206,469,41.5,54167,23651,256,213
50207,2499,41,56934,23830,1211,1288
50208,20675,42.6,47060,23765,10743,9932
50210,1531,45.3,58571,30229,800,731
50211,11849,36,77815,32020,5914,5935
50212,3515,46.1,55263,27287,1814,1701
50213,7027,40.6,42917,23848,3469,3558
50214,808,43.2,89118,29157,382,426
50216,2740,49.5,60508,34609,1270,1470
50217,719,36.7,40769,24097,360,359
50218,110,47.8,48125,23099,52,58
50219,14190,34,66280,27260,6870,7320
50220,9213,34.9,45933,19204,4716,4497
50222,645,40.6,61771,32242,381,264
50223,423,47.8,34779,25361,225,198
50225,2736,38.7,57917,27295,1348,1388
50226,5306,40.8,111000,41012,2688,2618
50227,22,39,76250,22055,17,5
50228,2177,39.7,53421,25716,1001,1176
50229,713,41.5,93375,39460,341,372
50230,1314,42.1,68015,26035,712,602
50231,143,50.5,58750,32775,79,64
50232,485,43.2,63194,25976,258,227
50233,1441,44.5,50000,23725,731,710
50234,536,52.2,54861,28473,257,279
50235,343,49.7,44821,25086,177,166
50236,1783,34.6,62283,28748,857,926
50237,3052,45.9,76875,30076,1650,1402
50238,938,48,50185,24046,522,416
50239,146,35.7,49792,18916,68,78
50240,2815,38.8,70076,26744,1450,1365
50242,375,36.9,53646,24138,199,176
50243,250,41.4,41875,24763,130,120
50244,2102,33.3,74792,30064,1100,1002
50246,680,50.6,53958,30932,325,355
50247,2378,38.3,65147,26834,1204,1174
50248,4406,46.3,58561,31095,2018,2388
50249,1176,44.9,44219,25163,591,585
50250,2595,47.2,50296,23151,1383,1212
50251,1282,41.9,59013,30057,690,592
50252,133,60.8,47500,70024,66,67
50254,330,46.6,63523,27604,170,160
50255,62,33.5,53750,21616,23,39
50256,590,44.4,62206,25496,288,302
50257,875,38.5,60865,22724,463,412
50258,950,44.6,52132,22271,414,536
50261,2297,36.9,84194,31824,1112,1185
50262,539,45,34219,18459,257,282
50263,17390,32.1,81269,38552,8583,8807
50264,350,35.8,39063,23249,192,158
50265,32214,34.3,69272,36725,16455,15759
50266,24636,32.8,75144,44368,12427,12209
50268,1011,45.2,30625,16850,460,551
50271,806,34.9,42721,18795,404,402
50272,130,45.5,46250,27878,86,44
50273,8217,40.8,51113,27390,3928,4289
50274,358,47,56667,26761,202,156
50275,602,39.8,34250,17210,346,256
50276,2594,39.6,59318,28291,1387,1207
50277,436,43.6,51250,25627,184,252
50278,943,45.4,58482,26986,464,479
50309,5431,30.7,32256,30040,3040,2391
50310,30138,35.8,57830,28725,14739,15399
50311,15155,27.5,44016,23917,7398,7757
50312,14873,40.8,50817,39097,6950,7923
50313,17632,34.1,50403,21449,8653,8979
50314,11925,29.9,30473,14545,6064,5861
50315,35873,34.4,41793,20989,17426,18447
50316,16983,30.9,37424,16968,8222,8761
50317,35391,36.9,44744,21620,17808,17583
50319,0,-666666666,-666666666,-666666666,0,0
50320,21195,31.6,53996,23483,9807,11388
50321,8501,34.9,51653,34648,4162,4339
50322,31526,39.7,69282,36682,14694,16832
50323,10566,36.6,119531,50473,4921,5645
50324,4874,41.5,55701,29538,2434,2440
50325,16010,37.5,90993,44271,7660,8350
50327,10833,38.6,76871,33965,5270,5563
50401,29322,42.8,42458,26218,14165,15157
50420,376,55.3,37188,26097,195,181
50421,2871,46.4,47500,26872,1480,1391
50423,3222,44.9,48071,24857,1532,1690
50424,1254,50.5,53679,30258,628,626
50426,46,42.6,103500,45563,29,17
50428,9274,47.7,51790,30302,4472,4802
50430,444,48.8,49545,31925,233,211
50431,376,31.3,35227,18663,227,149
50432,190,60.1,37750,26381,87,103
50433,206,45.4,55781,41122,94,112
50434,382,53.2,41458,31476,185,197
50435,628,43.4,47083,20138,299,329
50436,5919,44,48442,25289,2899,3020
50438,3903,38.5,59627,27181,2093,1810
50439,491,40.3,46939,22032,257,234
50440,475,47.1,48250,37483,266,209
50441,5846,41.6,48886,25596,2840,3006
50444,330,43.5,51522,21949,181,149
50446,668,41.8,52981,32431,364,304
50447,1203,43.4,38636,20969,548,655
50448,741,44.9,55547,25807,364,377
50449,664,42,41389,23469,299,365
50450,2681,46.6,40028,22963,1294,1387
50451,477,52.1,46250,30336,221,256
50452,802,43.5,55192,29418,454,348
50453,685,42.2,53125,23839,339,346
50454,180,56.2,29676,15310,80,100
50455,356,39,52813,22418,194,162
50456,1789,40.4,48958,21399,864,925
50457,378,35.4,44141,23198,189,189
50458,2148,42.4,53510,27574,1036,1112
50459,2870,46.6,49811,26240,1404,1466
50460,306,41.4,57159,23577,149,157
50461,5786,44.5,51100,24952,2877,2909
50464,723,39.9,53162,25720,386,337
50465,250,40.3,49375,21074,139,111
50466,1962,39.4,47639,20891,1018,944
50467,100,31.5,56875,22551,53,47
50468,1587,44.2,56719,28264,830,757
50469,1694,45.4,56304,28714,875,819
50470,213,57.1,41786,21268,111,102
50471,741,49,42461,25573,369,372
50472,2224,47.3,50682,25107,1069,1155
50473,185,55.5,38750,30328,112,73
50475,1676,41.3,47986,23391,854,822
50476,719,46.7,55139,24989,284,435
50477,427,40.5,41667,19511,237,190
50478,962,40.6,43750,23810,484,478
50479,569,50.1,41800,23775,298,271
50480,793,53.1,46696,32708,403,390
50482,884,49.8,66065,40436,412,472
50483,743,50.3,55714,28624,395,348
50484,362,45.3,39063,23299,191,171
50501,28492,38.7,39710,24205,14330,14162
50510,1001,47.9,55313,29216,519,482
50511,7223,47.8,51149,27424,3506,3717
50514,1507,46.4,47917,25858,718,789
50515,230,38.4,32500,18893,138,92
50516,576,46.7,54833,24504,301,275
50517,1132,39.4,45833,25184,541,591
50518,414,34.4,70313,32730,213,201
50519,605,34.7,42330,20113,318,287
50520,125,50.8,37917,24806,74,51
50521,30,79.5,18333,19743,12,18
50522,703,44.5,51250,23318,325,378
50523,825,43.4,60439,25317,460,365
50524,525,48.8,56250,27595,269,256
50525,3491,42.2,39200,25499,1657,1834
50527,282,38.3,33281,17989,135,147
50528,525,41.2,62109,29850,325,200
50529,822,39.3,47708,23255,400,422
50530,1318,35.3,35625,20355,684,634
50531,313,46.1,69107,52444,128,185
50532,879,47.2,49432,28336,431,448
50533,3952,45.1,45985,26765,1974,1978
50535,807,40,44432,27715,391,416
50536,4541,42.1,47321,26168,2227,2314
50538,473,44.8,52708,28082,240,233
50539,591,46.9,55208,33777,319,272
50540,916,47.6,44740,21185,409,507
50541,800,43.3,44412,24397,386,414
50542,1067,46.6,52639,25919,557,510
50543,1562,44.5,44583,23616,868,694
50544,565,42.1,43315,20111,325,240
50545,270,22.1,56250,22380,140,130
50546,400,47.8,40865,23694,235,165
50548,5818,44.6,49922,28463,2791,3027
50551,128,62.5,48750,29220,60,68
50554,1632,46.1,41815,25970,802,830
50556,281,50.7,41667,26754,146,135
50557,831,46.6,40625,21963,473,358
50558,756,39.6,52422,24223,380,376
50559,274,54.8,45625,40689,150,124
50560,618,45.5,59375,30927,313,305
50561,599,51.5,57059,27564,291,308
50562,567,48,39821,26368,287,280
50563,2517,47.4,39336,26863,1269,1248
50565,591,41.3,41686,22374,253,338
50566,344,52.5,47656,25748,169,175
50567,216,41.3,56000,32072,135,81
50568,1515,40.6,46250,24471,743,772
50569,875,39,50679,21475,473,402
50570,229,46.7,81250,37380,95,134
50571,313,42.8,38375,21954,153,160
50573,44,49,46875,29102,26,18
50574,2156,51.1,42742,26202,1060,1096
50575,1195,45.6,48036,23352,584,611
50576,393,47.8,40536,20132,233,160
50577,395,52.1,53304,26881,198,197
50578,677,49,46250,38384,353,324
50579,2686,43.5,48990,25351,1507,1179
50581,885,46,43958,24434,470,415
50582,189,43.6,35714,26940,120,69
50583,2662,48,46667,25936,1350,1312
50585,911,44,38125,25780,484,427
50586,288,36.6,42500,19621,110,178
50588,12906,32.5,46845,20736,6577,6329
50590,914,46.1,41023,27346,417,497
50591,220,38.2,46250,24581,108,112
50593,92,33.6,24375,13728,49,43
50594,229,41.4,60278,27190,116,113
50595,9185,41.3,40414,23962,4529,4656
50597,1185,44.4,49432,31780,625,560
50598,1005,39.3,54688,33031,479,526
50599,489,42.3,47500,24483,192,297
50601,2339,48.1,52548,25661,1073,1266
50602,1643,46.3,52727,26270,830,813
50603,728,37.5,47685,19368,404,324
50604,1684,47.2,47292,28890,784,900
50605,126,43.5,35000,23455,64,62
50606,936,49.6,43158,20944,467,469
50607,687,39.8,52115,19706,385,302
50609,360,39.5,52083,30079,196,164
50611,400,38.6,47386,28114,222,178
50612,308,50.2,73500,51661,144,164
50613,42337,27.7,51257,25929,20100,22237
50616,10340,43.5,41654,22467,4953,5387
50619,2306,44.3,45924,21678,1129,1177
50620,44,42.5,41458,20530,23,21
50621,1682,45,57250,31400,833,849
50622,3292,41,71339,33256,1667,1625
50624,1841,40.9,66833,34029,885,956
50625,1183,49.6,44048,23540,585,598
50626,2028,38.8,64583,26000,1012,1016
50627,3529,44.2,49329,23459,1866,1663
50628,1398,40.6,46154,27862,745,653
50629,2331,37.4,55074,27732,1167,1164
50630,1848,39.9,44091,25698,976,872
50632,1144,38.9,56132,24822,590,554
50633,467,38.4,45074,24707,249,218
50634,682,47.6,46838,28117,331,351
50635,1808,46.1,58571,30545,989,819
50636,1935,44.2,50197,24454,955,980
50638,3260,41.9,53404,28399,1515,1745
50641,1939,35.7,46167,19130,948,991
50642,669,39.1,62708,21632,368,301
50643,2607,45.3,77619,34798,1389,1218
50644,8426,41.6,58016,29521,4102,4324
50645,1066,44.5,36086,19943,548,518
50647,1850,45.2,56458,27839,994,856
50648,4513,33.3,59932,27305,2257,2256
50650,511,47.5,46625,30755,275,236
50651,3821,39.4,57245,29080,2001,1820
50652,95,48.1,30625,17234,43,52
50653,741,34.9,52273,31585,433,308
50654,385,33.7,41731,24066,180,205
50655,755,43.4,53802,24667,397,358
50658,2584,42.1,46220,24876,1237,1347
50659,5716,42.9,43547,24605,2882,2834
50660,1317,45.9,64511,27566,627,690
50662,7144,42.6,40385,22613,3505,3639
50664,18,73.1,-666666666,15622,5,13
50665,2676,43.2,54119,29881,1309,1367
50666,920,38,65625,27457,481,439
50667,851,42.4,65156,27063,445,406
50668,1327,38.1,59286,25078,696,631
50669,2624,45.3,60743,33303,1318,1306
50670,2155,40.6,57054,25499,1058,1097
50671,303,21.4,67292,19059,136,167
50672,499,45.9,60833,32841,278,221
50673,260,42.3,56094,23406,141,119
50674,3423,44.1,54100,27883,1678,1745
50675,2570,42,56027,30837,1319,1251
50676,2355,38.2,53514,24165,1228,1127
50677,11936,36.2,64139,29425,5678,6258
50680,1258,38.8,52955,29843,650,608
50681,552,40.9,57500,23255,256,296
50682,1758,40.4,62434,26596,950,808
50701,29075,38.6,47900,27812,14420,14655
50702,20036,34.5,40561,21562,9730,10306
50703,20380,35.3,33184,16479,9398,10982
50707,8489,38.3,44227,22290,4387,4102
50801,9468,41.6,42837,23207,4585,4883
50830,1879,40.7,51154,25596,870,1009
50833,2358,43.3,44509,20359,1173,1185
50835,131,47.5,39063,15877,69,62
50836,388,35.4,37500,20127,194,194
50837,272,55.4,47857,31593,155,117
50839,21,61.3,31563,21405,9,12
50840,607,44.7,40893,23636,282,325
50841,2851,48.1,45613,23758,1363,1488
50842,86,45.6,56250,29526,46,40
50843,646,29.4,40714,19268,334,312
50845,902,43.1,47083,19728,460,442
50846,1133,48.4,45602,24037,574,559
50847,60,51.8,37500,30497,26,34
50848,366,49.1,43281,37111,170,196
50849,2732,44.2,47042,25402,1315,1417
50851,1812,44.8,44000,25678,880,932
50853,756,48,49091,25830,385,371
50854,2027,52.9,46620,28128,935,1092
50857,239,34.3,41696,19271,139,100
50858,700,47.8,50417,25830,355,345
50859,693,42.2,54688,26138,339,354
50860,675,22.5,38295,14387,342,333
50861,324,38,55329,22639,171,153
50862,180,39.1,29792,21502,90,90
50863,275,30.4,53417,20683,141,134
50864,1990,46.5,37841,23345,953,1037
51001,2367,44.5,51667,24537,1150,1217
51002,2678,39.7,53380,29458,1393,1285
51003,1649,45.4,60391,25746,860,789
51004,1294,42.4,43333,22441,632,662
51005,1582,44.7,49318,24429,807,775
51006,1127,41.9,33315,31977,560,567
51007,705,42.8,52917,26102,377,328
51008,110,40,70625,32075,57,53
51009,281,31.2,55500,22543,134,147
51010,220,54.1,25909,20589,117,103
51011,59,49.6,46250,21761,24,35
51012,6316,48.7,47401,26535,3024,3292
51014,494,47.6,61538,34280,243,251
51016,1392,49.1,42604,20827,678,714
51018,400,36.2,48250,23735,215,185
51019,762,46.8,53661,27693,365,397
51020,723,35.2,48125,21657,355,368
51022,756,42.8,63750,30796,396,360
51023,3116,42.3,47274,24730,1487,1629
51024,1942,43.5,65625,29479,972,970
51025,1791,47.1,49516,31320,926,865
51026,745,47,55875,27625,364,381
51027,1032,39,51484,24873,534,498
51028,2136,42.3,58824,27352,1068,1068
51029,429,32.2,53229,22075,252,177
51030,1778,40.8,70766,34286,847,931
51031,12023,40.7,54988,27096,5910,6113
51033,506,32.4,72955,34184,302,204
51034,1859,46.2,48125,28600,926,933
51035,1647,44.8,58672,28059,852,795
51036,678,30.6,54615,21416,274,404
51037,328,48.7,40125,18887,169,159
51038,1761,44.2,68971,27576,898,863
51039,2477,42.7,58681,27946,1228,1249
51040,3763,45.2,38969,20406,1856,1907
51041,7356,30.4,58103,22949,3675,3681
51044,214,42.8,54583,23344,111,103
51046,1364,50.5,47120,28120,703,661
51047,762,51.5,48309,26066,435,327
51048,654,39.3,56000,31149,303,351
51049,476,47.9,47847,22334,256,220
51050,2882,39.1,59479,24319,1429,1453
51051,102,38.8,40714,20349,63,39
51052,797,43.7,64813,30219,412,385
51053,1145,44.7,51875,26076,567,578
51054,4979,35.7,80572,26636,2242,2737
51055,1396,33.5,59643,27044,680,716
51056,499,57.9,40956,26270,267,232
51058,1199,35.4,44615,24167,596,603
51060,592,50.3,34667,22164,267,325
51061,630,46,39250,24453,315,315
51062,532,47.1,52143,24029,277,255
51063,1253,43.4,45066,24568,578,675
51101,716,46.6,16394,14999,455,261
51103,17490,34,37143,16398,8979,8511
51104,22509,33.8,52662,27591,10907,11602
51105,9463,29.6,27365,13345,4553,4910
51106,25854,35,50758,25839,12693,13161
51108,6376,40.9,51667,27103,3298,3078
51109,3122,39.7,41827,20963,1425,1697
51111,209,34.8,68750,24540,99,110
51201,6232,43,55102,31172,3278,2954
51230,581,25.8,53125,20482,254,327
51231,284,35.1,73750,40433,158,126
51232,910,48.3,55625,28888,466,444
51234,1106,42.9,59179,26997,569,537
51235,995,37.3,47670,19235,520,475
51237,1597,45,50952,22423,772,825
51238,1295,35.5,54896,25300,687,608
51239,3318,33.3,63700,26537,1716,1602
51240,1739,36.6,49471,24270,875,864
51241,1846,32.2,58000,24648,1023,823
51242,248,35.8,55625,32060,111,137
51243,772,46,50577,21272,406,366
51244,84,40,64375,26056,45,39
51245,1517,36.8,44844,23143,750,767
51246,3801,39,52500,24483,1893,1908
51247,4954,30.8,56484,21562,2435,2519
51248,1499,50.9,42621,23801,698,801
51249,3455,42.9,46613,23398,1695,1760
51250,8472,28.5,63268,25307,4211,4261
51301,12879,42.9,47722,29821,6144,6735
51331,1007,55.7,45592,38855,482,525
51333,470,38.5,44167,23775,231,239
51334,7360,39.5,48157,26818,3734,3626
51338,901,37,57500,26477,444,457
51341,72,38.5,25000,20033,49,23
51342,1165,41,43650,23335,597,568
51343,169,49.4,60000,31169,85,84
51345,380,41,51319,23182,198,182
51346,2269,49.9,45568,26282,1009,1260
51347,1359,37.8,55583,27727,684,675
51350,566,39.8,46250,24617,280,286
51351,4521,47.6,50493,28811,2157,2364
51354,1056,49.5,51125,25793,531,525
51355,766,58.3,55337,42365,371,395
51357,801,32.9,51071,24689,391,410
51358,1284,45.2,43846,21767,618,666
51360,8593,47.9,60519,32190,4356,4237
51363,138,48.5,36250,30220,80,58
51364,579,39.8,36875,23660,326,253
51365,436,34.1,56250,24950,175,261
51366,367,48.8,50694,26356,175,192
51401,12086,41.4,47047,25698,5813,6273
51430,812,38.2,55938,21657,422,390
51431,385,43.8,44922,21913,189,196
51433,582,48.3,47500,22422,303,279
51436,956,34.6,57321,26397,495,461
51439,1149,41.5,54722,24215,569,580
51440,366,34.1,52639,29824,208,158
51441,340,42,31250,17008,153,187
51442,9596,34.6,43967,20127,4904,4692
51443,1836,45,50370,25004,897,939
51444,237,26.7,63333,19183,114,123
51445,2900,48.9,40608,25554,1394,1506
51446,517,50.4,45625,24909,248,269
51447,150,61.4,27708,20470,90,60
51448,653,40.8,44219,22819,368,285
51449,2000,50.3,41442,27913,944,1056
51450,1775,49.4,44712,26272,814,961
51451,112,36.3,29688,16602,50,62
51453,801,41.5,46925,24800,430,371
51454,1525,42.3,52583,23459,734,791
51455,2358,47.4,49417,29533,1150,1208
51458,1583,46.4,50272,27324,779,804
51459,91,42.4,45833,20809,43,48
51461,1158,44.9,55568,29941,584,574
51462,1109,33.3,48056,23015,554,555
51463,649,47.6,46719,25685,299,350
51465,751,48,50250,23178,352,399
51466,945,45.1,51932,25907,433,512
51467,624,53.8,60625,42881,326,298
51501,35025,34.5,40969,20111,16960,18065
51503,36878,40.7,58226,29381,18176,18702
51510,3763,37.1,45379,22661,1646,2117
51520,248,29.3,33281,15054,158,90
51521,1807,47.6,51500,33928,973,834
51523,359,54.5,44250,26251,150,209
51525,1089,42.3,54336,25614,558,531
51526,1561,53.9,79963,34697,761,800
51527,438,42.5,43594,18653,238,200
51528,846,49.6,41053,21278,412,434
51529,1944,45,51786,25199,977,967
51530,1198,34.2,48056,21756,676,522
51531,825,54.4,52321,26641,418,407
51532,689,41.3,46053,19951,305,384
51533,1014,46.5,55096,27547,561,453
51534,9495,40.7,67281,27091,4524,4971
51535,1689,48.1,45865,26983,843,846
51536,433,56.2,68750,36299,210,223
51537,6598,45.8,47946,26923,3132,3466
51540,525,48.1,39063,23079,284,241
51541,332,47,45417,22654,181,151
51542,1071,45.3,89028,31818,581,490
51543,449,48.1,48750,24637,221,228
51544,984,39.8,47266,21393,535,449
51545,328,43.6,28500,18867,161,167
51546,2649,40,63594,27787,1247,1402
51548,367,44.5,68618,34754,184,183
51549,408,44.7,53500,28298,195,213
51550,144,51.4,60833,25958,77,67
51551,1652,46.3,74135,30392,838,814
51552,319,46.8,69375,43957,144,175
51553,1256,34,71016,31540,619,637
51554,195,33.5,44156,29183,158,37
51555,5425,41.1,57063,26408,2740,2685
51556,512,33.9,51200,20052,259,253
51557,820,48.9,55625,26289,413,407
51558,567,53,60000,36776,325,242
51559,1660,43.9,64444,31736,761,899
51560,2159,37,60854,25882,1064,1095
51561,1151,50.8,41250,25486,599,552
51562,382,42,49861,24120,203,179
51563,578,53.6,43906,32541,276,302
51564,457,47.5,43500,24465,255,202
51565,545,47.4,58636,28610,277,268
51566,6897,45,42938,21377,3398,3499
51570,768,52.6,46333,24445,325,443
51571,763,37.8,76964,30446,390,373
51572,420,40.4,42208,25700,245,175
51573,1147,45.8,67143,30131,578,569
51575,1640,40.4,67031,31861,824,816
51576,1937,38.5,78083,35268,1074,863
51577,1316,43.9,55208,25370,632,684
51578,87,43.2,48750,23854,39,48
51579,2499,39.4,50139,25500,1255,1244
51601,5980,48,42888,25288,2984,2996
51630,172,37.5,28750,17507,99,73
51631,270,55,51181,29216,130,140
51632,7062,40.8,42766,21763,3823,3239
51636,515,52,47500,24686,231,284
51637,228,39.7,30972,14218,117,111
51638,1367,44,48713,27711,642,725
51639,942,50.4,55809,32140,485,457
51640,1616,43.5,37500,22533,715,901
51645,257,47.5,35417,20656,125,132
51646,809,45.2,44398,25578,421,388
51647,156,19.2,31875,15065,75,81
51648,112,49.3,44545,36329,53,59
51649,285,52.9,60750,35680,130,155
51650,430,33.3,54853,31293,240,190
51652,1689,46.2,50417,28099,862,827
51653,1525,33.9,58542,22627,753,772
51654,479,52.8,56042,28448,249,230
51656,74,30,52500,17784,40,34
52001,43799,36.7,42611,22926,20798,23001
52002,14869,39.6,68799,30760,7737,7132
52003,13377,44.4,61135,33635,6469,6908
52030,409,35.8,40781,21222,211,198
52031,5508,44.1,53719,26791,2784,2724
52032,1397,43,52426,30079,774,623
52033,3069,38.5,60625,25668,1513,1556
52035,986,49,46667,24549,566,420
52037,1310,40.8,57112,28640,619,691
52038,449,40.2,71339,25555,217,232
52039,904,51.5,56875,28161,499,405
52040,5688,39.2,47051,22886,2903,2785
52041,1481,37.9,60234,29857,730,751
52042,1832,37.6,50278,21901,870,962
52043,2269,49.6,54143,27868,1146,1123
52044,204,51.3,55875,24543,118,86
52045,2604,35.6,65833,23973,1315,1289
52046,2241,36.4,71276,28660,1175,1066
52047,464,52.7,60313,27004,231,233
52048,417,38,56000,19586,210,207
52049,1309,50.8,52188,28546,643,666
52050,725,25.5,50234,22739,387,338
52052,2849,48.4,39139,22322,1327,1522
52053,983,42.8,48750,20619,470,513
52054,882,46,65625,33806,439,443
52057,7961,41.7,53828,26776,3867,4094
52060,8555,44,39572,22142,4093,4462
52064,858,43.8,54750,26134,464,394
52065,1139,45.9,54457,25638,581,558
52066,80,54.7,35156,21325,48,32
52068,4141,35.4,76741,26931,2104,2037
52069,1589,40.3,56296,23981,748,841
52070,953,50.9,49167,25552,523,430
52072,294,50.4,49205,27068,151,143
52073,1341,31.5,63393,24164,739,602
52074,417,40.1,55000,25086,177,240
52076,2700,41.8,50625,25714,1335,1365
52077,456,39.2,35625,17847,234,222
52078,884,49.4,65625,31296,413,471
52079,835,46.1,52000,27941,479,356
52101,13845,40.1,53141,25122,6740,7105
52132,1939,39.2,49564,24369,948,991
52133,625,40.3,66333,26065,344,281
52134,448,27.2,61875,20332,177,271
52135,787,46.3,38438,24586,356,431
52136,5937,42.8,46200,24242,2980,2957
52140,449,52.9,55859,34028,245,204
52141,1390,42.5,39679,21960,676,714
52142,1662,25.7,42098,20622,969,693
52144,1300,38.1,63068,23786,695,605
52146,1065,59.4,49671,27163,650,415
52147,1109,47.1,62000,26541,567,542
52151,1889,51.3,39857,24770,934,955
52154,817,50.9,47333,24999,425,392
52155,1076,48.7,43864,25028,491,585
52156,802,33.6,39583,19715,382,420
52157,1733,48,50521,26296,863,870
52158,259,45.8,38015,24321,146,113
52159,2583,42.4,51528,26902,1353,1230
52160,1075,39.2,49840,26996,531,544
52161,1617,45.7,56719,25232,860,757
52162,3378,32.8,44056,23291,1632,1746
52163,264,42.6,34044,21156,139,125
52164,158,39.5,45536,20204,95,63
52165,810,43.9,39200,26682,441,369
52166,109,45.3,46750,31106,66,43
52168,179,38.9,32344,19296,73,106
52169,476,37.7,46875,20808,225,251
52170,551,51.1,66375,40976,325,226
52171,997,47.5,52500,24785,457,540
52172,5949,44.9,48229,23706,2898,3051
52175,3889,42.5,49534,23954,1841,2048
52201,1194,43,70368,27843,652,542
52202,1003,46.2,67321,29601,472,531
52203,1926,50,64879,34997,989,937
52205,8683,43.2,54877,25159,4691,3992
52206,2482,33.7,81450,29619,1231,1251
52207,304,48.6,48906,32883,162,142
52208,3198,42.5,38489,22981,1621,1577
52209,1281,34,54191,21487,629,652
52210,871,32,53082,22095,473,398
52211,2735,41.1,50793,23411,1360,1375
52212,194,52.1,57500,23176,90,104
52213,4437,38.7,74009,31817,2241,2196
52214,3003,39.5,52396,27441,1540,1463
52215,749,45.9,48462,21973,408,341
52216,1555,40.7,61389,27717,796,759
52217,447,47.8,40625,22426,213,234
52218,1880,38.7,59861,27142,1005,875
52219,180,42,53750,23908,81,99
52220,285,47.7,59688,28116,127,158
52221,171,29.7,51750,21994,96,75
52222,720,47.4,55521,27223,383,337
52223,1592,45,59000,30286,865,727
52224,2475,36.8,61688,27285,1234,1241
52225,305,56.4,39135,22024,175,130
52227,2988,35.1,81563,31780,1466,1522
52228,2756,39.6,84844,35458,1394,1362
52229,813,43.4,61719,30072,420,393
52231,299,44.5,64583,30341,142,157
52232,139,54.8,24444,29749,90,49
52233,6974,37.8,48333,28636,3528,3446
52235,783,41.2,47500,21682,365,418
52236,744,41.1,80341,26984,361,383
52237,1337,42.2,52708,23067,642,695
52240,33544,26.8,41405,24997,17135,16409
52241,19328,32,56862,31503,9170,10158
52242,1688,19.2,-666666666,2949,843,845
52245,22745,27.4,53868,28508,11282,11463
52246,21360,27.9,41170,31184,10901,10459
52247,5431,38.8,51544,24682,2464,2967
52248,1951,38,51554,26368,1008,943
52249,1084,48.4,63750,37537,553,531
52251,552,43.5,56250,23269,275,277
52253,2761,40.1,70163,28992,1316,1445
52254,765,45.2,41964,19987,374,391
52255,1108,47.9,47063,24756,541,567
52257,178,53.8,90179,35488,90,88
52301,3641,37.9,45172,23607,1811,1830
52302,37903,37.1,63817,31036,19099,18804
52305,625,51.6,58750,28466,327,298
52306,1944,38,59213,28336,988,956
52307,54,43,-666666666,69328,36,18
52308,148,44,48125,21764,75,73
52309,373,48.8,60288,27071,230,143
52310,6592,41.8,54478,26976,3284,3308
52312,130,31.2,35625,13568,60,70
52313,389,48.6,55063,22033,228,161
52314,6027,33.1,72722,25523,3024,3003
52315,958,42.4,61750,27831,486,472
52316,1563,44.8,56522,27156,716,847
52317,15310,30.3,73195,33941,7660,7650
52318,1158,46.3,54438,30041,604,554
52320,1109,46.6,59167,29853,596,513
52321,522,42.5,54808,25282,259,263
52322,2466,38.9,65852,28278,1125,1341
52323,1138,48.6,51667,27752,559,579
52324,1956,38.5,80176,28270,1029,927
52325,971,47.2,75423,29336,443,528
52326,461,40.3,38958,22388,198,263
52327,3640,35.3,83542,32337,1818,1822
52328,2713,38.5,115938,43323,1359,1354
52329,667,50.5,64438,30088,354,313
52330,888,41.6,49730,22763,504,384
52332,1903,45.1,54306,29980,981,922
52333,6763,42.2,86940,37389,3435,3328
52334,222,46.5,69750,23372,133,89
52335,591,50.7,45781,26551,285,306
52336,2363,43.7,60625,28756,1121,1242
52337,969,35.4,50897,20155,513,456
52338,3073,44.3,101012,42663,1558,1515
52339,4435,35.1,46858,19510,2185,2250
52340,2183,32.2,59688,28967,1215,968
52341,1129,44.9,81729,36597,586,543
52342,2880,44.1,42059,21917,1231,1649
52345,1428,34.8,67396,28254,782,646
52346,1112,33.3,58200,25757,518,594
52347,1515,44.7,51914,31231,738,777
52348,49,40.8,71250,24953,18,31
52349,7350,42,51339,22683,3461,3889
52351,1540,34.9,92105,30356,807,733
52352,1668,41.9,72014,30407,868,800
52353,8933,43.4,50482,27350,4299,4634
52354,327,47.6,72330,29013,167,160
52355,241,48.7,49625,22839,124,117
52356,2912,42.3,56412,26281,1518,1394
52358,3843,37.8,64073,27607,1756,2087
52359,254,48.2,60875,28739,121,133
52361,4395,36.3,64421,29639,2163,2232
52362,670,49.1,38359,27973,349,321
52401,2116,38.4,19383,21976,1283,833
52402,40175,34.6,55878,29588,19516,20659
52403,22718,42.1,56779,35027,10969,11749
52404,38222,33.6,45973,23978,18308,19914
52405,24901,36.8,55406,28942,12136,12765
52411,7151,43,124650,46065,3588,3563
52501,29993,39.1,40795,22268,14516,15477
52530,1036,45.3,54297,24820,546,490
52531,5948,40.6,46617,24243,2960,2988
52533,1626,42.6,49938,21050,757,869
52534,205,44.9,32500,18582,99,106
52535,884,49.3,51500,25446,479,405
52536,896,49.9,55515,33930,436,460
52537,6430,41.1,44558,21663,3152,3278
52540,1334,42,49038,23163,707,627
52542,380,46,36667,22948,188,192
52543,517,32.7,76357,29076,270,247
52544,7657,43.6,38317,22206,3686,3971
52548,94,40.3,45500,16653,46,48
52549,564,47.7,30417,16265,281,283
52550,480,47.8,32708,19100,270,210
52551,605,52.9,48250,25153,332,273
52552,1231,29.7,59023,31003,634,597
52553,1708,44.3,44833,25215,893,815
52554,1387,35.4,35568,18714,708,679
52555,343,50,45655,18970,166,177
52556,12637,45.6,47440,28429,6511,6126
52557,77,23,-666666666,5277,53,24
52560,483,44.6,53472,21979,301,182
52561,882,32.7,43750,21902,447,435
52563,1755,45.7,37969,21317,949,806
52565,1987,42.5,41477,21484,947,1040
52566,158,45.3,51042,27540,91,67
52567,628,51.4,54398,33772,353,275
52569,633,54.3,40313,23963,345,288
52570,1000,31.3,42619,16099,439,561
52571,1537,52.1,48929,24119,727,810
52572,1318,35,38750,16827,589,729
52573,102,31.4,55859,24135,63,39
52574,776,36.8,31755,17025,395,381
52576,475,50.9,36319,23865,253,222
52577,15091,39.9,44045,23757,7565,7526
52580,406,44.2,45625,26896,201,205
52581,532,58.6,61563,32677,279,253
52583,371,48,26908,21899,219,152
52584,492,36.5,41042,17808,260,232
52585,963,35.5,49653,22442,476,487
52586,400,57.3,45547,26364,176,224
52588,97,35.7,51406,16216,37,60
52590,1278,34.6,39688,16257,647,631
52591,3099,47.9,39741,23297,1600,1499
52593,150,46.3,40250,19919,94,56
52594,451,45.4,41806,18046,233,218
52595,512,26.6,35938,17053,272,240
52601,30090,41.1,40243,24252,14335,15755
52619,524,31.7,50313,20374,300,224
52620,849,45.6,42083,19081,429,420
52621,711,47.6,57708,27979,329,382
52623,1966,41.1,53571,23511,1050,916
52624,215,32.7,51458,36369,93,122
52625,2678,43.3,53727,26283,1344,1334
52626,1477,48.4,42875,22460,776,701
52627,13414,43.1,43673,22810,6980,6434
52630,493,33.9,38125,19681,283,210
52632,13194,39.3,35901,19768,6335,6859
52635,765,40.7,34063,24096,440,325
52637,2359,48.6,47536,25745,1223,1136
52638,466,47.5,56500,23131,220,246
52639,1939,45.9,49750,23987,1018,921
52640,1606,41.2,55529,36467,852,754
52641,12114,40,48057,23003,6481,5633
52644,323,40,75500,36412,144,179
52645,3109,42.3,45923,22909,1578,1531
52646,289,33.5,43333,27076,141,148
52647,232,39.5,51875,26379,107,125
52649,1030,41.5,41538,19229,461,569
52650,706,50.7,70417,31126,425,281
52651,820,41,54271,24434,485,335
52653,3480,41.4,47500,22984,1778,1702
52654,1866,44.3,48594,22063,825,1041
52655,4502,41.9,43207,23452,2169,2333
52656,2292,47.9,62852,28211,1138,1154
52657,42,45.5,38438,21405,17,25
52658,863,52.6,59609,33651,438,425
52659,1523,36.6,45588,23204,631,892
52660,155,70.1,56339,23832,100,55
52701,103,30.3,58750,21825,59,44
52720,965,42.8,51054,21274,498,467
52721,795,41.5,51827,24835,374,421
52722,35289,41.1,70360,38457,17060,18229
52726,4739,42.5,81359,32588,2302,2437
52727,451,42.8,81250,38315,303,148
52728,909,41.2,43819,23645,410,499
52729,763,49.5,63333,31296,368,395
52730,4937,46.9,47868,27842,2355,2582
52731,712,35.6,55333,22756,346,366
52732,28379,40.3,43782,24685,13989,14390
52737,398,42.2,47083,19907,202,196
52738,3536,37.3,50742,20834,1775,1761
52739,860,39.7,40114,16575,434,426
52742,7830,42.7,64625,28712,3723,4107
52745,526,41.7,68438,30003,226,300
52746,977,48.2,65583,31045,528,449
52747,2184,41.2,53813,26216,1039,1145
52748,9253,36.8,60392,30566,4615,4638
52749,1341,33.2,77125,22561,762,579
52750,547,43.8,67240,28233,292,255
52751,864,44.3,55469,26835,475,389
52752,520,35,43750,18762,233,287
52753,5483,43.4,75241,41187,2898,2585
52754,1447,40.4,60769,29245,779,668
52755,2032,39.4,61450,25506,987,1045
52756,2040,41.8,81389,33580,1030,1010
52757,153,37.6,47500,24795,81,72
52758,202,46.3,55000,27874,102,100
52760,372,60.3,67031,30345,197,175
52761,30409,38.4,48980,25376,14784,15625
52765,359,49.4,71875,35249,198,161
52766,831,46.4,51442,27662,437,394
52767,174,59.5,27857,46224,46,128
52768,1177,45.8,52337,30220,597,580
52769,835,37.7,68250,25955,422,413
52772,4951,45.5,55679,25885,2503,2448
52773,2199,44.5,60882,29025,1083,1116
52774,115,32.8,66875,25792,61,54
52776,4473,34.1,50938,21055,2215,2258
52777,1442,41.8,47235,23982,706,736
52778,3735,42.4,62841,29244,1825,1910
52801,978,38.6,15969,16211,700,278
52802,10500,35.2,31568,15491,5114,5386
52803,23308,32.2,41529,23888,11537,11771
52804,26954,37.3,50088,23726,12929,14025
52806,27998,35.2,48553,24075,13698,14300
52807,13847,36,50319,36328,6764,7083
53001,1880,43.3,65500,30247,933,947
53002,2501,40.4,65583,26409,1361,1140
53003,111,56.6,41118,20847,14,97
53004,3360,38.5,72262,29064,1691,1669
53005,19669,45.5,85288,41438,9375,10294
53006,1814,41.8,60833,27701,1008,806
53007,1783,45.4,43631,26634,862,921
53010,7700,44.1,61231,28145,4005,3695
53011,2290,45.4,59071,27950,1253,1037
53012,18868,44.4,80521,36806,9063,9805
53013,3243,40,65795,31283,1707,1536
53014,8069,42.6,54664,26748,3908,4161
53015,2647,40.1,58929,27761,1365,1282
53016,351,47.7,48875,21816,188,163
53017,5714,44.8,94808,42464,2871,2843
53018,8120,43.3,94873,42783,4110,4010
53019,1863,41.8,52417,24308,952,911
53020,3468,49.3,58234,32806,1708,1760
53021,4879,39.6,66491,27387,2663,2216
53022,19090,42,74646,35780,9432,9658
53023,2430,35.8,57083,15909,1840,590
53024,16725,42.1,66554,35089,7930,8795
53027,22076,39.9,61893,30572,10534,11542
53029,21019,40.7,87798,42326,10206,10813
53031,33,44.5,-666666666,24358,17,16
53032,4684,40,61875,25329,2185,2499
53033,4617,48.8,78889,39517,2326,2291
53034,1960,40.1,52784,24432,984,976
53035,2370,38.8,57841,25231,1201,1169
53036,2460,37.7,66250,28945,1266,1194
53037,8955,39.4,59545,31003,4386,4569
53038,4060,34.3,62401,28329,2054,2006
53039,4942,40.3,52010,23209,2658,2284
53040,8357,39.8,70156,28969,4035,4322
53042,7001,41.9,58183,27729,3520,3481
53044,2392,43.5,87109,38975,1103,1289
53045,21383,47.7,87587,46936,10085,11298
53046,1106,42.5,52083,30179,520,586
53047,123,29.5,62656,19540,67,56
53048,3121,38.5,49767,24346,1629,1492
53049,2211,44.5,74595,30544,1150,1061
53050,6860,41.4,57292,25507,3379,3481
53051,35755,44.2,71603,35655,17328,18427
53057,1671,48.1,61400,26762,878,793
53058,3500,40.8,83942,46310,1772,1728
53059,1784,46.8,63917,29124,863,921
53061,5229,46.6,44625,23393,2796,2433
53063,1598,45.2,66705,27129,847,751
53065,2281,41.6,62500,27151,1118,1163
53066,34097,41.8,79940,38061,17189,16908
53069,600,45.1,128173,71334,312,288
53070,4875,41.1,61740,26635,2420,2455
53072,24027,43.8,73993,42554,11597,12430
53073,14821,41.4,56916,28387,7685,7136
53074,12700,38.6,61560,31249,6474,6226
53075,3202,41.8,56648,27843,1623,1579
53076,3282,42.1,102794,37817,1759,1523
53078,2024,43.8,69853,31522,1033,991
53079,1360,46.4,64423,29588,650,710
53080,5630,37.6,63654,31417,2858,2772
53081,42804,37.4,42333,21763,21017,21787
53083,20581,42.2,60858,29380,10262,10319
53085,11016,44.4,56436,28764,5242,5774
53086,8178,41.3,71692,30890,4166,4012
53088,477,42.8,55455,25279,257,220
53089,18241,42,75313,32544,9052,9189
53090,22193,38.1,64483,28299,11009,11184
53091,2071,42.9,56250,24950,995,1076
53092,20845,47.9,100658,63695,10063,10782
53093,2053,40.9,69076,25158,1067,986
53094,19292,36.1,48951,22776,9358,9934
53095,26755,43.5,59348,32258,13448,13307
53097,5585,46.1,96793,47811,2655,2930
53098,11837,44,56756,25579,5993,5844
53103,3698,43.6,79214,31276,1980,1718
53104,5703,38.4,63233,30075,2808,2895
53105,29520,43.6,57673,27199,15084,14436
53108,3470,45.8,69233,31540,1750,1720
53110,18326,40.1,45929,23428,9619,8707
53114,2703,37.7,57917,23116,1422,1281
53115,16072,38.5,49888,22880,8056,8016
53118,7248,46.9,81619,38393,3612,3636
53119,5426,40.9,79348,32517,2809,2617
53120,9811,42.2,63319,31349,4971,4840
53121,19206,37.7,57909,26109,9341,9865
53122,6036,47.6,116875,61916,2865,3171
53125,1673,57.4,77961,54595,813,860
53126,6472,45.1,71179,39115,3368,3104
53128,8759,39.1,61946,27182,4537,4222
53129,14143,43.6,65625,32388,6644,7499
53130,7728,46.7,63091,32519,3802,3926
53132,34983,40.3,73742,35148,17897,17086
53137,2006,41.3,62222,29644,1105,901
53139,3030,40.2,63229,31939,1497,1533
53140,30400,34.5,38412,19964,14952,15448
53142,32273,36.6,64930,29304,15824,16449
53143,23872,33.6,44750,21580,11449,12423
53144,26609,34.6,50377,25934,13025,13584
53146,7256,47.8,74789,37192,3765,3491
53147,16984,42.3,50733,32556,8370,8614
53149,19271,42.5,78876,35282,9784,9487
53150,25048,42.8,85764,37392,12364,12684
53151,32321,45,76500,39777,15365,16956
53153,2239,43.7,75547,34562,1013,1226
53154,34580,37.7,65813,32186,17289,17291
53156,3054,42.4,53600,25161,1510,1544
53158,16015,39,76005,35020,8124,7891
53167,463,49.9,49880,31613,279,184
53168,8711,39.6,69907,27769,4445,4266
53170,2141,32.5,49900,24278,1139,1002
53172,21163,40.6,52900,25207,10433,10730
53177,8622,38.8,56886,23982,5277,3345
53178,2750,43,51696,26811,1433,1317
53179,6122,39.2,63333,28032,3038,3084
53181,7208,39.8,64821,30366,3819,3389
53182,9421,42.7,60921,25123,4352,5069
53183,2951,44.6,95422,44738,1566,1385
53184,4277,38.6,53361,25296,2130,2147
53185,18360,41.4,77357,33679,8986,9374
53186,34570,33.8,52948,27204,17003,17567
53188,34950,38,64446,32810,17405,17545
53189,25758,39.9,77761,34514,12499,13259
53190,19330,23.6,41859,19952,9973,9357
53191,2827,46.7,69441,39675,1397,1430
53192,108,78.6,15331,26094,17,91
53195,79,61.9,60000,26753,50,29
53202,23933,30.6,47231,44574,11991,11942
53203,1106,33.8,68750,65115,630,476
53204,42129,27,24355,11471,21357,20772
53205,9575,28.5,22092,12490,4274,5301
53206,29334,27,22141,10547,13201,16133
53207,36058,36.3,53646,27986,17247,18811
53208,32196,30.2,31474,18267,15592,16604
53209,45906,33.2,33119,18747,21017,24889
53210,26686,29.3,31149,16220,11951,14735
53211,35125,27.5,50619,35068,17605,17520
53212,31224,29.7,29653,18097,15495,15729
53213,26046,35.4,63005,37311,12491,13555
53214,34696,35.7,42199,23233,17387,17309
53215,60508,29.3,33837,13790,30262,30246
53216,32590,33.6,32906,17199,14728,17862
53217,29051,42.9,95965,54370,13942,15109
53218,40327,29.6,36033,14939,18280,22047
53219,35358,38.3,46175,25154,17217,18141
53220,26666,41,46891,25729,12682,13984
53221,38135,38.5,46939,24048,18759,19376
53222,25830,37.9,52390,28596,12035,13795
53223,28177,40.6,41825,23800,13079,15098
53224,22484,31,42765,21544,10604,11880
53225,24755,30.8,38125,19671,11086,13669
53226,19178,39,63728,34053,9573,9605
53227,22833,40.7,45977,26064,10854,11979
53228,14858,43.1,56004,32653,7179,7679
53233,15341,21.7,13199,8077,8064,7277
53235,9403,45.3,44040,27609,4734,4669
53295,135,53.6,-666666666,16330,130,5
53402,32223,39.4,58263,31906,15640,16583
53403,27770,35.6,36979,21644,13916,13854
53404,15272,31.5,31341,15153,7842,7430
53405,25280,37,50110,24827,12014,13266
53406,25862,43.4,58711,30073,12173,13689
53501,0,-666666666,-666666666,-666666666,0,0
53502,2347,42,54500,26358,1206,1141
53503,1894,41,54167,25067,935,959
53504,2021,44.8,50208,24441,1060,961
53505,425,52,57188,31586,221,204
53506,1090,47.5,44000,24265,564,526
53507,2265,38.2,72400,29514,1172,1093
53508,5380,37.1,75034,31658,2719,2661
53510,1540,33.3,44455,21883,727,813
53511,48785,37.6,40851,20344,23156,25629
53515,2301,46.1,65298,33541,1151,1150
53516,2153,42.7,61875,28500,1037,1116
53517,1694,41,69034,34972,891,803
53518,1212,48.4,46898,25531,648,564
53520,6741,41.7,52150,23566,3323,3418
53521,3567,41.3,77206,32028,1764,1803
53522,1246,41.7,52000,25027,625,621
53523,4770,50.3,60104,33068,2378,2392
53525,3740,42.3,57686,29187,1966,1774
53526,573,38.4,43636,21480,289,284
53527,10405,38.5,82285,34474,5044,5361
53528,5699,40.2,77098,37670,2810,2889
53529,2234,33.7,76406,32054,1217,1017
53530,4863,40,51014,23478,2557,2306
53531,4570,37.6,77799,30392,2367,2203
53532,13676,37.8,76511,33787,6640,7036
53533,7095,42.4,54599,27118,3371,3724
53534,11442,43.9,57287,28749,5853,5589
53536,8835,39.1,64278,26667,4396,4439
53537,674,46.5,43854,23490,311,363
53538,18671,41.5,55092,27378,9205,9466
53540,210,29.7,45938,18099,101,109
53541,721,49.4,43906,26256,351,370
53543,1593,41.8,52039,24246,842,751
53544,731,42.6,55417,28741,379,352
53545,22376,38.9,45830,24907,11074,11302
53546,32265,36.6,56696,25468,15794,16471
53548,18042,39.3,45559,23230,8820,9222
53549,10037,39.7,47820,24178,5049,4988
53550,1295,41.9,56897,22349,693,602
53551,8315,40.4,57544,28872,4012,4303
53553,625,35.5,55313,21660,335,290
53554,1134,38.1,55231,24135,528,606
53555,8523,44.2,69850,34640,4119,4404
53556,2681,40.5,43705,21987,1347,1334
53557,467,42.4,43393,21262,239,228
53558,10844,42.1,69150,36614,5361,5483
53559,6087,37.9,65372,26522,2951,3136
53560,3488,42.8,64271,30938,1674,1814
53561,1505,51.9,70375,39065,715,790
53562,24448,40,71219,51257,11541,12907
53563,10448,38.6,59935,27864,5294,5154
53565,5014,39.5,58719,25763,2451,2563
53566,15180,42.1,45527,26055,7391,7789
53569,1081,45.1,59500,25822,544,537
53570,2615,43.4,59659,30420,1375,1240
53571,317,26.9,68750,28673,168,149
53572,9849,40.5,67361,31633,4817,5032
53573,3082,43.2,41182,22213,1581,1501
53574,3830,45.2,71591,33446,1891,1939
53575,15558,39.5,81409,35741,7879,7679
53576,2452,37.9,55893,22504,1360,1092
53577,1451,39.7,60398,32078,776,675
53578,6225,37,67981,30542,3194,3031
53579,1911,41.5,53205,25547,980,931
53580,711,40.5,40000,19143,369,342
53581,10846,43,45685,23215,5350,5496
53582,987,46.2,52614,26501,526,461
53583,5770,40.3,52097,27735,2856,2914
53585,1969,38.5,44125,23800,952,1017
53586,2257,44.3,45677,21580,1097,1160
53587,1271,41.8,45417,22619,657,614
53588,3831,44.8,58086,29862,1907,1924
53589,19850,42.8,65586,30797,10175,9675
53590,36715,34.6,70122,32655,17747,18968
53593,20431,39.1,90738,42355,10302,10129
53594,5103,39.1,54521,24792,2429,2674
53597,17050,41,87630,37713,8062,8988
53598,2682,38.1,68661,35305,1307,1375
53599,95,35.2,30417,15140,58,37
53702,38,-666666666,-666666666,,19,19
53703,28111,24.1,26257,25358,13799,14312
53704,44206,35.3,49105,30638,21679,22527
53705,23267,37.9,62198,42980,11357,11910
53706,6281,19.2,26685,4075,3260,3021
53711,43977,38.1,69859,38410,21993,21984
53713,23044,29.4,33862,21109,12264,10780
53714,16081,39.7,49371,26487,7864,8217
53715,13406,21.8,27528,15019,7250,6156
53716,18320,42.4,59269,33373,8915,9405
53717,11775,35.5,70765,49645,5694,6081
53718,12396,34.5,71706,35154,6015,6381
53719,30564,30.5,67647,35392,14805,15759
53726,6033,22.6,38883,30506,3323,2710
53792,9,-666666666,-666666666,,9,0
53801,1028,48.7,42578,21784,542,486
53802,49,50.3,21875,12449,25,24
53803,1379,41.8,50521,23594,737,642
53804,1446,37.1,43750,19887,763,683
53805,5385,39,45524,20517,2863,2522
53806,1826,46.2,43403,21540,952,874
53807,4524,44.4,54036,27148,2202,2322
53808,1069,42,51190,24351,539,530
53809,3801,41.6,46483,23572,1939,1862
53810,437,47.8,41250,21945,229,208
53811,3218,47.4,52635,24324,1551,1667
53813,6077,40.5,47962,23033,2932,3145
53816,942,33.4,44375,18813,507,435
53817,186,35,38750,18565,91,95
53818,14800,22.7,47030,18793,8100,6700
53820,2698,41.9,54449,25121,1511,1187
53821,8360,42.8,41307,23124,4255,4105
53825,601,28.9,52891,17681,337,264
53826,1286,44.1,42969,19677,690,596
53827,235,46.8,34706,24684,132,103
53901,15046,41.5,48650,24238,7902,7144
53910,2945,48.6,36607,19050,1445,1500
53911,1330,37,73438,31013,696,634
53913,19937,40.1,48276,25603,9966,9971
53916,22383,41.9,48060,25775,11236,11147
53919,2669,39.3,62212,24834,1361,1308
53920,369,60.6,53542,28255,179,190
53922,966,43.9,60192,26835,548,418
53923,2084,36.2,55167,24222,1091,993
53924,1241,45.1,44722,21528,654,587
53925,7837,42,57557,29235,3774,4063
53926,1624,26.6,50859,16774,807,817
53928,193,30.5,59643,22360,114,79
53929,2623,43.3,42148,21356,1363,1260
53930,1277,40.8,55078,23446,640,637
53931,229,32.8,55938,22512,123,106
53932,2361,35.8,60938,25332,1218,1143
53933,4174,39.5,53793,20025,2837,1337
53934,4632,52.1,41667,21961,2359,2273
53935,322,38.8,49063,21389,165,157
53936,2555,37.3,44583,13364,1881,674
53937,1048,37.5,57813,23033,577,471
53939,227,43.9,38750,22584,115,112
53941,2994,43,53550,26061,1581,1413
53943,1032,44,51563,26540,529,503
53944,2299,43.3,45329,22380,1296,1003
53946,4416,45.3,46974,24020,2111,2305
53947,81,50.6,34375,19251,39,42
53948,8276,44.3,45294,24265,4178,4098
53949,6000,50.4,44443,23795,3080,2920
53950,5502,45.5,44782,25784,3156,2346
53951,2565,37.2,53542,22929,1284,1281
53952,3344,48.9,47763,26248,1692,1652
53953,334,29,43068,16722,161,173
53954,7083,41.3,59633,27074,3575,3508
53955,5324,43.1,61327,30474,2705,2619
53956,3287,44.9,53357,25744,1736,1551
53959,13507,38.4,50972,23202,6576,6931
53960,3224,44.1,58650,29012,1717,1507
53961,770,44.6,48214,25893,392,378
53963,13822,37.9,49849,20517,8016,5806
53964,3590,44.1,47115,22388,1822,1768
53965,10265,44,51301,27457,5231,5034
53968,2554,39.2,47384,21826,1326,1228
53969,379,45.6,58250,25697,157,222
54001,8175,48,48750,27100,4054,4121
54002,6320,34.9,62286,26465,3232,3088
54003,900,46.1,66339,29501,425,475
54004,2451,37.7,50833,22023,1285,1166
54005,2983,40.4,52857,24104,1519,1464
54006,685,43.5,58906,30760,359,326
54007,1382,39.1,64375,25112,732,650
54009,2337,36.6,57500,26182,1157,1180
54010,34,51.6,-666666666,25435,20,14
54011,6492,39.2,62589,27276,3403,3089
54013,3323,38.2,54911,26939,1699,1624
54014,2401,41.8,69485,31646,1258,1143
54015,3655,33,72056,28560,1897,1758
54016,31006,38.6,80463,39629,15483,15523
54017,16589,35.3,60123,26394,8180,8409
54020,7424,37.2,53934,26348,3597,3827
54021,6740,36.9,78887,34948,3400,3340
54022,21786,28.8,60016,27608,10216,11570
54023,3802,33.7,72292,28471,1960,1842
54024,4544,45.2,50140,26694,2245,2299
54025,7179,34.5,62096,24382,3482,3697
54026,2053,37.8,59375,24627,1120,933
54027,959,41.8,70000,27042,505,454
54028,2178,39.1,52891,25040,1024,1154
54082,1719,46.1,84423,51906,850,869
54101,2758,41.7,64450,29360,1365,1393
54102,796,53.4,34028,21412,396,400
54103,356,55.9,34531,26190,192,164
54104,1234,57.4,33611,21441,652,582
54106,4941,39.7,55976,23478,2646,2295
54107,3736,34.8,55231,23778,1875,1861
54110,5390,37,61597,25551,2785,2605
54111,2289,46.1,53036,26078,1156,1133
54112,2189,38.7,48491,23291,1098,1091
54113,3337,39.4,68773,28555,1685,1652
54114,5280,51.8,38457,25995,2740,2540
54115,41206,34.7,62172,30581,20289,20917
54119,1069,22.3,39524,12955,464,605
54120,111,53.5,31250,19959,61,50
54121,3190,49.3,48728,22477,1640,1550
54123,230,41.9,63224,24372,104,126
54124,3843,44,42969,21835,1920,1923
54125,556,55.6,28393,19895,294,262
54126,3797,37.5,64943,24964,2044,1753
54127,34,43.5,50357,20603,18,16
54128,1763,44,39185,22130,766,997
54129,3161,43.4,53616,25955,1662,1499
54130,25315,35.6,60443,27289,13056,12259
54135,3320,32.4,37539,15645,1594,1726
54136,6396,39.7,45482,25367,3158,3238
54137,1071,44.7,52232,24797,526,545
54138,832,60.5,36528,27275,433,399
54139,3140,42,51900,23078,1669,1471
54140,8764,39.3,58247,26309,4418,4346
54141,2561,39.5,91250,33400,1432,1129
54143,14648,43,38775,24424,7274,7374
54149,1213,58.9,39545,22882,646,567
54150,832,29.3,22847,10647,426,406
54151,3376,45.7,45813,23500,1668,1708
54153,7228,43.8,46364,23682,3717,3511
54154,5568,41.2,42233,24959,2784,2784
54155,6327,38.7,65000,32066,3160,3167
54156,1552,51.9,37872,19829,787,765
54157,6188,40.9,50327,23354,2919,3269
54159,1542,46.4,50441,23129,796,746
54160,216,41.4,55833,24295,112,104
54161,2844,47.7,43304,23533,1487,1357
54162,8715,39.1,58311,26209,4138,4577
54165,7697,39.7,58058,26288,3659,4038
54166,17044,45.8,43775,24280,8409,8635
54169,2624,39.4,103295,40606,1335,1289
54170,3442,41.7,60128,26939,1790,1652
54171,3465,40.1,82378,33403,1673,1792
54173,3980,42.5,82877,38692,1993,1987
54174,2853,49.2,42592,23428,1376,1477
54175,987,58.6,46719,27324,563,424
54177,2876,51.1,40109,23796,1522,1354
54180,2993,33.8,71400,27922,1513,1480
54201,5352,45.9,43301,21796,2661,2691
54202,1623,48.9,56563,38226,817,806
54204,1680,42.2,58056,27863,863,817
54205,2203,42.8,60625,26186,1152,1051
54207,190,38.9,65208,28955,114,76
54208,6299,39.8,61381,26559,3306,2993
54209,1208,55.4,57188,37924,565,643
54210,818,57.8,50625,51336,437,381
54211,201,62.7,56250,52967,83,118
54212,1095,59.2,58281,34621,578,517
54213,1376,36.4,51400,21656,746,630
54214,216,46,52917,32773,111,105
54216,6214,46.1,52712,26390,3164,3050
54217,7380,39.9,63313,28023,3820,3560
54220,39854,43.9,45277,25690,19119,20735
54227,1578,44,67650,28972,865,713
54228,2588,44.7,59494,26964,1326,1262
54229,4123,40.4,68667,29538,1995,2128
54230,4594,42.2,61337,25995,2398,2196
54232,893,30.7,48304,19789,485,408
54234,1483,64,43831,31822,612,871
54235,16980,48.3,49189,28984,8378,8602
54241,14883,45.3,44970,23364,7382,7501
54245,2340,38.9,60353,28171,1196,1144
54246,782,63.3,50089,31487,365,417
54247,2189,45,61356,27274,1094,1095
54301,22552,37.7,48136,28221,11231,11321
54302,29224,32.1,35110,21938,14164,15060
54303,28548,34.3,40481,20577,13773,14775
54304,27784,40.4,45875,25151,13887,13897
54307,1265,29.7,-666666666,16,1265,0
54311,34526,34.8,61105,29112,16893,17633
54313,36884,40.6,73662,33855,18605,18279
54401,30650,38.6,47089,28208,15170,15480
54403,24611,41,50796,27095,12599,12012
54405,2830,38.7,45609,24130,1537,1293
54406,3367,41.2,58583,26732,1744,1623
54407,1526,45.9,61591,29934,831,695
54408,1075,39.7,54107,24598,604,471
54409,13056,43.8,42020,23224,6506,6550
54410,2454,38.1,54524,21752,1199,1255
54411,5722,38,54320,20921,2988,2734
54412,2020,42.1,57216,26524,1079,941
54413,109,45.8,36875,18512,51,58
54414,3285,42.3,48750,21616,1696,1589
54416,1914,40.4,42014,17757,894,1020
54417,82,50.7,50357,16332,45,37
54418,1069,47.6,58500,26297,524,545
54420,1439,32.6,46354,21444,780,659
54421,3134,40.2,43438,21244,1496,1638
54422,1221,32.4,41984,16551,636,585
54423,2278,44.2,65223,27276,1138,1140
54424,1781,47.1,52722,25196,905,876
54425,2163,34.1,43250,18739,1150,1013
54426,4405,37.1,53000,22036,2208,2197
54427,1223,40.5,48393,22530,616,607
54428,1119,58,35625,23125,571,548
54430,134,36.5,40250,17531,67,67
54433,1669,44.4,38859,22762,919,750
54435,2111,47.7,48615,24568,1133,978
54436,2272,34.7,41875,17657,1181,1091
54437,3154,34.9,48889,20445,1597,1557
54440,3032,40,57353,25068,1544,1488
54441,765,42.9,70455,30176,380,385
54442,1149,42.1,43125,21123,625,524
54443,2295,43,60759,28092,1121,1174
54446,3044,32.9,46403,19987,1539,1505
54447,549,40.6,30917,15858,283,266
54448,4455,43.4,66825,28424,2236,2219
54449,26061,42.7,49534,30041,12773,13288
54450,399,32.7,43906,16777,215,184
54451,11757,42.1,47564,24527,5903,5854
54452,19304,43.2,50827,25391,9623,9681
54454,1229,41.1,52313,25335,636,593
54455,17063,40.7,61942,29550,8612,8451
54456,6173,43.9,42351,22836,3056,3117
54457,8490,49.2,47982,24728,4264,4226
54458,150,36.5,56389,20718,74,76
54459,1256,45.3,38068,21819,663,593
54460,2784,39.8,37675,19057,1377,1407
54462,356,53.8,37708,17327,193,163
54463,772,49.1,52857,26260,419,353
54465,675,57,39313,24576,328,347
54466,2942,41.7,48182,25808,1526,1416
54467,13732,35.6,60646,27304,7084,6648
54469,1854,46.8,48977,23234,847,1007
54470,2126,45.2,38352,20271,1055,1071
54471,1825,41,71146,28068,936,889
54473,2416,47.2,48833,25562,1273,1143
54474,3733,41.2,51942,26902,1705,2028
54475,1638,42,65208,27192,897,741
54476,18963,37.4,51625,28557,9331,9632
54479,4254,36.3,54129,21733,2131,2123
54480,1304,39.9,41080,21681,649,655
54481,29149,27.6,40627,21424,13721,15428
54482,9206,44.5,65527,29972,4732,4474
54484,5140,38.6,58279,27235,2675,2465
54485,309,51.5,41731,26161,173,136
54486,2383,45.6,42740,21398,1208,1175
54487,9437,48.9,49206,25342,4661,4776
54488,1265,33.9,48571,22470,702,563
54489,1526,43.5,55282,25599,762,764
54490,807,44.9,46912,28072,407,400
54491,1495,54.1,38199,22862,778,717
54493,610,51.7,38646,25067,311,299
54494,26400,45.6,49473,27339,12967,13433
54495,7936,39.9,36530,20069,3932,4004
54498,2279,36.2,42875,19703,1175,1104
54499,2992,40.9,41082,21503,1535,1457
54501,19965,46.6,44554,26691,9943,10022
54511,1272,45.1,37986,18766,697,575
54512,933,59,47500,30390,444,489
54513,407,45.9,43281,24720,209,198
54514,2037,49.1,40430,22616,1073,964
54515,450,49.8,43281,21888,238,212
54517,155,63.4,47000,41959,77,78
54519,1132,54.8,40938,25770,590,542
54520,4281,39.6,39243,20455,2176,2105
54521,7189,49.2,42445,26131,3772,3417
54524,743,44.7,43047,24178,400,343
54525,261,37.9,28906,16399,108,153
54526,856,41.2,36471,18350,443,413
54527,937,50.2,32115,18963,478,459
54529,1158,51.4,55625,31790,575,583
54530,822,49.9,35139,18804,447,375
54531,1459,51.8,51250,32233,794,665
54534,2344,48.4,37574,23678,1133,1211
54536,218,45,24167,21586,116,102
54537,547,49.6,42813,22654,280,267
54538,3162,40.4,33506,20115,1497,1665
54539,1199,53.7,48563,27540,666,533
54540,1112,51.8,33203,22545,580,532
54541,1416,45.8,47031,17917,714,702
54542,522,55.2,33472,19627,255,267
54545,910,55.6,48816,33115,454,456
54546,1321,44.7,37176,20965,646,675
54547,1219,59,38182,23490,658,561
54548,4743,56.5,49977,28633,2520,2223
54550,639,42.3,46136,23316,349,290
54552,4259,50.8,44524,24448,2190,2069
54554,1256,54.9,34609,23467,638,618
54555,4854,50.3,43634,24821,2388,2466
54556,1225,44.5,33295,20594,605,620
54557,965,61.4,53403,29816,472,493
54558,2414,53.2,39137,27520,1183,1231
54559,734,37.4,28750,16566,337,397
54560,498,47.6,60313,35470,275,223
54561,17,65.8,27222,73794,15,2
54562,1834,56.6,41627,26055,930,904
54563,726,49,40357,22546,363,363
54564,445,56.9,32237,23845,240,205
54565,101,58.5,46250,31990,59,42
54566,1377,42.2,40536,20000,655,722
54568,5016,49.1,41743,24911,2418,2598
54601,49744,29.9,44112,24205,23500,26244
54603,14335,40,42636,23415,7231,7104
54610,1667,50.7,39813,26460,883,784
54611,1223,34.7,54107,23827,625,598
54612,5125,37,47574,22952,2727,2398
54613,2055,53.5,41538,22211,1104,951
54614,2861,39.6,49338,24285,1520,1341
54615,10665,44.1,43558,22007,5829,4836
54616,2695,37.7,46010,21720,1373,1322
54618,2381,42.1,48906,23537,1225,1156
54619,3693,30.8,52188,18195,1909,1784
54621,1054,47.2,53125,26550,564,490
54622,2125,45.4,49758,25440,1048,1077
54623,1952,45.9,56793,30838,962,990
54624,1293,51.5,44563,24627,670,623
54625,260,38.8,41250,21828,134,126
54626,1291,44.6,47232,20639,722,569
54627,1840,47.1,51923,28391,980,860
54628,1118,53.7,43625,26312,617,501
54629,2484,45.1,51103,25784,1290,1194
54630,3963,43.2,54474,26677,1897,2066
54631,1884,46.6,42566,19688,982,902
54632,1156,47.8,55000,25950,561,595
54634,4252,36.9,43087,19154,2155,2097
54635,1762,41.8,48333,24832,876,886
54636,14312,34.8,67516,27313,7597,6715
54637,228,30.2,49167,17554,144,84
54638,1498,37.2,44318,22273,729,769
54639,2607,40.3,42417,19820,1318,1289
54641,0,-666666666,-666666666,-666666666,0,0
54642,2050,39.8,49227,23814,1072,978
54643,8,36.5,-666666666,26238,3,5
54644,1313,35.8,48289,22086,698,615
54645,71,33.5,57614,22015,38,33
54646,3911,41.5,44000,19817,1938,1973
54648,1561,37.5,44750,20307,797,764
54650,23231,40.6,60259,31199,11188,12043
54651,1381,39.8,40000,17150,672,709
54652,965,39.5,32143,20691,447,518
54653,883,33.9,55536,20976,458,425
54654,163,50.3,54063,24787,84,79
54655,1682,47.2,38375,22500,831,851
54656,17268,39.9,51000,24307,8814,8454
54657,426,40.2,39375,26328,215,211
54658,2101,48.5,56224,29344,1095,1006
54659,1628,28.9,42614,18841,863,765
54660,16384,37.9,48355,23710,8175,8209
54661,3423,40.8,54866,28922,1613,1810
54664,1566,44.1,39394,18261,765,801
54665,8635,44.1,42143,25107,4131,4504
54666,2571,46,51510,27036,1386,1185
54667,4748,39.1,52101,23203,2489,2259
54669,7760,40.2,62202,28414,3802,3958
54670,1935,27.8,46346,16157,1003,932
54701,40455,32.1,51413,27368,19052,21403
54703,42197,32.7,44557,23468,21318,20879
54720,6947,37.4,47477,26741,3357,3590
54721,1459,37.6,48281,23467,770,689
54722,4220,35.3,41348,20450,2306,1914
54723,1209,42.3,48021,25842,633,576
54724,7237,38.8,53423,23618,3349,3888
54725,2861,41.9,46250,23510,1468,1393
54726,1713,39.6,46771,21535,900,813
54727,5063,40.9,51393,23003,2635,2428
54728,6235,48.2,40804,22121,3215,3020
54729,31691,40.1,51886,27111,16331,15360
54730,4768,39.8,55221,23598,2514,2254
54731,816,41.4,27202,18683,384,432
54732,2943,44.8,47143,21214,1548,1395
54733,1305,41.3,50809,23292,697,608
54734,779,40.8,52955,21877,407,372
54736,3865,45.6,47692,24060,2008,1857
54737,520,42.9,50625,26391,272,248
54738,3056,41.5,59135,31766,1552,1504
54739,4752,36.6,60493,25468,2410,2342
54740,2221,42.2,52596,25484,1136,1085
54741,1544,41.3,38958,16822,749,795
54742,3905,43,58667,26474,1972,1933
54745,2098,50.2,47736,24548,1025,1073
54746,722,45.5,51250,23173,358,364
54747,2583,39,41755,22124,1371,1212
54748,1151,51.1,49653,22473,545,606
54749,1179,42.9,52045,25497,627,552
54750,925,47,51029,27728,521,404
54751,25904,27.7,45719,21253,12774,13130
54754,1719,44.7,38239,18888,836,883
54755,7555,40.4,48343,23550,3761,3794
54756,857,46.1,44167,25626,458,399
54757,3524,41.9,45500,21612,1840,1684
54758,4776,42.2,51636,23892,2453,2323
54759,1547,50.5,49408,25019,738,809
54760,180,56.8,48438,26693,91,89
54761,1335,44.6,49345,20996,721,614
54762,1165,45.3,48229,26720,580,585
54763,1255,44.3,56131,26272,640,615
54765,37,22.7,20500,15551,22,15
54766,1632,35.9,36985,17548,860,772
54767,3245,39.2,52212,24642,1669,1576
54768,6138,35.6,37034,17772,3463,2675
54769,389,56.1,63250,34112,198,191
54770,2122,41.8,48676,23277,1093,1029
54771,4360,35.4,42250,19889,2151,2209
54772,1058,39.5,45125,20815,540,518
54773,3330,41.5,48603,21932,1671,1659
54801,6509,46.5,42000,24665,3185,3324
54805,1551,36.9,46154,19960,826,725
54806,11496,41.4,40224,22672,5781,5715
54810,2261,48.5,44476,25229,1185,1076
54812,5531,40.4,41926,21497,2808,2723
54813,555,48.8,43250,23672,301,254
54814,2632,44.6,38125,21026,1333,1299
54817,2142,54.9,46848,28751,1026,1116
54819,2551,46.8,37426,20081,1332,1219
54820,694,49.8,51000,25804,363,331
54821,1344,58,39632,29100,695,649
54822,4585,39.9,48598,22565,2267,2318
54824,2247,37.9,45231,23146,1149,1098
54826,832,48.3,40750,23469,428,404
54827,162,60.8,51250,31931,83,79
54828,879,43.7,30061,17498,441,438
54829,5151,45.4,46875,23442,2570,2581
54830,3068,59.7,42014,25885,1618,1450
54832,457,56.5,32125,26847,205,252
54835,892,48.6,35000,21340,481,411
54836,1105,38.3,66308,26113,615,490
54837,3551,47.2,38893,23392,1756,1795
54838,1366,55.1,47984,25479,769,597
54839,306,43.5,39167,20772,157,149
54840,4415,43.5,38898,22000,2193,2222
54841,307,31.3,41250,17398,160,147
54842,70,48.3,67750,32251,30,40
54843,11288,45.6,41225,24231,5523,5765
54844,236,59.9,51563,32629,127,109
54845,144,49,38750,20957,62,82
54846,591,47.1,33393,18447,289,302
54847,2322,50.2,45648,25565,1198,1124
54848,5999,45.1,40528,21420,2912,3087
54849,2100,47.5,59833,29254,1064,1036
54850,180,57.9,44500,31958,93,87
54853,4172,46.2,44118,26625,2027,2145
54854,1037,38.9,53043,21922,546,491
54855,951,22.8,42917,16126,524,427
54856,1530,40.6,46125,22170,826,704
54857,19,-666666666,-666666666,,9,10
54858,1655,43.8,43047,26057,935,720
54859,1638,55.3,43021,25095,831,807
54861,190,23.4,24464,11372,86,104
54862,268,55.6,28250,15544,117,151
54864,1447,36.1,58438,24740,715,732
54865,426,57.3,37500,26390,232,194
54867,247,58.2,34423,21985,141,106
54868,15648,44.4,40895,24969,7636,8012
54870,1666,51.8,50192,26929,846,820
54871,3218,42.8,43661,23636,1578,1640
54872,2575,44.8,35255,19515,1324,1251
54873,2636,52.4,49861,25961,1396,1240
54874,3688,41.4,54828,25423,1952,1736
54875,998,51.1,35147,20501,518,480
54876,1674,52.5,40976,24019,857,817
54880,30396,37.5,41798,24825,14775,15621
54888,1389,53.2,43631,27460,668,721
54889,2739,45.8,46048,22965,1408,1331
54891,3360,48.4,50049,27137,1727,1633
54893,3636,49.4,36695,23492,1858,1778
54895,1022,49.8,40739,23722,551,471
54896,1514,52.6,36300,22230,824,690
54901,38967,29.4,37948,18534,20972,17995
54902,22553,39.8,46080,25853,11065,11488
54904,20380,43.8,67145,33893,10048,10332
54909,2418,41.2,52330,24403,1269,1149
54911,25851,37.5,49086,24416,12583,13268
54913,17940,38.9,71549,41367,8848,9092
54914,30938,36.5,48878,26963,14985,15953
54915,42554,35.7,64705,27957,20865,21689
54921,1314,43.2,46250,21602,723,591
54922,1481,41.7,57614,25804,815,666
54923,8973,43,47045,24966,4594,4379
54927,439,41.8,52083,61033,222,217
54928,442,40.7,63750,28100,220,222
54929,8830,42.2,42349,22185,4357,4473
54930,1750,49.2,41400,22499,880,870
54931,230,49.5,51667,22700,120,110
54932,1306,40.1,76103,29014,639,667
54933,307,43.5,44479,22150,173,134
54934,121,41.6,50833,24133,71,50
54935,42245,38.6,46468,25732,20547,21698
54937,19138,41.6,59556,27899,9303,9835
54940,3772,47,56579,28082,1962,1810
54941,2292,53.5,51321,34452,1130,1162
54942,8977,35.5,89013,35765,4667,4310
54943,1873,50.8,39010,21223,949,924
54944,8322,40.7,73920,30102,4220,4102
54945,3586,45.8,50365,24778,1800,1786
54946,56,77,-666666666,23377,36,20
54947,2425,50.1,63516,32154,1135,1290
54948,216,44,38438,22677,116,100
54949,3325,40.2,54099,25238,1685,1640
54950,3056,44.3,41005,23622,1569,1487
54952,25714,37.5,48964,26548,12677,13037
54956,43355,38.1,60210,31644,21051,22304
54960,2596,54.4,44464,25239,1340,1256
54961,14107,41.7,55952,26388,7223,6884
54962,1109,47.9,51372,26346,578,531
54963,7196,40.7,60688,26215,3725,3471
54964,1052,44.8,64514,31192,529,523
54965,1410,46.3,45625,23691,743,667
54966,1995,38,47692,22724,1005,990
54967,492,33.1,34948,17830,227,265
54968,2948,47,42287,23935,1442,1506
54970,4050,44.3,38919,17909,2493,1557
54971,10893,39.8,52299,23576,5106,5787
54974,1406,40.9,61184,28930,689,717
54977,1381,44.4,59539,27239,737,644
54979,1400,42.9,65313,26566,694,706
54980,120,49.7,55417,30635,52,68
54981,15532,46.5,48141,28364,7890,7642
54982,7132,44.6,44390,23279,3644,3488
54983,4569,43.8,51142,22684,2295,2274
54984,3156,55.2,42396,25828,1550,1606
54985,313,38.9,-666666666,2025,266,47
54986,4583,47.1,61371,34552,2291,2292
55001,2918,50.5,103603,44501,1465,1453
55003,3862,39.4,55175,27012,2330,1532
55005,4450,37.6,83182,30252,2319,2131
55006,3948,37.1,51278,21196,1926,2022
55007,2500,44.4,45161,21217,1261,1239
55008,14920,38.1,53727,25475,7318,7602
55009,7984,45.6,60929,31647,3994,3990
55011,10000,39.7,89798,32473,5254,4746
55012,2204,39.4,73125,28794,1108,1096
55013,6317,43.7,67024,31730,3257,3060
55014,27703,37.9,81887,31175,14456,13247
55016,34601,34.8,81480,30452,17159,17442
55017,768,41.5,47260,20649,356,412
55018,966,43.3,77500,32408,485,481
55019,1921,37.8,70104,30041,977,944
55020,3554,35.2,85972,31772,1806,1748
55021,29791,37.8,52896,24041,16021,13770
55024,32547,33.5,85662,30108,16088,16459
55025,23594,39.9,72222,31741,11691,11903
55026,467,48,65417,30266,248,219
55027,2832,34.2,67464,27106,1408,1424
55029,17,-666666666,-666666666,,17,0
55030,1357,40.9,40605,19425,694,663
55031,2085,37.4,81250,34478,1114,971
55032,3340,40.3,66146,26850,1700,1640
55033,29512,39.4,69230,32619,14455,15057
55036,53,38.9,26250,13862,26,27
55037,4946,42.5,37522,20412,2487,2459
55038,21029,33.7,83624,34310,10545,10484
55040,12769,35.9,60897,25822,6480,6289
55041,7653,46.6,51429,28267,3773,3880
55042,8790,43.2,104444,43691,4288,4502
55043,3537,44.8,76336,36727,1808,1729
55044,48198,36.3,99243,38547,24050,24148
55045,7562,42.1,66660,32282,3725,3837
55046,5349,31.7,72125,27935,2605,2744
55047,2910,50.4,94028,38755,1626,1284
55049,2652,34.8,59286,23134,1321,1331
55051,9623,44,46610,23193,4817,4806
55052,1846,43.1,55000,25935,957,889
55053,1010,42.7,71023,29766,528,482
55054,2481,29.2,94076,29707,1226,1255
55055,3455,41.4,56310,27267,1823,1632
55056,13717,36.1,64451,25644,6714,7003
55057,24968,31.1,67757,26543,11989,12979
55060,28884,39.4,54945,27727,14209,14675
55063,9171,43.2,47556,22709,4749,4422
55065,1135,41.1,77778,30365,571,564
55066,18417,42.2,53113,28608,9113,9304
55068,27832,35.8,85602,32687,13558,14274
55069,5450,37.7,54203,20182,3396,2054
55070,7502,32.7,64753,26461,3866,3636
55071,5553,35.3,59240,27246,2771,2782
55072,4570,40.8,41206,17687,2849,1721
55073,3033,49.9,83083,34298,1557,1476
55074,2000,37.3,55200,27209,1080,920
55075,20326,36.6,55030,26025,10112,10214
55076,21740,40.9,62353,33459,10305,11435
55077,12311,33,72404,35050,6107,6204
55079,7937,40.9,69357,28579,4272,3665
55080,2350,45.7,63015,30426,1278,1072
55082,34673,43.4,75425,39734,17238,17435
55084,1778,37.3,62589,26349,898,880
55085,478,42.5,71667,29911,245,233
55087,428,45,74625,25000,201,227
55088,1697,40.6,81250,38787,897,800
55089,2005,41.1,79583,34966,1065,940
55090,520,37.2,48542,24280,247,273
55092,11462,39.1,75095,30785,5835,5627
55101,5980,35.7,40300,34082,3041,2939
55102,17220,38.1,46255,36682,8508,8712
55103,13060,28.8,28899,16048,6527,6533
55104,44348,29.5,44629,25061,21952,22396
55105,27952,33,76472,42928,12669,15283
55106,54648,29.5,42686,17651,27022,27626
55107,15182,32.8,44913,20227,7388,7794
55108,15382,30.7,56994,33195,7013,8369
55109,31351,39.4,51782,27011,15070,16281
55110,37810,43.5,68618,36306,18434,19376
55111,0,-666666666,-666666666,-666666666,0,0
55112,43711,37.2,64763,32060,20993,22718
55113,39138,41.4,61113,33851,19138,20000
55114,3217,28.1,38861,23180,1635,1582
55115,9053,42.5,96088,42001,4428,4625
55116,24311,37.5,61142,38484,11890,12421
55117,43226,31,44040,22198,21157,22069
55118,27718,44.2,55862,37069,13370,14348
55119,40716,32.6,56275,25611,20217,20499
55120,4321,45.6,85938,48688,1964,2357
55121,8183,34.2,64385,33998,4066,4117
55122,30443,36.2,71038,37759,15155,15288
55123,26065,37.9,103829,44350,13237,12828
55124,49632,37.7,80378,36863,24534,25098
55125,42693,37.7,91591,41592,20401,22292
55126,25559,44.6,77451,44302,11922,13637
55127,17118,47.6,84888,48014,7859,9259
55128,28477,37.4,66170,30193,14101,14376
55129,20659,33.4,107649,44080,10067,10592
55130,16223,27.3,30092,14576,8229,7994
55150,202,37.5,44000,25722,95,107
55155,0,-666666666,-666666666,-666666666,0,0
55301,10645,29,86319,31225,5510,5135
55302,7025,43.5,58845,29419,3510,3515
55303,46557,37.6,68130,29489,23255,23302
55304,46526,39.1,91222,34326,23893,22633
55305,18535,43.8,66298,45967,8562,9973
55306,16505,37.7,59679,32171,8136,8369
55307,3399,37.1,51100,24958,1731,1668
55308,8799,32.9,78611,28138,4707,4092
55309,18718,33.9,76390,28566,9247,9471
55310,1455,48.1,51354,30112,774,681
55311,33912,35.8,106029,47892,16520,17392
55312,1597,43.5,57750,28382,756,841
55313,23493,36.6,67799,28634,11810,11683
55314,1468,43.1,52903,23786,758,710
55315,5005,34.4,105042,37462,2469,2536
55316,23403,38.9,84768,35569,11732,11671
55317,19506,39.6,102759,46677,9585,9921
55318,25741,34.9,73737,35063,12853,12888
55319,5193,41.2,81875,33487,2778,2415
55320,4717,36.3,66250,27886,2391,2326
55321,5338,35.9,60885,26167,2791,2547
55322,3178,36.4,76848,30069,1628,1550
55324,1315,49.1,56375,28098,697,618
55325,4527,40.7,58039,25102,2283,2244
55327,3386,47.3,86393,40972,1701,1685
55328,8686,39.5,81491,32943,4434,4252
55329,1906,39.7,50909,23388,927,979
55330,36438,37.4,74102,30369,18642,17796
55331,17387,45.4,108911,61569,8583,8804
55332,1633,49.3,45795,26521,853,780
55333,957,48,39911,27546,532,425
55334,2916,43.8,47652,25514,1446,1470
55335,1530,43.8,53984,26087,793,737
55336,8016,37.3,60413,26150,3933,4083
55337,44314,36,65372,31603,21174,23140
55338,1034,39.9,61354,24949,520,514
55339,1044,37.8,65833,31479,574,470
55340,6453,42.7,112196,66803,3294,3159
55341,2606,35.2,94375,35841,1250,1356
55342,2065,42.2,55982,26832,1037,1028
55343,25113,35.3,56118,33931,11805,13308
55344,14985,31.8,64285,40873,7476,7509
55345,21832,45.2,89936,46027,10600,11232
55346,16405,40.8,100775,46370,7877,8528
55347,30126,39.3,116682,55641,15121,15005
55349,4006,37.5,54732,26823,1984,2022
55350,18102,39.5,53249,27633,8992,9110
55352,8828,37,86228,32444,4399,4429
55353,3218,38.7,58558,26294,1628,1590
55354,2769,39.4,54444,24757,1356,1413
55355,9749,42.2,52529,26028,4944,4805
55356,5966,44.4,99485,58690,2964,3002
55357,3410,42.4,86111,37082,1696,1714
55358,4933,41.4,60738,28723,2502,2431
55359,6070,46,90521,42399,3128,2942
55360,2783,32.4,84913,29276,1402,1381
55362,18951,33.3,75079,29310,9403,9548
55363,4615,30.4,59308,25116,2357,2258
55364,14296,43.9,79938,46108,7192,7104
55366,537,33.5,36875,15408,265,272
55367,980,41.3,58750,30370,467,513
55368,2031,40.9,66848,29350,1024,1007
55369,33164,40.3,78965,36211,15807,17357
55370,863,45.8,71786,30692,449,414
55371,16356,38.5,56497,24814,8256,8100
55372,30650,38.4,98799,41562,15498,15152
55373,5457,33.1,77688,35334,2748,2709
55374,13336,35.8,95510,36069,6464,6872
55375,4548,32.9,91941,35375,2400,2148
55376,16630,35.4,89160,32578,8321,8309
55378,27357,34.8,91595,36416,13610,13747
55379,41427,33.1,79592,32532,20720,20707
55381,1933,45.1,61908,27550,1023,910
55382,3455,45.5,62969,30146,1730,1725
55384,1862,51.2,44667,39512,829,1033
55385,1310,45,54907,26048,664,646
55386,6784,35.9,120658,43155,3397,3387
55387,12773,37,78405,33579,6337,6436
55388,5617,39.1,65709,31193,2700,2917
55389,2561,38.5,56029,22542,1320,1241
55390,2503,35.8,63942,29098,1323,1180
55391,14875,47.2,97267,75834,7395,7480
55395,2774,37.6,54415,25956,1375,1399
55396,2231,41.8,48919,23296,1042,1189
55397,2892,38.9,73000,25216,1405,1487
55398,16038,33.1,71623,25483,7958,8080
55401,7543,34.4,84297,72298,4202,3341
55402,426,32,38274,38720,272,154
55403,14804,33,36849,43470,7787,7017
55404,28309,29.6,25346,20405,14488,13821
55405,15449,30.6,48913,40008,7977,7472
55406,32493,38.2,56989,32841,15793,16700
55407,37616,31.8,47433,23953,18494,19122
55408,31130,29.3,43178,31159,16373,14757
55409,11993,36.9,65938,36168,5681,6312
55410,19395,40,92462,52087,8958,10437
55411,27640,25.8,29355,13900,13473,14167
55412,21680,31.5,44637,19393,10633,11047
55413,12618,34.2,45518,31940,6455,6163
55414,27702,22.3,30946,19257,14451,13251
55415,3264,31.8,52736,32447,2148,1116
55416,29820,36,77213,54897,14192,15628
55417,26256,38.5,71316,36536,13321,12935
55418,30096,35.8,55486,30231,15017,15079
55419,26808,36.8,94177,49251,13099,13709
55420,22223,38.7,49445,25407,10466,11757
55421,27146,37,49333,26950,13210,13936
55422,28074,40.5,63525,35262,13437,14637
55423,35868,36.4,52927,27982,17656,18212
55424,10031,40,144583,71926,5099,4932
55425,9256,36.7,49790,26767,4556,4700
55426,25495,35.4,63699,34690,12779,12716
55427,22835,40.5,64314,33348,11202,11633
55428,29491,36.4,45068,23661,13903,15588
55429,27803,32.3,45490,20387,13450,14353
55430,22993,32.3,45811,21791,11210,11783
55431,18138,45.5,63837,34923,8676,9462
55432,30423,38.7,54910,27179,14843,15580
55433,34024,36.3,59258,27493,16326,17698
55434,28398,36.7,61812,27021,13814,14584
55435,12286,46.9,56213,47347,5307,6979
55436,12555,45.4,89530,61632,5951,6604
55437,17792,46.4,69408,38663,8569,9223
55438,17042,43.9,80246,52572,8297,8745
55439,8819,47.1,104211,61092,4182,4637
55441,17753,40.6,72965,42995,8594,9159
55442,12724,41.7,87428,48538,6086,6638
55443,33116,33.3,74597,29983,16348,16768
55444,14681,35.2,70648,28496,7361,7320
55445,9862,33.9,80992,31247,5217,4645
55446,20375,38.4,103035,52239,10231,10144
55447,21435,40.2,78739,44538,10253,11182
55448,27758,37.1,70448,31621,13568,14190
55449,24826,34.1,95621,39081,12210,12616
55450,53,-666666666,-666666666,,0,53
55454,7331,22.2,12806,11030,3901,3430
55455,1983,19.2,-666666666,3681,877,1106
55601,91,54.7,42750,19771,53,38
55602,147,60.6,46607,31520,83,64
55603,533,46.6,54205,27172,296,237
55604,3445,51.5,57135,34790,1651,1794
55605,525,32.9,40938,21820,280,245
55606,162,60.4,41705,37117,78,84
55607,103,55.9,40833,21806,46,57
55609,243,56,68942,35249,110,133
55612,623,40.9,47353,31610,366,257
55613,223,55.9,46786,33400,114,109
55614,2636,52.1,42571,27516,1376,1260
55615,217,51.9,43214,28982,122,95
55616,6936,45.5,46891,27367,3451,3485
55702,474,45.4,60000,26411,267,207
55703,786,48.8,48750,28509,450,336
55704,1206,38.7,48167,24088,629,577
55705,3276,48.1,46337,26010,1727,1549
55706,1627,53,40909,24329,803,824
55707,3568,39.5,55580,23840,1893,1675
55708,1054,46,31010,21237,523,531
55709,4191,42.8,45766,23840,2190,2001
55710,1142,51.3,75950,37351,524,618
55711,584,38.3,47039,20260,348,236
55712,619,41.4,42955,17974,321,298
55713,1112,39.5,41375,20766,617,495
55716,342,36.5,34792,18283,158,184
55717,224,50.8,66250,44946,133,91
55718,3178,44.8,58785,28199,1681,1497
55719,5931,44.8,37139,22547,2816,3115
55720,17149,38.3,48905,24311,8514,8635
55721,3333,48.7,63500,30129,1669,1664
55722,1063,38.6,43942,25065,529,534
55723,2500,51.5,44889,26686,1233,1267
55724,829,49.9,49926,26699,433,396
55725,94,54.8,65000,42954,47,47
55726,841,46.3,42847,22661,431,410
55731,5890,51.6,42386,26114,2980,2910
55732,1259,49.5,50000,26291,690,569
55733,4608,42.1,72531,29032,2398,2210
55734,6188,47,42753,25169,3014,3174
55735,1802,49,40592,23097,975,827
55736,1481,47.9,36055,21151,710,771
55738,514,48,66429,27067,291,223
55741,3122,51.3,48906,26987,1588,1534
55742,311,42.7,54107,24413,163,148
55744,20589,44.8,48562,24489,10290,10299
55746,17148,41.8,39165,23897,8067,9081
55748,1459,41.9,38304,21768,714,745
55749,561,49.4,54821,26559,315,246
55750,2087,49.9,48080,22948,1045,1042
55751,1469,48.2,51719,24899,763,706
55752,404,51.4,43438,23653,219,185
55753,1064,30.7,35673,18223,523,541
55756,413,54.3,56750,26858,193,220
55757,932,45.3,42250,21265,483,449
55758,142,51.8,48750,28420,81,61
55760,3097,52.8,36313,22286,1577,1520
55763,582,52.7,63750,29322,317,265
55764,550,48.3,35729,19013,321,229
55765,742,48.2,33167,21672,379,363
55766,47,33.4,58750,26868,24,23
55767,4615,45.8,45156,19367,2870,1745
55768,2913,45.5,54410,28596,1555,1358
55769,2534,46.7,44958,23453,1204,1330
55771,1833,42.9,41420,21119,948,885
55772,75,46.1,30000,15700,47,28
55775,1121,55.8,51515,29073,628,493
55779,3943,41.1,58972,28367,2301,1642
55780,235,31.9,58958,17983,95,140
55781,536,56.2,58750,34782,271,265
55782,467,46.1,60000,26224,254,213
55783,2360,45.5,47411,24511,1265,1095
55784,79,49.3,52500,26403,42,37
55785,219,46,41406,19616,116,103
55786,308,34.8,60341,20044,160,148
55787,410,55,36786,23697,213,197
55790,1794,57.5,48519,31829,983,811
55792,10000,46.3,35323,21992,4942,5058
55793,509,51.1,49750,24527,254,255
55795,1584,37.5,41313,19532,864,720
55797,1574,36.4,58664,24479,810,764
55798,546,49,45625,22665,303,243
55802,2212,59.5,24674,31860,971,1241
55803,17151,44.5,68704,33836,8760,8391
55804,14467,42.5,67478,33825,6894,7573
55805,10149,25.8,24239,16772,5172,4977
55806,9680,29.6,31460,18225,4915,4765
55807,10265,35.9,40315,21010,5001,5264
55808,5689,40.2,42167,23402,2776,2913
55810,8980,41.4,62065,28284,4652,4328
55811,26669,40,58002,28418,12913,13756
55812,10999,22,42148,24265,5667,5332
55814,725,42.4,-666666666,7672,714,11
55901,52796,33.7,65157,32189,25424,27372
55902,22656,39.7,81925,49247,10728,11928
55904,26074,35.1,52406,25872,13326,12748
55905,0,-666666666,-666666666,-666666666,0,0
55906,17866,42.2,68474,36317,8833,9033
55909,1361,44.2,49438,26632,648,713
55910,1451,42.1,55893,27271,816,635
55912,28806,37.8,42253,24248,14349,14457
55917,3753,43.3,59402,27544,1785,1968
55918,1078,43.8,52578,25142,520,558
55919,1026,50.3,60000,31979,502,524
55920,7104,34.5,74617,31912,3546,3558
55921,4830,43.1,47885,23305,2509,2321
55922,757,37,39583,20227,390,367
55923,4506,40.3,59542,28011,2237,2269
55924,1341,38.4,63846,28071,779,562
55925,1098,36.6,53750,25103,553,545
55926,739,43.1,49583,26181,371,368
55927,4029,36.2,61518,27026,2011,2018
55929,1260,33.5,75278,27751,647,613
55931,335,45.8,45625,23086,177,158
55932,2285,34.3,72721,30152,1202,1083
55933,286,35.7,53750,27843,156,130
55934,3443,38.3,66512,27853,1734,1709
55935,921,38.5,60000,25995,490,431
55936,1820,39.6,54079,28875,862,958
55939,2146,44.2,41094,22647,1083,1063
55940,2632,37.9,65417,28605,1334,1298
55941,891,45.4,52202,28277,471,420
55943,3022,46.4,51570,25658,1451,1571
55944,7145,37.2,74257,28843,3434,3711
55945,1293,48,54500,29511,706,587
55946,3217,43.6,53258,28203,1660,1557
55947,7586,43.6,62597,29248,3657,3929
55949,1699,46.8,47880,25095,837,862
55950,130,54,46250,19107,55,75
55951,1509,46.3,53542,27879,741,768
55952,2429,41,59539,26809,1289,1140
55953,802,45,50625,26764,407,395
55954,1379,48,44009,25846,656,723
55955,2694,39.8,85417,34517,1378,1316
55956,1852,43.3,66520,30990,985,867
55957,705,42.8,56406,27755,356,349
55959,2287,39.8,47188,22117,1170,1117
55960,3102,41.7,95625,43412,1558,1544
55961,441,46.5,47083,23122,217,224
55962,804,49.9,57321,26881,427,377
55963,5137,41.5,64464,40048,2401,2736
55964,4343,36.3,52192,27227,2128,2215
55965,2203,45.1,47694,25911,1140,1063
55967,948,40.4,63750,25803,471,477
55968,132,38,37500,19681,65,67
55969,1198,43,55208,25570,613,585
55970,1087,38.7,59464,25356,554,533
55971,3328,38,56393,24073,1631,1697
55972,5036,30.3,55450,21408,2568,2468
46968,88,63.6,28036,17670,30,58
46970,23780,39.1,38625,19928,12922,10858
46974,1710,41.1,53226,23598,832,878
46975,14841,40.8,40514,21824,7294,7547
46978,2102,43.2,49033,24264,1047,1055
46979,5108,40.7,70036,28436,2427,2681
46982,2942,39.1,49250,20061,1516,1426
46984,162,60.5,36250,32636,82,80
46985,1087,47,46328,31089,515,572
46986,1980,42.3,48542,21005,942,1038
46987,569,51.9,52083,24925,297,272
46988,1029,40,50402,28574,497,532
46989,5203,22.5,52708,16841,2673,2530
46990,1105,39.9,54005,19529,596,509
46991,1810,40.3,53370,25830,894,916
46992,16554,44.1,43091,21911,8046,8508
46994,2376,48.8,45852,22055,1134,1242
46996,7358,40.1,45412,20784,3735,3623
46998,74,59.3,62542,35245,14,60
47001,10171,40.8,48116,22141,4919,5252
47003,1029,41,39519,19997,524,505
47006,11985,38.4,63854,28830,5813,6172
47010,235,55.1,61464,32009,132,103
47011,863,43.1,63629,25981,502,361
47012,10371,40,49274,23110,5010,5361
47016,780,47,45865,19699,424,356
47017,446,46.4,30536,25507,290,156
47018,4370,44.2,54796,23721,2113,2257
47020,1745,38.3,40972,15287,915,830
47022,3288,38.5,74500,28915,1743,1545
47023,1675,34,45625,17318,871,804
47024,3187,39.5,38385,17635,1695,1492
47025,23160,40.8,58684,29928,11578,11582
47030,1501,42.2,41223,17969,813,688
47031,5161,44.3,39146,20778,2438,2723
47032,3092,42.2,51114,23137,1567,1525
47034,116,32.5,32000,17153,69,47
47035,392,24.8,39777,21693,220,172
47036,1064,36.7,63571,21301,558,506
47037,4598,36,43125,18710,2227,2371
47038,1543,35.4,46653,19773,739,804
47040,5412,42.3,49303,24952,2735,2677
47041,6287,38.2,64265,23613,3054,3233
47042,4222,41.4,44590,19478,1965,2257
47043,5200,42.5,37572,20080,2537,2663
47060,6228,42.8,67827,29675,3041,3187
47102,7849,37.3,39816,17829,3798,4051
47104,0,-666666666,-666666666,-666666666,0,0
47106,4476,41.7,68598,28065,2195,2281
47108,2180,38.5,37955,19600,1128,1052
47110,250,53.9,15859,19514,64,186
47111,14951,38.1,52252,24802,7012,7939
47112,16491,41.6,47745,23318,8322,8169
47114,344,36.7,53500,24267,197,147
47115,2647,43.8,50347,22474,1323,1324
47116,894,39.7,31042,16990,473,421
47117,4505,41.9,51463,21001,2226,2279
47118,3565,43.4,32073,18483,1733,1832
47119,11410,44.3,80434,37270,5489,5921
47120,1011,38.6,36528,19784,505,506
47122,10022,38.5,71105,30548,5219,4803
47123,147,40.8,39853,16301,82,65
47124,4590,36.2,74229,30052,2231,2359
47125,1778,36.4,44508,21234,889,889
47126,4131,37.9,62432,23776,2203,1928
47129,19750,35.3,41607,20299,9463,10287
47130,44870,38.1,49107,24782,21879,22991
47135,1361,42.1,47396,21769,534,827
47136,4199,35.9,67685,30722,2097,2102
47137,1559,47,47639,28819,777,782
47138,4843,42.6,48447,20976,2575,2268
47140,2531,39.5,35938,16563,1219,1312
47141,1996,41.7,44400,19409,1019,977
47142,976,46.1,40500,21663,553,423
47143,3219,44.5,68340,27100,1673,1546
47145,1974,35.8,48777,19691,1073,901
47147,864,45.9,37500,26991,511,353
47150,47954,38.6,43417,23326,22920,25034
47160,67,42,41786,20312,48,19
47161,4265,31.9,55951,20961,2107,2158
47162,680,49.8,21111,19763,292,388
47163,1731,39.1,38636,20894,882,849
47164,3162,41.7,49602,22978,1647,1515
47165,6351,42.2,42998,21163,3200,3151
47166,1366,44.9,66938,29375,690,676
47167,15167,38.8,41671,21255,7484,7683
47170,14174,39.3,43784,20974,7062,7112
47172,15645,37,61902,27998,7914,7731
47175,847,48.3,51818,26296,499,348
47177,1212,49.6,70893,37578,560,652
47201,42583,36.6,53738,26517,21270,21313
47203,26327,40.9,57716,30663,12833,13494
47220,5182,43.2,44833,25233,2629,2553
47223,1589,40.4,46716,23393,732,857
47224,545,39.2,60347,22030,347,198
47226,276,30.9,43375,16655,124,152
47227,1546,45.2,51442,20944,780,766
47229,3075,38.5,38967,18811,1490,1585
47230,1812,42.1,35402,18678,961,851
47231,1011,41.6,44722,21106,480,531
47232,3280,37.4,60128,21838,1613,1667
47234,1908,35.5,56801,21096,985,923
47235,1883,48.3,51994,25545,855,1028
47240,21160,39,48261,22636,10496,10664
47243,5886,29.2,43556,17107,2783,3103
47244,833,45.1,56548,28672,393,440
47246,4585,38,51591,21034,2268,2317
47247,87,56.5,39375,23760,40,47
47250,22177,42.9,44671,22811,10627,11550
47260,2053,35,39406,17637,1005,1048
47263,275,23.5,53750,14690,144,131
47264,1794,41.6,53056,22420,918,876
47265,20456,39.3,41572,19547,10396,10060
47270,719,32.8,38333,22733,335,384
47272,2250,43.3,40568,20261,1079,1171
47273,1757,38.7,52375,21879,963,794
47274,29024,37.2,47479,22751,14569,14455
47280,701,36.6,35625,19536,389,312
47281,1495,34.9,50469,23901,778,717
47282,202,51.8,42083,27322,89,113
47283,2828,36.2,48169,19542,1353,1475
47302,27195,41.3,30951,17656,12868,14327
47303,25877,27.7,29498,16765,12774,13103
47304,31218,34.7,46424,25960,14877,16341
47305,4142,34.1,21186,13519,2204,1938
47306,5519,19.4,-666666666,4558,2184,3335
47320,4147,47.6,51667,30790,2069,2078
47324,139,48.1,38250,22507,66,73
47325,634,50.9,47045,18313,327,307
47326,1911,29.8,54891,17060,984,927
47327,4664,41.3,42517,22560,2243,2421
47330,5663,43.2,43789,23647,2806,2857
47331,23184,41.6,36728,18851,11324,11860
47334,3178,46.4,45745,24631,1506,1672
47335,647,41.9,29955,17966,315,332
47336,3783,37.2,37050,17644,1763,2020
47337,183,49.6,43333,19687,71,112
47338,2646,44.6,44931,22372,1304,1342
47339,744,32.1,45128,21029,402,342
47340,2875,44.1,41125,21523,1552,1323
47341,2390,38.2,52857,20936,1247,1143
47342,2846,43.1,46977,21671,1474,1372
47344,243,17.9,45000,15306,134,109
47345,1536,40.8,45962,20913,750,786
47346,3883,43.6,47784,25715,1930,1953
47348,10029,41.6,40491,20680,4917,5112
47351,575,36.3,41563,16373,298,277
47352,770,52.5,38594,20073,382,388
47353,5778,40.3,42781,21017,2876,2902
47354,1083,44.1,43750,25161,566,517
47355,2761,45.2,42535,26740,1380,1381
47356,6002,41.7,49601,23536,2982,3020
47357,1409,42,63641,27517,733,676
47358,1270,33.2,45028,18445,652,618
47359,2891,40.6,38214,20244,1479,1412
47360,1523,46.7,42946,20898,768,755
47361,156,42.1,49375,21882,68,88
47362,29546,42.2,37734,18642,15434,14112
47367,123,39.8,41250,16255,45,78
47368,2807,45.9,44940,21627,1259,1548
47369,1578,39.2,40022,17521,741,837
47371,12591,39.5,39759,19702,6305,6286
47373,2011,43.6,42399,22819,949,1062
47374,46361,40.1,35108,20163,22059,24302
47380,2015,37.6,41027,20763,985,1030
47381,146,48.8,41932,21521,80,66
47382,163,25.7,23750,12694,86,77
47383,2771,38.8,54167,25112,1292,1479
47384,1945,40.5,45691,22557,1119,826
47385,1943,39.9,57344,22696,1020,923
47386,1494,43.1,62841,23002,788,706
47387,767,41.5,39886,19186,350,417
47388,365,39.4,33750,19481,170,195
47390,5254,39.5,36020,17497,2626,2628
47393,1823,40.4,53698,18472,1055,768
47394,8393,39.9,42837,23484,3936,4457
47396,7004,41.2,53981,32218,3476,3528
47401,42605,29.1,45415,29935,21720,20885
47403,30728,33.4,42778,22981,14879,15849
47404,20748,31.1,34298,20628,10253,10495
47405,4264,19.5,-666666666,2952,2114,2150
47406,4444,19.4,-666666666,2740,2101,2343
47408,25387,24,25360,20033,12543,12844
47420,48,50.3,-666666666,39550,15,33
47421,27649,40.3,41732,22343,13598,14051
47424,8631,43.4,48276,24632,4331,4300
47427,1298,35.4,31367,15797,666,632
47429,8504,34.1,55190,22626,4131,4373
47431,1268,35.6,37500,19556,628,640
47432,4557,46,37132,19246,2186,2371
47433,4457,37.4,50726,21259,2288,2169
47434,115,52.5,-666666666,21634,53,62
47436,1557,42.5,42042,18000,841,716
47437,0,-666666666,-666666666,-666666666,0,0
47438,4286,41.8,41393,20331,2141,2145
47441,9298,42.4,43401,23215,4559,4739
47443,1074,44.6,33438,19298,487,587
47446,10238,44.6,44590,21676,5045,5193
47448,7050,49.5,51003,25835,3450,3600
47449,538,47,55398,28855,248,290
47451,1377,41.8,40385,20953,676,701
47452,4952,40.5,40594,20034,2326,2626
47453,373,45.5,47083,22215,131,242
47454,7688,38.9,38557,18050,4031,3657
47455,21,-666666666,-666666666,,11,10
47456,1057,44.1,52500,25145,532,525
47457,52,50.8,37344,24021,43,9
47458,0,-666666666,-666666666,-666666666,0,0
47459,4172,39.6,47500,20551,2172,2000
47460,11131,44.9,44921,22463,5540,5591
47462,5710,36.3,46164,20937,2793,2917
47464,141,47.8,22917,18563,70,71
47465,631,40.1,48083,23490,355,276
47467,38,-666666666,-666666666,,19,19
47468,1121,52.1,51250,35164,556,565
47469,1822,38,39531,18064,897,925
47470,2068,43.9,36146,19362,1089,979
47471,2525,39.6,36611,20457,1314,1211
47501,17909,39.4,47471,22964,8757,9152
47512,3931,40.9,39279,20749,1933,1998
47513,1749,49.4,34353,21791,876,873
47514,1747,33.6,65250,4659,1576,171
47515,862,44.8,46625,19868,472,390
47516,1353,46.8,53806,28333,632,721
47519,275,51.9,41696,29115,107,168
47520,3147,37.7,36280,18626,1512,1635
47521,829,39.4,68194,22952,502,327
47522,206,45.9,51667,25812,125,81
47523,3328,43.3,56328,22736,1585,1743
47524,544,41.7,42875,19285,298,246
47525,218,51.4,62083,28157,117,101
47527,1884,33.5,52647,23757,960,924
47528,653,48.2,66250,23129,325,328
47529,865,40.5,42898,21265,449,416
47531,730,41.3,60865,24926,470,260
47532,4906,40,61653,24671,2224,2682
47535,289,61,36538,33813,106,183
47536,0,-666666666,-666666666,-666666666,0,0
47537,757,37.7,56406,19384,374,383
47541,1179,49,41607,24439,537,642
47542,9724,37.4,54613,22135,4771,4953
47546,20673,42.2,55549,28423,10565,10108
47550,662,42,68807,31105,355,307
47551,817,47.9,58023,22495,422,395
47552,97,64.6,28125,16589,41,56
47553,8545,36.7,44424,21523,4400,4145
47557,1320,34.2,58295,22962,723,597
47558,5307,26.3,55272,17582,2668,2639
47561,1393,38,35897,17569,720,673
47562,4237,34.8,45407,21699,2096,2141
47564,1829,40.3,46672,20546,799,1030
47567,5621,42.9,39896,21337,2749,2872
47568,770,29.7,38980,16185,428,342
47574,146,52.1,31932,13524,79,67
47575,917,39.3,50685,25991,448,469
47576,343,49.3,59519,26419,198,145
47577,893,54.8,28523,23898,444,449
47578,696,48.9,58250,25319,282,414
47579,3034,41.5,67411,28282,1528,1506
47580,624,30.1,68203,18887,309,315
47581,3693,45.6,45227,23474,1849,1844
47584,102,55,43571,29472,52,50
47585,542,41.8,35455,17670,282,260
47586,11281,41.7,48789,23382,5604,5677
47588,642,51.7,31429,26051,265,377
47590,539,47.4,52692,33241,301,238
47591,26995,37.1,40815,20681,13619,13376
47596,87,40.6,33906,19245,43,44
47597,1194,41.1,50417,19893,616,578
47598,3658,42.4,39949,22466,1850,1808
47601,14015,42.3,54074,27263,7238,6777
47610,5171,32.6,51411,20208,2793,2378
47611,1278,45.3,43750,29923,614,664
47612,1000,43.7,73523,43435,534,466
47613,2809,41.2,63198,27162,1408,1401
47615,1704,39.8,47292,19849,832,872
47616,339,45.3,63750,25869,141,198
47619,1538,39.9,52500,23240,725,813
47620,12834,41.9,58422,31106,6467,6367
47630,34898,40.2,69988,33361,16852,18046
47631,1818,52.4,53287,26730,857,961
47633,2671,41.6,48150,25440,1381,1290
47634,2207,46.9,51724,25905,1208,999
47635,5896,40.1,43941,20324,2933,2963
47637,1601,39.5,49180,21234,745,856
47638,3474,43.3,61175,28253,1586,1888
47639,4445,37.1,77216,28233,2308,2137
47640,1100,35.4,46250,21114,647,453
47648,4613,39.9,53235,25886,2353,2260
47649,1532,42.1,44022,23214,708,824
47654,104,28.3,33750,16652,48,56
47660,5051,43.7,37448,19843,2428,2623
47665,3734,36.7,64950,24663,1730,2004
47666,1347,46.9,52129,26137,698,649
47670,12140,39.5,45915,23971,5987,6153
47683,172,38.2,42500,17059,77,95
47708,323,49.9,30536,26715,215,108
47710,18968,41.6,36218,22089,9184,9784
47711,31638,41.2,48618,26273,15816,15822
47712,26654,31.1,45156,22772,12619,14035
47713,10221,39.3,24280,16796,4894,5327
47714,34523,32.7,35558,18438,16393,18130
47715,27039,37,41922,26258,12336,14703
47720,18245,43.1,62115,26999,9393,8852
47725,16001,38.9,80751,37444,7995,8006
47802,34260,39.6,43076,23566,18392,15868
47803,21614,35,46217,24788,10924,10690
47804,11487,36.8,35115,17872,5296,6191
47805,12457,40,53399,24445,6241,6216
47807,12814,28.2,21360,12221,6569,6245
47809,2827,19.8,-666666666,3300,1246,1581
47832,997,29.8,57635,23803,544,453
47833,1510,32.5,31708,16058,736,774
47834,19168,41.2,45352,21376,9575,9593
47836,41,56.7,-666666666,25393,25,16
47837,1382,42.1,53889,27635,702,680
47838,4050,37.1,52936,11038,3014,1036
47840,1902,37.7,57768,23708,945,957
47841,1990,42.8,40000,20165,912,1078
47842,9785,40.8,41270,22465,4774,5011
47846,437,41.6,55398,29585,221,216
47847,1057,47.1,51389,24184,542,515
47848,1846,39.6,52880,23995,992,854
47849,366,44,51406,19439,188,178
47850,2344,46.3,50966,24155,1130,1214
47853,97,50.6,55500,25246,45,52
47854,1119,40.8,49479,25161,649,470
47855,544,38.1,42500,16846,296,248
47857,545,40.5,51750,21083,253,292
47858,1036,38.7,57794,24586,539,497
47859,1438,34,46875,15885,753,685
47860,358,36.5,33512,15316,179,179
47861,532,45,51667,22779,284,248
47862,1526,37.4,40625,19245,766,760
47863,240,20.8,62875,18013,49,191
47865,35,65.1,2499,4226,3,32
47866,250,29.6,27344,17674,65,185
47868,2897,43.7,57708,24608,1480,1417
47869,136,40.1,-666666666,14298,47,89
47871,179,50.5,36071,20806,84,95
47872,8166,42.4,46780,19345,3436,4730
47874,3608,45.4,42964,22292,1811,1797
47876,393,21.6,-666666666,9222,10,383
47879,3459,43.7,36281,20004,1694,1765
47880,94,36.8,-666666666,21738,68,26
47881,471,35.9,62750,21321,259,212
47882,8180,39.5,40625,22049,3995,4185
47884,222,41.5,48125,19580,111,111
47885,8935,42.2,47381,22088,4472,4463
47901,3258,28.3,21250,20898,1827,1431
47904,15475,32.8,33379,17446,7981,7494
47905,40910,33.7,52174,26898,19701,21209
47906,68328,22.6,36101,22036,36862,31466
47907,0,-666666666,-666666666,-666666666,0,0
47909,40068,32.7,52439,25128,19143,20925
47916,36,47.5,42500,20269,18,18
47917,502,45.4,34286,20101,259,243
47918,5742,40.8,43147,22836,2973,2769
47920,2181,45.2,56359,30197,1151,1030
47921,1093,37.6,52639,26150,510,583
47922,1547,39.9,50625,21888,732,815
47923,3577,40.5,60950,24450,1749,1828
47924,176,55.1,50491,20282,96,80
47925,324,27.9,55096,15815,205,119
47926,932,35.9,50469,20121,464,468
47928,1903,46.6,43646,22740,883,1020
47929,678,40.2,55000,21868,323,355
47930,1021,31.3,52500,28280,510,511
47932,5381,42.5,53462,26981,2663,2718
47933,28124,40,45868,23145,14227,13897
47940,1428,34.9,55441,22283,724,704
47941,1164,34,58295,23011,563,601
47942,684,46.5,51313,22805,350,334
47943,995,31.2,70606,18508,417,578
47944,3493,40.4,51031,23594,1803,1690
47946,1889,48.3,46037,22217,976,913
47948,1464,41.6,47604,22722,713,751
47949,1716,38,49659,21134,785,931
47950,1003,42,42169,21002,536,467
47951,2055,47.5,43833,26089,1050,1005
47952,2685,45.5,37232,20271,1393,1292
47954,2446,42.5,51894,23587,1271,1175
47955,1114,35.9,44115,20456,479,635
47957,2162,36,41522,19308,1054,1108
47958,230,54.7,29000,17020,113,117
47959,2813,36.6,41308,19401,1431,1382
47960,15021,46.8,52626,25665,7422,7599
47963,2030,38.9,42917,20114,920,1110
47964,129,47.2,38750,19480,71,58
47965,645,39.2,43958,20758,312,333
47966,466,49.9,42031,19836,245,221
47967,924,35.5,53462,19191,496,428
47968,657,48.9,49306,24305,354,303
47969,134,52.1,67188,29936,78,56
47970,2097,38,53438,23142,1009,1088
47971,1982,40.4,45179,22156,932,1050
47974,1242,41.4,44250,25592,607,635
47975,457,48.9,48056,25079,200,257
47977,2256,37.9,51793,23473,1155,1101
47978,11622,39.9,53969,24519,5555,6067
47980,1115,38.1,51905,22889,569,546
47981,934,33.7,64000,24998,533,401
47982,123,49.8,49375,24956,50,73
47983,457,26.5,57532,15912,190,267
47987,3939,45.5,45900,24432,1943,1996
47989,1386,40.3,47569,23181,763,623
47990,1571,39.5,47000,19979,659,912
47991,1112,38.1,42143,20173,595,517
47992,1391,37.8,49834,33347,773,618
47993,4308,42.2,50717,26371,2136,2172
47994,335,56.3,37330,28025,174,161
47995,1510,41.5,48047,21362,724,786
47997,117,28.6,43333,20169,54,63
48001,11924,46.2,45625,26044,5913,6011
48002,3257,45.9,62958,26939,1605,1652
48003,5850,41.3,55446,26632,2807,3043
48005,5402,43.5,75388,31117,2686,2716
48006,3988,41.7,57317,23986,2107,1881
48009,20241,40.8,98750,67663,9622,10619
48014,4470,33.1,50234,19098,2236,2234
48015,8272,42.4,30752,19543,3548,4724
48017,11913,40,51868,29961,5771,6142
48021,32405,35.5,43274,18978,15281,17124
48022,2636,41.3,61397,23167,1259,1377
48023,5135,44.9,44038,25146,2492,2643
48025,14576,44.1,112183,60438,6738,7838
48026,14529,43.7,51585,28474,6745,7784
48027,3229,43,56331,24087,1633,1596
48028,1175,56.1,58281,38126,572,603
48030,16528,35.8,30875,17084,8229,8299
48032,2276,43.3,58750,25486,1149,1127
48033,16553,42.7,44011,27942,7128,9425
48034,13463,38.1,40731,27944,5920,7543
48035,34439,38.9,43809,22866,16042,18397
48036,21314,41.5,45573,26103,9841,11473
48038,41711,43.3,52030,28928,19198,22513
48039,7756,43.2,46190,21963,3892,3864
48040,9894,42,53237,25982,4833,5061
48041,4421,43.7,53772,25067,2352,2069
48042,27708,38.9,82344,30476,13968,13740
48043,16352,41.2,33267,21730,8274,8078
48044,52927,36.7,83313,32364,25600,27327
48045,24706,44.3,52214,31327,12422,12284
48047,39280,39.9,70452,31013,19113,20167
48048,8166,36.9,57393,22425,4312,3854
48049,5531,43.4,58040,26235,2896,2635
48050,1614,50,53375,26538,902,712
48051,17027,35.9,64328,25296,8881,8146
48054,7309,47.5,58250,29679,3475,3834
48059,15108,44.3,50704,29515,7296,7812
48060,40361,36.6,35337,19083,19945,20416
48062,9464,42.6,54219,27514,4601,4863
48063,4058,42.2,57034,27084,1947,2111
48064,4093,40.1,56310,23101,2232,1861
48065,10661,43,68763,29778,5534,5127
48066,47499,37.6,40289,20548,23323,24176
48067,24944,35.3,66659,40862,12377,12567
48069,2539,45.1,97670,53652,1300,1239
48070,6280,41.9,112869,53709,2939,3341
48071,29933,38.3,40140,22113,14725,15208
48072,15089,37.9,70023,35638,7579,7510
48073,33123,40.7,58755,37408,15868,17255
48074,9287,41.9,49109,24355,4508,4779
48075,21246,43.4,54152,28355,9729,11517
48076,25276,43.8,66177,31668,11575,13701
48079,12232,42.9,58768,30707,5994,6238
48080,22798,43,50119,29621,10287,12511
48081,20839,46,57256,31194,9991,10848
48082,16180,44.8,53518,26963,7956,8224
48083,23305,39.1,63788,29769,11297,12008
48084,14689,37,84331,44055,7223,7466
48085,24292,43.4,91629,37116,11822,12470
48088,22844,42.4,55289,26791,11041,11803
48089,29960,33.9,35165,16509,14590,15370
48091,31746,37.3,36401,18072,15452,16294
48092,26516,41.2,48225,23739,13144,13372
48093,23310,45,48831,26259,10731,12579
48094,18424,40.6,76701,35677,9321,9103
48095,4778,45.2,84539,38449,2270,2508
48096,3830,47.5,76102,32021,2079,1751
48097,5278,41.5,44146,20601,2617,2661
48098,19414,45.5,113574,52916,9569,9845
48101,27933,41.6,58720,27119,13048,14885
48103,54593,38.1,75559,42394,26703,27890
48104,39125,23,49756,32201,19515,19610
48105,33729,31.8,59130,40967,17306,16423
48108,26657,34.4,58507,35354,13220,13437
48109,6878,19.2,-666666666,22390,3303,3575
48111,42081,38.4,52054,27306,20773,21308
48114,20575,44.2,83661,36302,10325,10250
48116,26103,44.1,73793,36453,13010,13093
48117,10049,42.3,55778,26311,4984,5065
48118,12562,46.6,68134,35811,6275,6287
48120,7454,28.5,48333,20774,3859,3595
48122,10661,35.4,33223,18117,5045,5616
58324,1360,45.1,52813,28374,644,716
58325,83,60.3,52917,29719,45,38
58327,407,41.3,54432,52394,221,186
58329,3231,30.8,25109,13624,1570,1661
58330,363,50,38750,30231,207,156
58331,116,53.5,69792,51149,58,58
58332,302,61.8,41667,28555,143,159
58335,1580,19.9,22794,7640,769,811
58338,101,48.5,85000,48783,43,58
58339,32,58.5,56250,56725,19,13
58341,2582,51.3,40071,24604,1248,1334
58343,63,69.5,22083,19375,32,31
58344,836,50.6,56250,35304,449,387
58345,150,57.3,48281,37100,67,83
58346,635,49.8,46806,29024,308,327
58348,723,49.8,35938,25555,359,364
58351,439,41.3,41667,23524,252,187
58352,480,53,56500,37846,252,228
58353,49,61.5,57500,40249,21,28
58355,65,47.5,98500,46437,32,33
58356,1738,47.8,42969,28072,789,949
58357,389,29.3,36250,18502,171,218
58361,309,52.4,58125,26120,176,133
58362,32,-666666666,-666666666,,12,20
58363,115,51.5,80625,40601,64,51
58365,291,44.2,62917,38485,149,142
58366,1233,38.6,56429,22796,632,601
58367,1581,36.8,37361,22899,791,790
58368,3907,48.2,41765,22733,1996,1911
58369,1306,38.9,29375,17469,601,705
58370,1489,23.6,36810,12564,770,719
58372,110,48.3,51042,40915,56,54
58374,624,43.6,39250,28615,322,302
58377,416,42,59375,36682,214,202
58379,353,24.8,31696,11827,207,146
58380,351,56.8,47500,34134,187,164
58381,316,40.2,54375,36279,191,125
58382,171,41.6,65357,39809,106,65
58384,578,51,34531,24797,332,246
58385,285,45.5,38750,28399,171,114
58386,198,46.7,58750,32614,134,64
58401,17220,42.8,49184,27241,8565,8655
58402,388,37.2,-666666666,4147,324,64
58405,342,19.9,-666666666,5637,140,202
58413,1151,53.1,32596,25824,593,558
58415,117,51.9,78750,32732,53,64
58416,434,60.4,39773,30388,235,199
58418,356,49.9,57750,42213,159,197
58420,295,36.3,114688,46618,142,153
58421,2894,44.6,51154,32933,1433,1461
58422,267,48.9,52697,34753,129,138
58423,75,53.5,51250,50685,39,36
58424,211,47.6,44167,23516,100,111
58425,1467,52,50139,26136,687,780
58426,201,45.5,81818,39934,102,99
58428,311,48.8,51250,29626,177,134
58429,330,30.9,56250,28904,178,152
58430,112,40.3,29750,36751,65,47
58431,111,61.1,62917,31931,56,55
58433,1076,48.8,53929,30264,515,561
58436,2100,41.8,43712,21049,1110,990
58438,618,52.3,49286,33607,302,316
58439,180,32.8,76053,30195,94,86
58440,193,44.1,50938,29237,106,87
58441,252,50.3,32500,34456,148,104
58442,533,52.6,37500,20596,259,274
58443,175,56.1,52857,39910,102,73
58444,238,57.2,48409,24945,119,119
58445,129,36.1,43750,21556,60,69
58448,280,54.6,40417,27010,159,121
58451,187,51.5,62778,29103,114,73
58452,34,64.2,63542,23426,16,18
58454,491,47.3,48875,29056,318,173
58455,356,45.5,59219,40559,180,176
58456,440,54,39432,35509,205,235
58458,1286,46.2,51989,28893,684,602
58460,228,62,37054,31544,121,107
58461,497,56.6,56324,32825,240,257
58463,596,53.9,40750,29296,279,317
58464,282,57.2,46250,21658,149,133
58466,509,44.5,69844,36981,276,233
58467,737,39.7,54583,23666,354,383
58472,374,47.2,57750,30191,196,178
58474,2657,42.8,49851,26155,1262,1395
58475,153,56.5,40417,40871,73,80
58476,250,38.5,50882,47108,167,83
58477,193,44.8,29375,21656,114,79
58478,155,49.1,46250,34482,96,59
58479,246,48.1,49750,26979,134,112
58480,264,40.5,64167,26375,157,107
58481,266,45.5,69250,28935,118,148
58482,944,46.1,53750,28756,470,474
58483,199,52.8,51500,29667,101,98
58484,48,53.3,43625,40004,30,18
58486,134,50.8,44500,33157,75,59
58487,473,45.1,50060,23950,249,224
58488,283,56.3,36500,26027,146,137
58490,284,46.7,60455,35728,141,143
58492,539,36.7,42500,36095,233,306
58494,357,42.2,48500,29216,190,167
58495,1277,49.3,39750,24861,579,698
58496,167,62.1,80924,47777,94,73
58497,328,34,42813,32096,172,156
58501,28410,37,52358,30668,13745,14665
58503,27196,37.3,81341,38377,13481,13715
58504,25064,34.5,56740,29501,12286,12778
58505,0,-666666666,-666666666,-666666666,0,0
58520,313,49.5,33906,19905,172,141
58521,670,48.1,70865,34301,379,291
58523,3706,48.4,67047,33537,1873,1833
58524,55,72.8,16667,13776,24,31
58528,807,23.5,20625,9950,349,458
58529,622,48.2,44167,27067,275,347
58530,1144,47,63696,31061,568,576
58531,343,53.3,56563,42352,179,164
58532,279,42.5,39706,22392,131,148
58533,941,50.9,36667,29585,456,485
58535,514,49.7,55625,32665,258,256
58538,2735,25,37375,15512,1451,1284
58540,2310,52.8,50245,25333,1166,1144
58541,423,46.8,51250,38434,214,209
58542,278,48.8,46875,25032,149,129
58544,604,46.7,38333,32200,328,276
58545,3484,41.5,69797,31030,1808,1676
58549,148,46.5,48125,23451,82,66
58552,1705,51.2,38250,24926,814,891
58554,23277,38.2,62693,29796,11704,11573
58558,914,39.7,83550,36005,472,442
58559,190,52.3,44167,30363,96,94
58560,180,52.2,41528,35621,108,72
58561,1062,47.6,57794,30910,498,564
58562,370,55.9,39318,28903,201,169
58563,1988,42.4,55542,30510,990,998
58564,174,48,63750,22251,103,71
58565,184,53.5,51250,30350,103,81
58566,153,45.4,64375,25828,82,71
58568,435,33.4,42250,20483,209,226
58569,53,44.3,56875,26992,26,27
58570,426,34.1,58000,29236,216,210
58571,635,50,51944,30111,341,294
58572,320,50.1,45000,31437,189,131
58573,809,51.9,39926,32529,437,372
58575,856,51.1,37875,33576,439,417
58576,882,54,51250,31751,404,478
58577,1784,47,65365,35147,903,881
58579,1122,44,57059,33706,590,532
58580,318,52.5,51484,29593,174,144
58581,235,51.2,32778,20149,117,118
58601,22432,36.8,65148,31938,11276,11156
58620,186,45.3,75625,33369,92,94
58621,1122,46.1,32778,27661,545,577
58622,1625,41.9,60125,35029,870,755
58623,2397,45.4,53601,29338,1169,1228
58625,193,55.1,35000,25635,75,118
58626,270,48.2,56563,38356,160,110
58627,210,51.5,50938,33651,122,88
58630,484,37.6,51630,29738,292,192
58631,999,47.2,48056,25666,513,486
58632,219,34,38125,21617,100,119
58634,107,35.8,66944,36942,60,47
58636,823,41.4,51484,28047,445,378
58638,1157,45.1,52132,22997,594,563
58639,1767,51.5,47560,33517,889,878
58640,1595,36.1,72386,31230,801,794
58641,117,41.4,34844,29142,70,47
58642,350,51.2,75625,38463,189,161
58643,216,39,37813,23731,92,124
58645,231,44.6,46146,31490,139,92
58646,1173,49.6,46518,27790,565,608
58647,1156,47,49375,26557,549,607
58649,408,48.1,42955,26694,224,184
58650,420,48.7,61250,36944,208,212
58651,406,52.5,85417,52857,191,215
58652,994,45.3,47417,27934,542,452
58653,595,48,69464,28928,312,283
58654,334,30.9,52500,25038,183,151
58655,465,40.3,66016,25395,244,221
58656,382,40.5,48889,34002,222,160
58701,30193,35.5,54439,30303,15273,14920
58702,0,-666666666,-666666666,-666666666,0,0
58703,19644,31.1,60273,29086,10014,9630
58704,4970,22.1,45045,16930,2623,2347
58705,454,21.2,-666666666,20196,440,14
58707,462,19.4,-666666666,7902,164,298
58710,502,53.7,56250,30227,266,236
58711,148,57.4,61607,28458,82,66
58712,172,39.8,27250,26441,94,78
58713,23,34.2,53750,20578,15,8
58716,118,54.3,35833,22079,55,63
58718,1153,36.9,72500,32365,641,512
58721,537,38.2,58854,35187,298,239
58722,1575,33.4,71125,30505,877,698
58723,286,45.3,36806,19334,156,130
58725,270,36.5,75769,24922,163,107
58727,314,41.5,53125,29768,154,160
58730,1286,55.3,56417,34823,683,603
58731,297,34.7,58750,20502,147,150
58733,418,49.1,78667,38966,227,191
58734,271,41.5,60156,39574,149,122
58735,424,46.2,52708,35107,239,185
58736,492,49.9,44167,28116,259,233
58737,130,54.7,37143,25052,64,66
58740,832,39,63750,31108,394,438
58741,629,45.9,48750,28196,345,284
58744,119,59.1,41250,24848,75,44
58746,1450,47.1,55170,30111,730,720
58748,113,56.9,62500,47024,57,56
58750,619,37.7,64375,38334,332,287
58752,193,50.8,71250,48366,96,97
58755,106,51.6,28438,49201,51,55
58756,289,32.8,41750,23406,165,124
58757,982,19,42250,12266,479,503
58758,279,59.3,57500,30596,140,139
58759,994,35.5,57500,25971,529,465
58760,222,37.3,38958,19758,109,113
58761,1221,39.7,62895,29028,677,544
58762,221,47.4,51667,33559,148,73
58763,3558,33.1,51649,24302,1848,1710
58765,306,47.1,59167,30974,187,119
58768,170,55.3,59500,43923,84,86
58769,350,35.9,40714,41937,211,139
58770,1396,38.1,70333,30748,680,716
58771,569,33.4,59712,37339,321,248
58772,121,40.3,42250,24211,63,58
58773,837,35.7,52206,32371,415,422
58775,401,32.8,85250,31347,192,209
58776,253,41.4,105250,45530,136,117
58778,136,55.3,37500,37072,65,71
58779,587,53.3,39375,25178,292,295
58781,722,39.5,73625,32461,385,337
58782,371,51,58750,34178,182,189
58783,404,44.1,55707,33101,230,174
58784,2453,36.9,75326,37368,1397,1056
58785,1073,35.6,70385,27856,550,523
58787,129,53.9,41458,48328,78,51
58788,1079,45.6,40217,29566,582,497
58789,369,38.7,37411,25456,196,173
58790,1705,35.1,53869,27768,842,863
58792,260,64.6,44643,29993,146,114
58793,660,50.8,58750,29524,337,323
58794,113,16.8,58125,26035,65,48
58795,175,51.5,106250,49222,88,87
58801,20786,34.7,77200,38895,10926,9860
58830,296,41.6,69000,63149,152,144
58831,562,33.1,52014,36125,309,253
58833,55,59.4,27292,33396,29,26
58835,397,31.9,100000,48695,280,117
58838,272,40.5,66250,32182,169,103
58843,472,42.9,84375,41775,233,239
58844,249,45.5,50982,21448,122,127
58845,294,47.7,66563,42157,153,141
58847,564,43,94421,42881,244,320
58849,1154,30.4,61027,28520,641,513
58852,1626,48,76667,46010,841,785
58853,354,25.6,65625,24433,199,155
58854,3331,42.1,71471,39577,1706,1625
58856,166,49,86667,37904,90,76
59001,1572,53.4,44550,31389,734,838
59002,264,38,37250,12256,139,125
59003,1016,35.5,55375,20438,446,570
59006,737,40.9,26667,21124,359,378
59007,140,46.3,51250,25954,52,88
59008,363,52.3,30694,22252,206,157
59010,87,47.2,39861,17914,48,39
59011,3025,43.8,45917,22721,1572,1453
59012,283,29.3,31544,13262,135,148
59013,179,52.8,71563,43993,84,95
59014,1846,40.9,54821,23217,873,973
59015,602,43.7,52125,27198,349,253
59016,819,31.6,32308,13253,410,409
59018,590,52.3,38056,21392,319,271
59019,3984,46.1,54292,27514,2097,1887
59020,28,52.9,39375,28407,14,14
59022,2246,25,54265,10682,1198,1048
59024,508,48.5,44519,21259,217,291
59025,87,41.3,41875,16971,45,42
59026,291,41.5,55625,26222,153,138
59027,659,47.4,34600,21380,351,308
59028,434,50.5,61875,35215,215,219
59029,728,51.3,41250,24916,388,340
59030,1537,46.2,46064,24813,840,697
59031,391,21.3,28000,8228,160,231
59032,394,47.9,33229,17095,196,198
59033,328,52.1,39375,19151,166,162
59034,5614,36,40337,19611,2749,2865
59035,123,14.9,29091,11798,79,44
59036,1291,56.2,31062,18930,595,696
59037,1661,40.8,64740,29231,766,895
59038,597,53.8,36711,24922,298,299
59039,34,67.3,33438,24182,23,11
59041,1786,50.8,43796,27163,871,915
59043,3193,25.1,32833,11752,1640,1553
59044,11079,40.1,55026,26686,5413,5666
59046,362,49,38583,20559,168,194
59047,12035,45,42910,24672,5886,6149
59050,1475,30.3,39563,16115,785,690
59052,163,45.1,82500,31721,89,74
59053,553,28.5,45350,17203,322,231
59054,280,54.6,45000,28607,127,153
59055,74,45.9,81250,28253,46,28
59057,611,48.5,62986,29839,332,279
59058,96,37,56458,24867,36,60
59059,154,50,49688,26959,78,76
59061,204,56.6,66750,37725,130,74
59062,61,45.1,173750,52333,20,41
59063,2015,39.5,63523,27001,1005,1010
59064,171,50.7,26731,33337,108,63
59065,48,60.3,49063,22285,29,19
59066,651,26.2,35000,14179,342,309
59067,335,38.9,62813,21587,160,175
59068,3301,50.7,49458,28663,1667,1634
59069,490,53.2,46667,32539,260,230
59070,927,46.5,42708,27722,491,436
59071,96,60.6,64875,53770,56,40
59072,4276,48.3,40927,21421,2158,2118
59074,359,56.2,39559,26971,198,161
59075,119,43.4,27083,20182,67,52
59076,74,49,40000,17792,45,29
59077,104,31.9,61250,22376,51,53
59078,104,57.7,32188,15716,73,31
59079,3583,41.6,64816,26355,1883,1700
59081,11,69.3,58750,33018,4,7
59082,31,32.8,70417,19839,12,19
59085,132,47.5,35938,23133,69,63
59086,758,47.9,51250,26690,322,436
59087,506,48.3,41250,22816,261,245
59088,1093,44.6,54148,28723,470,623
59089,360,33.3,38000,12161,185,175
59101,39757,34.3,40820,22576,19979,19778
59102,47930,40.4,50828,28396,22440,25490
59105,30032,37,56986,27360,14964,15068
59106,13050,40.9,82468,44458,6494,6556
59201,5193,30.8,42699,17624,2562,2631
59211,214,46.2,89375,23358,104,110
59212,427,35.9,62500,25487,210,217
59213,778,29.3,34479,13991,389,389
59214,137,43.6,62292,23407,86,51
59215,1097,47.9,41379,24379,568,529
59217,305,28.2,31563,19588,145,160
59218,969,37.1,58750,26917,489,480
59219,189,55.2,72000,55532,111,78
59221,1581,40.4,49727,24379,814,767
59222,168,48.5,46875,27163,81,87
59223,330,53,62917,35906,196,134
59225,497,30.3,32000,14571,225,272
59226,426,50.8,39125,23862,205,221
59230,4626,45,49538,27595,2304,2322
59231,389,38,35787,16202,160,229
59240,12,58.5,52083,49842,7,5
59241,411,47.1,43929,22507,207,204
59242,112,31.6,67750,34501,47,65
59243,392,27.2,70833,23742,244,148
59244,62,53.7,41667,17747,33,29
59247,352,42.6,48021,24060,191,161
59248,688,54.4,45865,25092,363,325
59250,186,52.4,32500,21457,108,78
59252,115,41.1,40625,26257,52,63
59253,110,57,33906,27513,64,46
59254,2001,51.1,43571,29299,928,1073
59255,3489,27.5,23792,13713,1692,1797
59256,68,30.6,-666666666,36412,55,13
59257,28,-666666666,-666666666,,15,13
59258,120,43.5,67083,32974,66,54
59259,338,49.1,43393,33646,185,153
59260,115,52.1,64063,70909,58,57
59261,513,52.2,45441,23516,282,231
59262,816,40.2,52813,20102,396,420
59263,1457,50.4,46563,29775,759,698
59270,7623,40.5,62987,35477,3978,3645
59274,283,54,48750,31208,150,133
59275,315,51.6,36667,34249,153,162
59276,21,39.8,-666666666,22529,21,0
59301,11491,41.4,43698,24088,5657,5834
59311,202,46.5,28125,20600,124,78
59312,33,45.8,62813,25382,13,20
59313,2600,38.9,47708,25915,1299,1301
59314,101,61.3,75000,39672,55,46
59315,114,53,47917,22891,60,54
59317,1205,46.4,42065,26439,594,611
59318,86,46.4,41250,33385,41,45
59322,59,56.2,50000,20064,30,29
59323,2413,36.5,76000,32261,1178,1235
59324,860,52.4,41964,25861,394,466
59326,323,53.3,31667,19945,177,146
59327,2968,45,43969,24015,1487,1481
59330,8453,42.1,51500,26049,4396,4057
59332,157,56.2,39821,24311,81,76
59333,21,40.1,-666666666,16576,5,16
59336,223,39.9,51250,27671,134,89
59337,754,46.9,39205,26097,361,393
59338,128,54.5,25625,16866,64,64
59339,161,43.3,45000,27839,90,71
59343,35,66.6,52917,38251,19,16
59344,331,51.1,54107,49304,176,155
59347,294,51.1,58214,26838,119,175
59349,873,54.2,40066,20182,452,421
59351,134,50.7,21563,16534,84,50
59353,928,49.7,41875,27492,467,461
59354,100,11.3,63500,16494,63,37
59401,14093,36.1,39660,22261,6904,7189
59404,27043,41.2,55448,26611,13472,13571
59405,30784,34.5,41985,23715,15304,15480
59410,702,50.8,34609,30246,375,327
59411,346,45.9,48672,22647,212,134
59412,1732,37.8,57500,29427,907,825
59414,1087,45.1,24320,18032,517,570
59416,526,53.3,59779,51430,285,241
59417,7950,28.9,27670,11578,3906,4044
59418,123,55.9,59028,24257,45,78
59419,217,50.3,47292,25889,117,100
59420,226,39.8,64688,27300,86,140
59421,1795,51.4,52262,31581,886,909
59422,2483,46,35563,21595,1215,1268
59424,59,56.5,38750,28688,32,27
59425,3554,45,45948,21239,1714,1840
59427,4590,31.9,39572,21236,2066,2524
59430,448,48.3,41750,26640,251,197
59432,126,61.6,41250,24783,57,69
59433,648,51.5,43571,26633,360,288
59434,642,38.6,38375,21409,317,325
59436,1712,46.4,48409,24607,831,881
59440,132,48.6,44375,22757,66,66
59441,74,54.6,38000,21058,49,25
59442,1642,54.4,49213,29663,861,781
59443,882,39.3,39226,20396,457,425
59444,321,36.3,33125,12553,172,149
59446,578,45.9,32303,18434,312,266
59447,193,49.9,46250,23691,96,97
59448,658,25.6,28750,9214,347,311
59450,495,41.7,48333,25528,237,258
59451,219,42.1,31853,19198,120,99
59452,559,45.7,39813,21513,263,296
59453,337,42.4,38750,20918,187,150
59454,210,44.7,27396,37800,123,87
59456,194,33.7,41000,14243,102,92
59457,9233,48.7,38100,25043,4576,4657
59460,146,54.4,48333,29073,85,61
59461,11,-666666666,-666666666,,7,4
59462,119,51.8,51667,33416,53,66
59463,117,59.3,52500,65765,73,44
59464,452,44.1,50714,22644,247,205
59465,69,60.8,38750,26845,42,27
59466,97,52.1,36944,27716,56,41
59467,222,29.7,31250,9892,75,147
59468,756,34.8,57875,22369,381,375
59469,166,52.8,50893,26645,91,75
59471,313,32.5,43438,20557,146,167
59472,836,44,44655,23220,455,381
59474,3698,41.9,47992,22377,2165,1533
59477,482,35.9,46591,15940,283,199
59479,893,48.6,38947,24039,427,466
59480,486,37.7,59191,33452,277,209
59482,758,43.3,53846,22491,372,386
59483,374,53.9,60125,29766,197,177
59484,162,55.4,77500,43135,74,88
59485,500,49.6,85000,34509,236,264
59486,1397,40,38068,19878,659,738
59487,1429,45.3,48190,22183,753,676
59489,275,52.7,34861,20072,147,128
59501,12529,35.9,43368,22377,6323,6206
59520,1231,41.4,37679,24004,607,624
59521,3945,24.7,35493,13105,1966,1979
59522,1784,49.2,43036,25407,809,975
59523,2216,46.6,45867,23101,1165,1051
59524,849,29,31776,15387,426,423
59525,237,40.9,40000,19786,103,134
59526,2496,29.5,32344,12453,1237,1259
59527,962,25.5,27750,10865,484,478
59528,192,49.8,50568,22762,109,83
59529,143,57.2,115938,70966,74,69
59530,129,56.1,51250,17747,57,72
59531,327,59,46750,31924,172,155
59532,187,50.1,46125,28952,92,95
59535,68,55.8,37500,26082,36,32
59537,160,47.8,127813,29958,76,84
59538,2841,48.6,40781,22796,1401,1440
59540,373,52.3,44375,24942,226,147
59542,262,34,33214,17982,136,126
59544,163,31.4,64250,29333,101,62
59545,35,53.8,38750,19431,23,12
59546,80,57.9,42917,19199,26,54
59547,29,64.8,72917,32924,16,13
59601,29420,42.6,52207,30609,14629,14791
59602,25076,40.2,63219,27496,12351,12725
59631,199,44.8,31250,18108,95,104
59632,2105,46.4,37426,20354,1068,1037
59633,213,51.6,66313,28209,107,106
59634,4785,46.3,93913,38788,2553,2232
59635,7467,34.6,61678,24079,3779,3688
59636,10,24.5,-666666666,17880,7,3
59638,829,42.3,66250,31721,404,425
59639,1005,55.6,35673,21721,495,510
59640,90,41.8,47361,50007,38,52
59642,24,59.5,24167,16742,9,15
59643,590,51.6,34453,22331,254,336
59644,3971,45.3,42010,22812,2124,1847
59645,1648,41.8,38017,19247,822,826
59647,417,36.1,61292,24086,161,256
59648,443,56.2,48333,25161,192,251
59701,33286,41.3,37847,23245,16914,16372
59703,69,56.5,98426,46287,32,37
59710,265,54.9,44659,38299,149,116
59711,9011,46.5,40205,23128,4699,4312
59713,216,49.5,37500,23249,110,106
59714,19101,32.3,53816,25537,9310,9791
59715,31684,31.1,47946,31349,16762,14922
59716,1990,33.2,65794,32029,1157,833
59718,27839,31.5,55651,28932,14476,13363
59720,260,59.7,46250,66956,164,96
59721,549,39.1,56576,26966,267,282
59722,5711,43.5,40685,18766,3666,2045
59724,136,51.1,39688,32998,72,64
59725,7833,41.2,42944,22341,3898,3935
59727,219,55.3,50000,33674,115,104
59728,403,49.2,51389,22647,216,187
59729,2153,51.1,53750,44349,1054,1099
59730,1873,46.3,48107,34548,1035,838
59731,130,55.6,36705,22431,76,54
59732,68,40.8,40625,24787,30,38
59733,217,55.3,24306,18580,104,113
59735,493,45.2,45568,20244,265,228
59736,143,56.1,42250,26901,78,65
59739,385,47.4,32500,18691,182,203
59740,211,39.8,41528,32226,121,90
59741,4365,41.6,57946,25973,2221,2144
59743,159,57.4,39293,27250,89,70
59745,126,53.1,38125,21667,63,63
59746,67,63.2,53750,38939,37,30
59747,215,56.3,48875,23681,90,125
59748,211,42.3,66354,27397,125,86
59749,1522,50.9,42256,26366,725,797
59750,304,55,60208,31440,159,145
59751,236,36.9,33750,16523,107,129
59752,3236,44,51176,25177,1649,1587
59754,832,49.4,44412,24716,398,434
59755,225,58.6,39219,25484,115,110
59756,343,41.4,-666666666,7416,271,72
59758,2084,41,47619,28499,1129,955
59759,3308,52.6,50641,27257,1712,1596
59760,348,38.7,39792,17036,185,163
59761,308,47.7,37500,24797,185,123
59762,334,57.7,42083,39506,188,146
59801,30890,29.4,34462,21874,15138,15752
59802,19292,33,37931,25060,10120,9172
59803,16856,35.6,61446,28965,8342,8514
59804,7978,43.5,50830,28427,3855,4123
59808,18594,35.2,54034,27677,9113,9481
59820,1241,47.2,45956,26394,661,580
59821,2294,40.6,32128,18636,1190,1104
59823,1323,49.2,47237,24592,697,626
59824,1718,36.9,40750,18543,931,787
59825,2335,43.8,47452,24502,1185,1150
59826,574,52.9,39896,31192,306,268
59827,400,48,16756,16295,251,149
59828,5425,46,42215,23926,2626,2799
59829,2319,49.3,39295,25047,1141,1178
59830,74,49.9,28750,17486,44,30
59831,611,31.1,22135,13142,314,297
59832,955,49.4,38409,21177,493,462
59833,5345,43.7,75714,29538,2742,2603
59834,2005,42.6,76488,29630,1183,822
59837,339,49.9,37813,26093,175,164
59840,12979,50.4,33707,23390,6656,6323
59841,817,19.5,38269,9386,387,430
59842,114,55.1,54545,34830,52,62
59843,359,50.1,28333,18827,202,157
59844,888,45.9,42500,16938,507,381
59845,1217,51.9,26014,17017,609,608
59846,1148,58.5,52891,26606,555,593
59847,5366,38.1,61328,27051,2771,2595
59848,157,47.1,28000,10806,82,75
59851,254,29.3,61957,40644,122,132
59853,956,43.1,38833,18290,452,504
59854,243,58.4,42250,28865,127,116
59855,957,31.8,23750,12631,488,469
59856,385,59,32946,15327,196,189
59858,1347,56.7,43958,26876,679,668
59859,3082,52.4,34290,20731,1630,1452
59860,10082,42.7,34871,22319,4833,5249
59863,66,60.9,21625,24348,20,46
59864,6839,37.3,38569,18659,3279,3560
59865,3170,35.5,40056,20940,1610,1560
59866,1085,50.9,32981,19000,503,582
59867,9,-666666666,-666666666,,0,9
59868,1675,54.3,39625,24106,893,782
59870,10463,45,39759,22089,5058,5405
59871,185,52,41458,21684,113,72
59872,2205,53.5,31837,19020,1169,1036
59873,3172,51.3,33377,19848,1519,1653
59874,974,56.3,35655,24257,505,469
59875,3679,43.5,37181,17650,1863,1816
59901,49962,39.2,44982,24019,24124,25838
59910,584,59.8,65221,26479,317,267
59911,7892,51.5,52850,30825,4137,3755
59912,13738,41.3,48849,22609,6925,6813
59913,513,47,39643,26091,227,286
59914,200,60.6,41250,27061,103,97
59915,509,41.9,40441,24871,217,292
59916,56,58,44250,27241,40,16
59917,4268,47.5,37178,20775,2013,2255
59918,720,51.7,40625,24826,386,334
59919,916,39.3,22500,14604,554,362
59920,1784,44.9,45795,27615,945,839
59922,2292,52.3,55707,50739,1179,1113
59923,9713,48.2,31781,22209,5017,4696
59925,1282,51.4,46607,24366,724,558
59926,452,35.8,42188,15751,264,188
59927,318,38.7,39922,14154,181,137
59928,82,52.4,41792,65963,41,41
59929,265,46.3,45625,37270,115,150
59930,736,54.8,36544,19323,319,417
59931,264,52.8,54750,31925,114,150
59932,1665,41.2,56364,27822,869,796
59933,66,51.5,22188,14539,41,25
59934,596,43.8,30197,19709,302,294
59935,3482,55.1,29981,21853,1822,1660
59936,519,36.8,55139,26792,276,243
59937,12567,44.1,46176,30142,6616,5951
60002,24250,41.2,78250,33622,12929,11321
60004,49957,41.8,79892,40134,24307,25650
60005,30931,39.8,69484,37387,15179,15752
60007,33973,43.5,67473,33540,16676,17297
60008,22302,36.2,59172,29141,10980,11322
60010,44031,46.3,120632,65973,21872,22159
60012,11081,43.6,109962,44826,5328,5753
60013,26811,39.4,97828,36375,13349,13462
60014,48234,37.4,81031,33683,23744,24490
60015,27218,42.3,128676,59603,13224,13994
60016,60794,39.4,59533,28824,29984,30810
60018,28749,39.9,54688,25289,14559,14190
60020,10391,39.1,59175,29156,5022,5369
60021,5560,38.3,81034,35473,2687,2873
60022,8327,42.8,162460,93256,4121,4206
60025,38667,44.1,83914,46444,18467,20200
60026,13869,45.3,90106,55357,6195,7674
60029,435,42.2,165000,49234,240,195
60030,35685,39.9,80909,36657,17824,17861
60031,38205,38,84548,36190,18479,19726
60033,13763,31.2,51114,20119,6870,6893
60034,1826,47.6,53942,32272,925,901
60035,29814,45.2,111549,65617,14555,15259
60040,5439,37.1,54612,28624,2618,2821
60041,8877,42.9,58816,28836,4542,4335
60042,8630,35.1,66808,26801,4061,4569
60043,2786,41.5,227250,97582,1366,1420
60044,9867,42.3,92861,57721,4647,5220
60045,20732,46.5,150406,85546,9841,10891
60046,34534,37.6,87107,34451,16994,17540
60047,42206,41.4,126999,51432,20703,21503
60048,29480,44.5,114284,56705,14206,15274
60050,32369,38.3,66723,29588,16426,15943
60051,24664,39.9,72693,31311,12133,12531
60053,23341,45.1,73102,32758,11269,12072
60056,55611,39.3,68710,33918,27664,27947
60060,37586,36.8,80069,34078,19020,18566
60061,26029,37.9,91443,42508,13021,13008
60062,40095,47.1,100520,53333,19625,20470
60064,16297,29.3,35293,13945,8072,8225
60067,38450,41.6,92212,48131,18883,19567
60068,37421,44.5,87119,44003,17892,19529
60069,8132,49.8,104196,60212,3945,4187
60070,15937,36.9,61188,31099,7987,7950
60071,3488,44.1,56075,34175,1821,1667
60072,976,40.5,80625,28364,473,503
60073,60237,31.2,64086,23835,30478,29759
60074,39053,33,62006,28455,19034,20019
60076,32922,43.9,69067,32273,15750,17172
60077,27189,42.7,58216,27807,12414,14775
60081,9939,42.8,83482,33893,5114,4825
60083,9909,41.3,90093,39852,4918,4991
60084,16304,36.8,74427,32846,8322,7982
60085,70997,30,41006,16888,35660,35337
60087,26679,33.1,56122,23950,13192,13487
60088,13274,21.2,59891,19059,10002,3272
60089,41645,42.6,94351,43828,20010,21635
60090,37744,37.1,58466,28163,18013,19731
60091,27268,43.8,129551,67089,13656,13612
60093,19010,44.3,163719,91958,9066,9944
60096,7001,43.2,73304,31314,3411,3590
60097,10758,36.5,64292,26145,5692,5066
60098,32549,38.7,60666,28676,15884,16665
60099,31593,33.4,54152,21849,15091,16502
60101,39657,33.9,55915,24741,19396,20261
60102,32166,39.6,99655,39151,15989,16177
60103,42209,37.1,93352,36684,21069,21140
60104,19061,35.7,50244,19925,8736,10325
60106,20276,34.7,57624,23616,10166,10110
60107,40677,34.5,73587,29485,20408,20269
60108,22975,42.6,72602,38285,11212,11763
60109,567,37.9,61125,30213,258,309
60110,38998,29.9,56654,21147,19894,19104
60111,376,44.8,71534,30034,180,196
60112,4674,28.3,70737,22040,2211,2463
60113,309,29.1,46250,23713,129,180
60115,46267,24.1,37922,19558,22655,23612
60118,15587,40.9,78091,36426,7801,7786
60119,10357,40.2,90833,39662,5391,4966
60120,51216,31.3,53543,20465,25513,25703
60123,48053,33.4,55012,23179,24148,23905
60124,19618,38.6,102059,39864,9674,9944
60126,46450,40.2,93308,43202,22851,23599
60129,184,44.9,73750,32883,97,87
60130,14202,39.1,51055,37602,6609,7593
60131,18068,38.1,54102,24078,8699,9369
60133,38369,32.8,68974,23217,18986,19383
60134,29339,40.7,103401,43649,14849,14490
60135,7174,34.7,61798,25585,3702,3472
60136,7093,32.5,105379,36321,3628,3465
60137,38384,41.1,89386,47759,18734,19650
60139,34867,32.9,63039,25006,17642,17225
60140,14050,34.8,78235,30495,6953,7097
60141,190,67,-666666666,23104,175,15
60142,26708,44.6,75572,35963,12933,13775
60143,10128,41,74598,35817,5093,5035
60144,64,28.5,103750,39764,34,30
60145,2408,38.5,86932,29535,1210,1198
60146,2585,39.8,57717,25765,1371,1214
60148,52390,40.6,70448,34217,25429,26961
60150,1589,36.5,52109,22251,796,793
60151,4235,41.7,68265,32465,2187,2048
60152,12899,40.1,63013,28446,6317,6582
60153,24152,36.9,42295,19420,11224,12928
60154,16804,47.5,68422,32066,7951,8853
60155,7931,43.2,51690,28726,4070,3861
60156,28886,35.2,85570,32765,14612,14274
60157,2116,46.4,79844,38902,1114,1002
60160,25459,30.5,45208,17193,13029,12430
60162,8110,40.1,53868,24201,3948,4162
60163,5218,39.5,62581,30131,2644,2574
60164,22116,34.9,56891,20809,11086,11030
60165,4947,28.7,38214,12997,2456,2491
60169,34103,34.5,68864,29468,16865,17238
60171,10300,37.3,46354,23335,4961,5339
60172,24588,38.3,76512,34244,11862,12726
60173,12143,30.9,66556,39254,6375,5768
60174,31340,41.6,76938,42715,15629,15711
60175,25836,40.8,125219,48046,13839,11997
60176,11790,35.7,41813,22153,6239,5551
60177,22705,34.9,85642,31147,11055,11650
60178,22299,36.9,64274,29495,10894,11405
60180,1293,49.8,57176,32219,654,639
60181,28933,36.7,69144,28565,14426,14507
60184,2536,47,171667,68968,1247,1289
60185,35974,33.2,69183,27750,18185,17789
60187,28660,35.3,84419,35878,14315,14345
60188,42399,36.9,76033,31530,20871,21528
60189,31344,41,93179,47717,14948,16396
60190,10561,43.6,95025,45706,5247,5314
60191,14358,41,61439,28061,7038,7320
60192,16522,41,115285,43764,7940,8582
60193,39883,42.1,72939,34560,19197,20686
60194,20322,37.5,73261,33871,9520,10802
60195,3810,30.9,62877,41965,2047,1763
60201,42682,31,65589,41825,20194,22488
60202,32255,38.1,68321,40568,15515,16740
60203,4749,39.8,113947,57806,2252,2497
60301,2229,44.7,61367,49586,1062,1167
60302,32218,39.1,77385,52201,15203,17015
60304,17455,37.7,85607,39506,8028,9427
60305,11183,41.4,113317,62034,5428,5755
60401,8012,44.2,64063,27732,3914,4098
60402,64039,33.4,53402,22106,30772,33267
60403,19634,37,46716,23084,10289,9345
60404,17984,38.6,86706,32126,8743,9241
60406,26021,32.6,40875,18000,13332,12689
60407,1945,35.4,56563,22179,1027,918
60408,5501,40.5,64292,25938,2856,2645
60409,37202,35.8,40359,20000,16940,20262
60410,12530,35.2,86325,29804,6339,6191
60411,58818,32.5,41537,18571,28155,30663
60415,14294,33.9,50336,22987,7498,6796
60416,9152,34.3,60103,26610,4464,4688
60417,15572,45.3,70383,31275,7625,7947
60419,22978,33.8,48012,20732,10558,12420
60420,6738,40.7,60658,20082,2471,4267
60421,3960,40.1,70485,30466,1965,1995
60422,9007,46.8,98140,49802,4036,4971
60423,30261,40.1,95667,38466,14650,15611
60424,2310,41.1,57417,27561,1205,1105
60425,9000,38.4,55139,24485,4432,4568
60426,28260,33.2,26080,13951,12938,15322
60428,12463,38.2,39739,17671,5743,6720
60429,16006,37.1,48487,22208,7440,8566
60430,21217,41,72754,32001,9942,11275
60431,21783,33.5,81037,30116,10357,11426
60432,21448,29.4,37624,15064,11229,10219
60433,17220,35.4,43644,18967,8804,8416
60435,49002,35.7,53691,24780,23168,25834
60436,18371,32.7,45592,19492,9091,9280
60437,157,49.8,36563,23715,75,82
60438,28815,40.6,50941,24985,13656,15159
60439,23177,41.7,92089,39570,11292,11885
60440,53836,32.4,71422,25176,26640,27196
60441,35532,34.8,72333,29886,18069,17463
60442,9684,35.4,76029,31032,5176,4508
60443,20800,40.6,64384,28468,9941,10859
60444,1842,37.6,72500,30321,970,872
60445,26171,39.2,58813,26795,13173,12998
60446,39871,31.4,68672,22612,19473,20398
60447,14094,33.2,81325,31177,6736,7358
60448,24678,40.6,95208,37630,12340,12338
60449,9174,38,74322,33022,4486,4688
60450,20689,40.6,62647,30484,10511,10178
60451,34516,36.9,91980,33897,16910,17606
60452,28096,37.2,71526,28543,13932,14164
60453,56820,41.3,57381,28489,26955,29865
60455,16343,38,52298,21117,8339,8004
60456,4356,38.5,49667,23066,1958,2398
60457,14367,36.4,54234,23909,7114,7253
60458,14111,32.5,50522,23033,6561,7550
60459,29107,36.4,56503,20995,14428,14679
60460,1425,38.5,55357,29760,733,692
60461,4706,51.9,86646,50137,2203,2503
60462,38801,45.6,77780,38763,18337,20464
60463,14337,52.7,76085,39971,6815,7522
60464,9707,54.2,76371,45227,4103,5604
60465,17567,44.9,55363,29656,8442,9125
60466,22667,35.8,48559,21761,10418,12249
60467,26880,44.9,88947,36488,12444,14436
60468,5847,41.5,75000,30813,3113,2734
60469,6017,30.2,48072,15367,3048,2969
60470,603,40.6,58333,23540,306,297
60471,13865,40,52284,27130,6259,7606
60472,5182,43.2,21542,13875,2772,2410
60473,22445,41.2,64362,26431,10912,11533
60474,685,38.5,55417,27375,341,344
60475,9797,36.6,43138,21262,5010,4787
60476,2837,39.9,50036,23048,1293,1544
60477,38144,38.6,69734,31541,18260,19884
60478,16856,39.5,60157,25724,7682,9174
60479,696,38.3,72232,26076,360,336
60480,5006,44.3,75203,37596,2426,2580
60481,11916,43.2,62487,28344,6059,5857
60482,11152,37,55269,24824,5419,5733
60484,6902,28.5,48571,20160,3120,3782
60487,26795,37.9,92588,34507,13432,13363
60490,19960,35.9,108477,34681,9932,10028
60491,22573,43.4,93986,36528,10939,11634
60501,11886,30,48438,16597,5995,5891
60502,23552,34.4,105319,48269,11219,12333
60503,16952,32.3,106823,35090,8683,8269
60504,37956,32,71624,30499,18698,19258
60505,71433,29,43868,15168,35864,35569
60506,56982,33.9,54401,23213,28190,28792
60510,28999,40.5,90864,39342,14054,14945
60511,1575,45.2,64602,33109,782,793
60512,1527,56.1,67135,36156,846,681
60513,18995,39.1,72653,31340,8804,10191
60514,10414,39.5,95162,55401,4820,5594
60515,28054,42.2,81383,45841,13331,14723
60516,28005,43.8,85227,39936,14072,13933
60517,32578,37.4,77001,37644,16479,16099
60518,3714,43.3,51674,23658,1847,1867
60519,0,-666666666,-666666666,-666666666,0,0
60520,2869,39.2,59323,29446,1500,1369
60521,17660,41.7,158947,77527,8741,8919
60523,9818,56.9,96591,70668,4669,5149
60525,31514,43.1,74573,41497,15012,16502
60526,13609,39.4,69198,38852,6591,7018
60527,28181,43.3,72950,52089,13241,14940
60530,605,43.2,59519,32451,315,290
60531,1818,43.5,63125,29450,898,920
60532,27008,37.4,72060,43428,13307,13701
60534,10626,36.9,50842,23006,5658,4968
60536,109,42.3,76875,36818,46,63
60537,690,33.4,63594,22895,386,304
60538,26202,32.6,71964,25625,13041,13161
60539,248,56.5,-666666666,5378,188,60
60540,43053,39.7,100612,45632,20964,22089
60541,3033,40.7,76875,31290,1455,1578
60542,16820,35.6,81383,33511,8108,8712
60543,37053,35.7,91461,31892,18793,18260
60544,25188,35.9,74603,30381,12337,12851
60545,13141,31.6,60897,29260,6608,6533
60546,15970,41.9,65663,37801,7690,8280
60548,12281,42.9,61058,27282,5979,6302
60549,982,32.2,61429,17763,573,409
60550,1528,32.9,50662,20561,766,762
60551,4779,39.9,75417,23790,2849,1930
60552,4521,39.2,72448,29528,2446,2075
60553,843,39.9,65288,24685,470,373
60554,11597,40.9,108109,45430,5888,5709
60555,13543,37.1,75988,36065,6740,6803
60556,1871,36.6,67039,27236,906,965
60557,0,-666666666,-666666666,-666666666,0,0
60558,13008,42.4,139257,59195,6452,6556
60559,24496,39,61540,33040,11391,13105
60560,22907,34.5,83634,34231,11678,11229
60561,23067,46.5,79274,40618,11157,11910
60563,36512,35,80629,42060,17654,18858
60564,41453,37.9,140442,48961,20848,20605
60565,40864,40.8,113581,45408,19895,20969
60585,22627,34.8,116713,36000,10999,11628
60586,46395,31.3,86417,28727,22994,23401
60601,9732,36.6,95556,89136,4843,4889
60602,1463,32.4,79957,66748,653,810
60603,882,26.1,107419,73239,364,518
60604,415,54,132188,135807,225,190
60605,24972,33.1,75426,58338,12039,12933
60606,2789,30.9,109324,83005,1565,1224
60607,25134,30.6,80261,50222,12160,12974
60608,78794,31.3,35336,16542,43861,34933
60609,62773,30.4,33630,14552,31374,31399
60610,38740,34.3,72636,71176,17669,21071
60611,29722,39.5,85642,107019,13703,16019
60612,36052,30.6,35318,21407,17325,18727
60613,49536,31.5,66697,55034,24808,24728
60614,68363,29.8,86215,67585,33637,34726
60615,40745,33.9,39055,32992,18721,22024
60616,49491,35.8,44258,28052,24006,25485
60617,83435,36.1,38845,18242,38290,45145
60618,97413,32.9,55577,31862,48941,48472
60619,64922,39.4,34977,19987,27990,36932
60620,73253,38.2,31753,16347,32169,41084
60621,33608,31.6,19548,11893,14620,18988
60622,54272,31.1,68923,43393,26902,27370
60623,85158,27.8,28949,11463,42223,42935
60624,39283,27.9,22786,11731,18384,20899
60625,78966,33.4,56597,29124,40531,38435
60626,51061,33,38734,24054,25579,25482
60628,71710,37.5,37472,17025,31635,40075
60629,113833,29.2,40650,14299,54974,58859
60630,57886,38.1,58086,26705,28517,29369
60631,28899,43.7,74007,35878,13969,14930
60632,90845,29.3,38545,13596,46337,44508
60633,13474,36.6,44417,20668,6705,6769
60634,72718,38.9,55767,24269,35914,36804
60636,39918,32.2,26352,11897,18854,21064
60637,48270,30.7,25775,19746,21262,27008
60638,56033,37.2,61903,25850,27208,28825
60639,91934,30.3,38707,14310,45428,46506
60640,64365,37.2,46974,35414,33857,30508
60641,70730,35.3,46816,23168,35618,35112
60642,18312,31.7,67591,45788,9518,8794
60643,51836,42.1,61799,28249,23621,28215
60644,47631,32.5,26092,13381,21654,25977
60645,46913,35,48918,25500,22546,24367
60646,28314,42.7,75419,40071,13453,14861
60647,87146,31.6,51675,30368,44219,42927
60649,45444,37.9,28573,20347,19944,25500
60651,61150,32.7,30971,14599,29466,31684
60652,42517,34.9,65330,23889,21049,21468
60653,31086,35.6,24968,22333,13439,17647
60654,15885,32.8,90645,101469,7634,8251
60655,28173,37.6,85531,35689,14172,14001
60656,27468,41.1,54134,29771,13740,13728
60657,68088,30.5,75885,63820,33716,34372
60659,39657,35.1,49581,21675,20308,19349
60660,42060,36.2,38970,30160,21238,20822
60661,7436,31,93750,76827,3604,3832
60706,23284,46,49325,24916,10904,12380
60707,42712,39.1,55554,26405,20720,21992
60712,12611,47.8,95440,42872,6252,6359
60714,30111,48.2,46725,26321,13958,16153
60803,22945,35.7,51186,23086,11049,11896
60804,84042,28.2,44177,14735,42625,41417
60805,19903,38.7,65393,29023,9533,10370
60827,28547,31,33108,16567,12729,15818
60901,36908,35.3,39915,19514,18598,18310
60910,382,49.1,41250,20476,182,200
60911,1604,37.5,60250,24503,897,707
60912,735,32.3,38625,19360,380,355
60913,1371,53.3,60625,32488,707,664
60914,28923,33.5,63264,25892,13922,15001
60915,10601,35.4,48302,25729,4927,5674
60917,607,33.3,72791,25341,312,295
60918,783,48.2,58295,28492,374,409
60919,605,36.7,39125,21468,332,273
60920,120,31.2,47143,21689,49,71
60921,1381,40.3,36111,19408,648,733
60922,2332,43.8,44087,21853,1087,1245
60924,1691,47.9,52353,33142,831,860
60926,29,70.2,16563,20352,8,21
60927,2384,35.3,61193,29434,1160,1224
60928,736,44.4,50398,25879,364,372
60929,818,30.3,52037,21956,388,430
60930,819,51,43013,23034,365,454
60931,590,36,50000,23796,253,337
60932,0,-666666666,-666666666,-666666666,0,0
60933,248,51.1,52708,24508,126,122
60934,276,36.7,47813,23947,156,120
60935,1397,35.3,75750,23545,731,666
60936,4125,45.3,38769,27992,1979,2146
60938,2109,40,45492,20488,943,1166
60940,3524,40.2,68176,26398,1824,1700
60941,1979,41.8,56771,31553,1067,912
60942,6094,42.8,40202,21747,2857,3237
60945,170,52,42250,23141,90,80
60946,384,41.6,56111,32852,187,197
60948,1553,47.1,68516,35013,764,789
60949,656,35,32303,18322,344,312
60950,11883,39.5,64669,27514,5761,6122
60951,725,42.2,70703,26575,370,355
65747,3608,62.1,40391,25655,1818,1790
65752,332,53.5,19679,16437,167,165
65753,4787,38.9,43578,20127,2373,2414
65754,1156,24.7,46831,19120,559,597
65755,435,33.7,25625,10093,242,193
65756,655,37.2,39063,13265,311,344
65757,6869,44.1,50342,26684,3433,3436
65759,1283,45,35819,18313,655,628
65760,634,59.2,31563,19265,340,294
65761,1120,56,35536,20166,635,485
65762,452,54,33438,17721,231,221
65764,1605,38.8,28079,11052,787,818
65766,134,42.8,51250,14016,71,63
65767,1834,49.4,26914,17379,950,884
65768,362,40,26094,18160,222,140
65769,3293,34.3,42500,18828,1546,1747
65770,2634,46.5,43077,22733,1285,1349
65771,2035,34.1,54615,20491,1111,924
65772,2239,40,46625,20649,1172,1067
65773,564,55.6,35800,19787,348,216
65774,996,51.7,31300,16190,454,542
65775,24256,40.2,34122,18714,11756,12500
65777,239,43,19667,13469,118,121
65778,489,51,24792,15867,237,252
65779,2381,50.8,33915,16139,1261,1120
65781,8386,35.8,48082,20805,4296,4090
65783,136,63.9,26302,10047,70,66
65784,0,-666666666,-666666666,-666666666,0,0
65785,5395,44.2,31134,15913,2722,2673
65786,2452,39.7,30284,14791,1278,1174
65787,1525,58.3,46667,23803,667,858
65788,405,43.5,34583,16847,207,198
65789,1696,41.9,38715,17564,890,806
65790,764,45,31141,16701,379,385
65791,4611,44.4,30063,17097,2340,2271
65793,6620,38.5,30250,16041,3362,3258
65802,43687,33.1,33354,19170,21220,22467
65803,42747,34.3,33756,17699,21146,21601
65804,36996,39.3,40744,28510,17921,19075
65806,9888,25.4,17253,12648,5154,4734
65807,55658,31.7,37009,20424,26217,29441
65809,11060,47.5,80406,45211,5120,5940
65810,21787,38.8,66418,34169,10463,11324
66002,13653,34.5,44521,21778,6570,7083
66006,7215,41.5,54091,28733,3531,3684
66007,6124,39.3,76579,32093,2967,3157
66008,262,42.8,75357,33316,128,134
66010,598,49.4,47083,28369,325,273
66012,10949,36.9,64242,29761,5236,5713
66013,1832,48.2,94375,41724,1066,766
66014,324,60.5,50757,25163,154,170
66015,859,47.5,48194,23858,465,394
66016,297,49,29659,16716,163,134
66017,388,42.9,50833,30014,204,184
66018,5698,39.2,60643,27463,2733,2965
66019,290,18.2,-666666666,5853,137,153
66020,1691,42.2,74609,28715,879,812
66021,2068,38.9,58125,24758,1045,1023
66023,1358,38.2,52115,22003,604,754
66024,905,35.1,44219,19836,475,430
66025,7743,35.3,69073,28618,3717,4026
66026,814,42.1,63462,28512,458,356
66027,5713,23.4,83636,22114,2961,2752
66030,21854,31.5,68602,26400,11116,10738
66031,456,31.7,-666666666,14335,444,12
66032,5225,39.3,38150,19892,2593,2632
66033,663,48.2,39583,23741,343,320
66035,1385,21.7,41786,16016,663,722
66039,646,50,50417,24925,320,326
66040,3228,38.8,47031,24243,1610,1618
66041,842,33.3,53667,23088,459,383
66042,552,45,61500,28315,279,273
66043,10990,33.9,81544,24615,6774,4216
66044,27547,24,31663,18972,13907,13640
66045,2427,19.4,-666666666,3192,938,1489
66046,19695,28.3,44049,21561,10385,9310
66047,19379,29.1,58033,31474,10098,9281
66048,35424,39,50972,25417,18834,16590
66049,26147,33,63486,35121,12462,13685
66050,1968,47.2,65956,30376,1005,963
66052,2021,42.8,57848,27076,1064,957
66053,7768,38.4,69051,31098,3943,3825
66054,3164,42.4,54167,25114,1638,1526
66056,1681,46.5,42609,22989,811,870
66058,398,42,51818,20186,227,171
66060,1066,42.4,51141,21789,588,478
66061,57167,34,70241,30770,29119,28048
66062,75938,33.6,82333,33452,37476,38462
66064,5936,36.4,41773,21320,2861,3075
66066,2440,40.4,54044,28026,1309,1131
66067,16537,37,47661,23156,8065,8472
66070,2816,41,66492,27531,1388,1428
66071,12284,43.1,57213,28405,5992,6292
66072,1203,38.9,45227,22800,631,572
66073,2242,43.2,60638,25600,1111,1131
66075,1840,49.9,35078,24025,848,992
66076,1759,41.2,44290,20386,958,801
66078,927,37,49167,18022,396,531
66079,477,46,61875,25592,240,237
66080,835,43.5,44107,21613,424,411
66083,9256,35.1,72098,31088,4834,4422
66085,7852,45.4,109363,53214,3964,3888
66086,9965,39,67622,28114,4964,5001
66087,1840,37.4,46855,22776,937,903
66088,2579,42.8,50667,25268,1284,1295
66090,2480,44.7,49552,26506,1248,1232
66091,158,55,33802,18294,102,56
66092,4289,36.3,63250,25927,2112,2177
66093,659,48.8,64432,33113,348,311
66094,538,34.8,33750,16755,288,250
66095,1260,52.1,46226,21817,674,586
66097,985,46,49091,26164,545,440
66101,13255,28,22753,10810,6671,6584
66102,29584,29.7,31204,13566,15327,14257
66103,13142,30.2,32099,19227,6791,6351
66104,24686,35.2,35180,17089,11441,13245
66105,2337,33.4,29833,12085,1128,1209
66106,24014,33.4,42586,18067,12037,11977
66109,22275,39.6,70914,30806,11132,11143
66111,10409,35.3,49124,20465,5072,5337
66112,11319,36.8,40801,21806,5129,6190
66115,0,-666666666,-666666666,-666666666,0,0
66118,0,-666666666,-666666666,-666666666,0,0
66202,16473,33.5,47958,29856,8000,8473
66203,19752,36.2,52977,26477,9984,9768
66204,18954,35,52761,28719,8894,10060
66205,13804,36.8,78648,48634,6478,7326
66206,9937,46.4,103533,53459,4733,5204
66207,13143,48.4,84710,50210,6062,7081
66208,21405,42,83860,52770,9858,11547
66209,19182,47.6,106054,67843,9118,10064
66210,18011,36.1,68127,39624,8848,9163
66211,4569,52.5,77813,110081,1944,2625
66212,33262,36.7,57929,30501,15857,17405
66213,28142,38.4,81139,40558,13600,14542
66214,11794,33.3,49045,31676,5354,6440
66215,25146,39.7,67351,34897,12134,13012
66216,25551,39,82825,35357,12314,13237
66217,4886,44.1,56884,44581,2220,2666
66218,7789,33.9,96300,34349,4024,3765
66219,10528,31.6,72711,38432,5140,5388
66220,7279,38.1,120071,45328,3569,3710
66221,15344,35.4,128525,54054,7756,7588
66223,21853,35.5,93657,44661,10779,11074
66224,11617,39,139569,62794,5880,5737
66226,12863,33.6,108333,36044,6308,6555
66227,4440,39.9,80550,37553,2049,2391
66401,1763,39.2,46597,23530,870,893
66402,2761,46.9,63800,33890,1374,1387
66403,811,40.9,47969,21723,417,394
66404,562,40.9,53500,27452,294,268
66406,473,50.3,46750,23039,205,268
66407,431,51.3,51591,29689,219,212
66408,571,37.8,53661,23744,276,295
66409,2988,49.6,76538,39968,1453,1535
66411,1309,39.4,35341,17829,533,776
66412,249,37.7,53125,26668,96,153
66413,1788,46.7,47500,24485,912,876
66414,2713,37.7,49167,23873,1414,1299
66415,984,34.7,44750,22977,516,468
66416,607,45,56250,23617,326,281
66417,214,34.8,47500,22008,106,108
66418,639,38.3,62206,21008,332,307
66419,343,34.8,31429,29125,159,184
66422,528,20.8,40250,12659,237,291
66423,922,43.1,52083,20789,489,433
66424,631,45.1,68047,27533,307,324
66425,385,53.8,43938,23451,185,200
66427,1155,53.3,44250,26693,583,572
66428,423,49.3,59250,29172,212,211
66429,689,43.1,52604,23267,313,376
66431,608,48.2,58021,25951,329,279
66432,373,50.5,56944,30840,190,183
66434,4810,43,39194,21488,2395,2415
66436,5629,41.8,50064,24400,2850,2779
66438,234,46.6,80875,60308,123,111
66439,2940,38.8,34113,19102,1353,1587
66440,2054,42.1,64256,25409,924,1130
66441,27346,28.2,46237,22281,13925,13421
66442,15037,21.3,38125,14323,8570,6467
66449,551,56.7,30909,22031,232,319
66451,1809,42.5,60536,26777,899,910
66501,255,37.3,48438,20189,129,126
66502,44791,24.9,38545,22908,23750,21041
66503,14737,34,70097,34787,7405,7332
66506,3779,19.3,7708,3375,1578,2201
66507,1237,31.8,67500,23114,638,599
66508,4347,41.3,44813,24699,2236,2111
66509,2906,37,56486,22263,1516,1390
66510,731,39.6,43813,21833,360,371
66512,3140,47.4,64648,26989,1643,1497
66514,1608,44,82644,36054,848,760
66515,521,33,52917,20231,250,271
66516,280,42.5,57679,23840,144,136
66517,1832,27.3,32837,17600,898,934
66518,202,34.1,70341,27847,103,99
66520,603,33.1,50417,23996,260,343
66521,1740,47.4,51750,25795,858,882
66522,30,69.3,26250,19953,17,13
66523,3656,44.2,44178,23989,1741,1915
66524,2929,42.6,61170,28363,1438,1491
66526,878,39.7,57772,22917,346,532
66527,272,36.4,42083,22021,139,133
66528,1226,44.1,40924,15152,631,595
66531,1262,32.8,58906,22332,607,655
66532,565,45.4,50167,24155,306,259
66533,1559,40.9,68235,26653,746,813
66534,3784,41.5,47284,23435,1838,1946
66535,2605,39.1,44875,22161,1269,1336
66536,4347,23.7,47898,17015,2107,2240
66537,1297,45.8,51186,22385,645,652
66538,3024,46.4,44528,25991,1578,1446
66539,2770,39,64315,34116,1423,1347
66540,490,53.8,53750,23615,273,217
66541,305,53.5,38393,23573,169,136
66542,3262,48.5,65375,34102,1581,1681
66543,910,41,58289,23412,468,442
66544,311,59.4,35750,30006,154,157
66546,1195,52.5,78092,39461,660,535
66547,7668,35.3,62397,27184,3940,3728
66548,830,49,45833,30385,440,390
66549,1675,38.8,57500,27694,816,859
66550,510,39,42153,27635,242,268
66552,457,46.8,51563,24836,242,215
66554,766,42.5,63250,29225,409,357
66603,1378,34.3,17430,12541,751,627
66604,21886,36.6,40550,24818,10589,11297
66605,20732,34.1,44562,20361,10091,10641
66606,11351,40.1,39951,26139,4904,6447
66607,11181,31.1,28009,12606,5265,5916
66608,5945,36.6,32571,15399,2968,2977
66609,7750,34.9,48571,23965,3697,4053
66610,9311,43.9,103270,45138,4569,4742
66611,9061,42.9,41364,28693,3964,5097
66612,2976,34.6,13496,10878,1678,1298
66614,31709,38.8,53673,30118,15362,16347
66615,3146,39.7,68651,33518,1372,1774
66616,5510,42.9,39961,19428,2762,2748
66617,8902,43.4,64518,27752,4475,4427
66618,9688,40.9,74653,29319,4987,4701
66619,2931,30.2,49129,18183,1471,1460
66621,513,20.3,-666666666,5933,190,323
66622,183,51.2,-666666666,2056,183,0
66701,12130,38.8,38608,19170,6016,6114
66710,887,36.9,42500,20946,492,395
66711,727,34.9,32976,20602,332,395
66712,1850,38.9,36169,17423,872,978
66713,6063,38.9,45118,17855,3043,3020
66714,151,52.8,48393,28030,90,61
66716,788,40.3,49375,17004,365,423
66717,600,41.1,39583,21357,313,287
66720,11316,38.3,40316,20849,5499,5817
66724,1062,39.1,35435,17212,579,483
66725,5672,43.7,40417,23126,2720,2952
66728,0,-666666666,-666666666,-666666666,0,0
66732,295,51.4,31641,16974,161,134
66733,2252,46.3,46902,21536,1176,1076
66734,223,42.4,46652,15134,118,105
66735,588,55.5,31000,19283,263,325
66736,3595,45.8,37396,20838,1752,1843
66738,387,42.2,35125,16542,191,196
66739,5242,39.3,38054,17158,2534,2708
66740,350,26.2,51389,14255,164,186
66741,151,50.4,41042,31216,84,67
66743,4137,39.7,48344,22762,2174,1963
66746,230,52.8,32500,17571,108,122
66748,2395,43.5,43750,22107,1128,1267
66749,7994,38.8,39719,19990,3911,4083
66751,951,39.3,32813,16858,443,508
66753,1082,42.4,51048,20165,505,577
66754,428,49.8,47353,21161,213,215
66755,1065,47.6,43929,25907,509,556
66756,968,43.5,32813,18224,469,499
66757,3429,41.9,37316,18406,1645,1784
66758,283,48.6,28750,13660,142,141
66760,29,-666666666,-666666666,,14,15
66761,356,45.5,19722,15754,237,119
66762,24796,28.4,35843,21538,12489,12307
66763,3365,38.2,40721,21404,1676,1689
66767,515,47.5,33929,58889,246,269
66769,404,37.8,40500,26071,226,178
66770,1134,43.7,49329,23074,635,499
66771,1165,44.7,48260,21486,539,626
66772,364,30.8,62679,17721,167,197
66773,922,39.4,38220,16616,449,473
66775,94,42.7,57833,27779,57,37
66776,1198,42.1,49500,20629,629,569
66777,726,49.9,40066,18509,352,374
66778,74,39.5,38750,22774,39,35
66779,780,32.1,52955,20114,359,421
66780,813,31.1,43826,20444,386,427
66781,1351,39.7,40324,18107,659,692
66782,267,33.5,31471,11561,134,133
66783,2053,48,36222,25624,971,1082
66801,28837,30.6,37665,19469,14028,14809
66830,177,52.2,43500,16394,76,101
66833,618,33,48281,18005,264,354
66834,947,40.8,45313,21033,507,440
66835,1208,43.7,44286,21273,604,604
66838,238,48.9,52946,25248,123,115
66839,3774,44.1,55125,30801,1865,1909
66840,750,45.8,36667,20853,368,382
66842,246,45.6,51250,22979,126,120
66843,90,68.6,20000,23559,64,26
66845,1431,44.1,37014,21068,699,732
66846,3172,50.5,44315,26625,1551,1621
66849,483,41.1,46058,21881,242,241
66850,130,62.3,60714,30659,69,61
66851,570,50,29010,17454,241,329
66852,563,50.1,40972,27130,282,281
66853,419,42.7,39688,31831,222,197
66854,781,41.1,43566,21720,391,390
66856,1670,44.1,57656,28666,841,829
66857,1126,37.5,50114,21981,581,545
66858,471,46.7,38250,20958,266,205
66859,201,47.2,31250,19457,109,92
66860,1416,37,41898,19455,672,744
66861,3072,46.4,44194,23330,1521,1551
66862,76,60.8,19922,19955,27,49
66863,79,44.4,44000,11047,44,35
66864,486,47.8,53000,24926,241,245
66865,1094,42.1,52813,23625,549,545
66866,1737,47.6,44018,21515,820,917
66868,692,35.3,46458,21788,381,311
66869,676,42.8,31771,19291,326,350
66870,115,61.6,30114,23016,62,53
66871,1311,46.9,51042,25476,633,678
66872,1367,42.1,58636,22317,636,731
66873,346,50.4,49095,22053,186,160
66901,6518,39.1,38351,19653,3082,3436
66930,255,42.5,58438,22613,112,143
66932,144,59,36932,27664,80,64
66933,246,58.8,28889,21514,126,120
66935,2247,51,37750,23429,1057,1190
66936,306,59.7,29375,19176,140,166
66937,755,46.2,36094,21282,383,372
66938,1017,47.5,41343,22424,511,506
66939,659,37.8,47656,23975,297,362
66940,370,54.4,48875,26183,212,158
66941,216,46.4,33958,21564,122,94
66942,286,35,43250,17150,154,132
66943,469,47.5,37321,24659,240,229
66944,172,52.6,42750,26375,85,87
66945,1042,41.9,41250,20491,536,506
66946,175,34.6,51250,20676,102,73
66948,575,44.5,39716,19717,293,282
66949,655,50.1,42353,24264,349,306
66951,857,46.6,42500,27248,442,415
66952,507,53.4,63162,29422,253,254
66953,698,49.8,43188,24788,347,351
66955,93,55.8,51250,25573,54,39
66956,1172,52.4,35486,21860,593,579
66958,249,47.5,39306,25375,126,123
66959,299,55.9,27604,18410,157,142
66960,167,50.3,37000,23331,93,74
66962,279,49.3,50625,27969,156,123
66963,116,49,50625,31434,53,63
66964,185,52.6,34922,33943,107,78
66966,589,54.8,44417,38010,312,277
66967,1960,48.7,43077,23198,947,1013
66968,1746,46.9,44167,21719,823,923
66970,180,54.8,68333,35730,91,89
67001,1922,23.7,83013,23266,980,942
67002,13834,35.2,80691,35232,6748,7086
67003,2720,45.7,32623,21868,1317,1403
67004,811,47.4,55250,24598,410,401
67005,16515,37.3,41012,20413,8000,8515
67008,516,38.4,44250,20937,246,270
67009,955,34.9,40341,24148,456,499
67010,13685,39.1,45675,23821,6304,7381
67012,20,-666666666,-666666666,,9,11
67013,2821,40.2,45101,22948,1351,1470
67016,503,38.5,58000,28553,267,236
67017,2213,43.6,61620,30330,1188,1025
67018,66,53,33125,20180,29,37
67019,910,43.7,38897,19537,461,449
67020,1602,37.5,55690,23353,819,783
67021,112,21,65893,16524,46,66
67022,1699,49.3,40573,25406,840,859
67023,176,47,42500,26379,102,74
67024,722,54,36429,19868,364,358
67025,3803,37.8,66364,29481,1936,1867
67026,4822,39.6,63333,31790,2482,2340
67028,245,37.3,42614,22855,134,111
67029,829,50.9,36944,23298,412,417
67030,2739,32.2,84931,29457,1418,1321
67031,2792,35.9,53315,20477,1325,1467
67035,1092,48.4,46111,28192,576,516
67036,97,58.4,39896,27644,54,43
67037,27430,36.7,66207,30012,14103,13327
67038,763,42.8,50000,20979,364,399
67039,3737,39.9,56094,25426,1860,1877
67041,239,38.8,81250,29101,122,117
67042,17831,34.4,48590,21465,9555,8276
67045,3612,47.4,38506,22049,1737,1875
67047,754,52.1,39500,20428,389,365
67049,30,81.3,43500,27247,19,11
67050,1879,40.1,70357,29745,869,1010
67051,448,43,40000,22747,215,233
67052,8097,33.7,67219,29025,4043,4054
67053,587,39.1,41591,19225,287,300
67054,1284,43,44412,26049,661,623
67055,170,49.2,6563,5796,17,153
67056,3242,38.7,53870,23774,1596,1646
67057,253,52.4,40625,20979,124,129
67058,2055,44.3,45234,22184,1083,972
67059,989,34.1,41838,20120,454,535
67060,13988,36.2,51087,22829,6429,7559
67061,164,33.5,34896,20929,101,63
67062,4169,36.4,64167,24351,2074,2095
67063,3853,41.3,52433,23863,1924,1929
67065,214,52,56250,21492,113,101
67066,335,40.6,75625,29159,197,138
67067,1824,41,79313,33611,879,945
67068,4280,43.5,45046,22974,2107,2173
67070,1252,47,45926,28473,630,622
67071,104,48.9,48125,24463,53,51
67072,217,53.8,44318,26974,110,107
67073,293,34.6,52656,23278,149,144
67074,2001,41.9,67586,27342,1067,934
67101,3610,27.7,57245,22711,1856,1754
67103,373,29.4,67500,27207,198,175
67104,2459,45.9,45919,26310,1246,1213
67105,281,34.7,29583,15157,138,143
67106,137,56,57446,51435,50,87
67107,2787,49.7,42317,23018,1324,1463
67108,1494,43.3,53594,23646,747,747
67109,362,40.5,48906,22713,182,180
67110,7843,41.4,67302,31189,4201,3642
67111,219,54.6,41125,22322,143,76
67112,286,46.4,40000,23173,176,110
67114,21695,39.7,47973,23718,10412,11283
67117,1822,46.5,54531,25134,812,1010
67118,781,38.8,60563,23626,384,397
67119,1620,46.1,64635,25342,727,893
67120,1564,40.2,58281,28774,794,770
67122,97,59.5,51563,42636,60,37
67123,790,41.8,51477,32197,448,342
67124,8507,39,46090,26514,4283,4224
67127,914,39.3,37500,18699,433,481
67131,155,50.3,61094,29357,83,72
67132,418,31.5,60398,18633,197,221
67133,6389,40.3,72271,32064,3117,3272
67134,314,36.5,39306,24363,131,183
67135,3770,34.5,62661,25829,1738,2032
67137,586,54.3,31250,20182,298,288
67138,279,41.6,50625,23904,135,144
67140,592,45.8,47303,27020,301,291
67142,475,45.7,43750,23556,240,235
67143,53,52.6,29886,26083,26,27
67144,2828,34.5,60921,33593,1473,1355
67146,2017,42.8,48929,22958,984,1033
67147,9138,36.1,62733,28336,4505,4633
67149,1018,47.8,60500,29469,487,531
67150,25,74.5,14250,20036,11,14
67151,596,36,51847,20867,242,354
67152,9322,38.5,45543,22333,4727,4595
67154,1334,47.9,56310,28620,756,578
67155,162,40.9,55938,22698,88,74
67156,15100,37.9,42196,22506,7765,7335
67159,93,59.8,35556,22100,59,34
67202,1358,32.8,43409,28441,962,396
67203,31039,34.3,38793,20809,15285,15754
67204,20440,39.4,43582,23324,10282,10158
67205,16954,37.2,100550,36580,8728,8226
67206,16534,43,64747,45048,7951,8583
67207,27993,30.9,45938,23450,14017,13976
67208,19012,30.2,42801,22841,9339,9673
67209,14022,37.6,61469,27478,6721,7301
67210,10111,26.2,35181,16397,5312,4799
67211,21303,32.1,30979,16044,10693,10610
67212,44221,37.3,57248,28761,21376,22845
67213,22516,32,29989,15086,10496,12020
67214,16115,30.1,22588,12717,7853,8262
67215,5737,33.7,75156,28473,2710,3027
67216,23996,31.3,32334,16262,11931,12065
67217,27996,34.2,39556,20046,14243,13753
67218,22482,32.8,37512,21479,11011,11471
67219,11594,31.9,48842,19161,5584,6010
67220,14533,32.4,54791,26093,7161,7372
67223,718,46.4,84018,49393,340,378
67226,18002,37,70311,37675,8694,9308
67227,160,64.3,67344,32049,60,100
67228,1739,34,123750,46387,929,810
67230,10428,40.2,122827,49016,5182,5246
67232,269,23.9,54073,51008,131,138
67235,11660,34.7,97031,35568,5769,5891
67260,0,-666666666,-666666666,-666666666,0,0
67301,13651,36.4,42339,22835,6812,6839
67330,1622,39.1,46964,22931,801,821
67332,138,50,33750,22592,86,52
67333,3177,40.7,40885,19045,1335,1842
67334,72,51.5,25000,16590,29,43
67335,3306,43.3,40744,21330,1774,1532
67336,1894,44.8,27875,18173,887,1007
67337,12770,40.6,35919,20206,6158,6612
60952,716,39,43750,18518,335,381
60953,2372,47,51989,31190,1158,1214
60954,6260,45,50429,26347,2940,3320
60955,1833,39.2,45658,21867,988,845
60957,5515,43.6,51429,25694,2791,2724
60958,2107,45.3,22384,12872,951,1156
60959,1073,45.4,43352,22264,572,501
60960,1089,37.1,49583,18429,617,472
60961,772,45.4,54063,23803,385,387
60962,595,41.3,43125,25722,295,300
60963,1818,38.5,45741,24500,899,919
60964,5232,42.8,53975,24696,2558,2674
60966,1558,42.3,40250,22178,851,707
60968,330,53,58393,33052,170,160
60969,59,30.1,81250,28741,32,27
60970,7173,46.1,38352,21926,3325,3848
60973,486,40.2,42794,17877,251,235
60974,330,42.3,38250,18695,197,133
61001,1250,54.5,51250,25529,669,581
61006,1794,49.2,54213,29275,936,858
61007,649,49.4,61250,32554,301,348
61008,34683,36.6,57806,25190,17353,17330
61010,8278,38.3,71632,29572,3976,4302
61011,2139,50.7,87750,46427,1080,1059
61012,2461,37.4,59667,20871,1284,1177
61013,488,50.2,55000,27283,245,243
61014,1171,48.1,55250,28691,560,611
61015,670,50.4,56042,25802,363,307
61016,4681,44.9,70571,33679,2442,2239
61018,1221,37,52813,28515,627,594
61019,3354,53.2,58165,27311,1601,1753
61020,3301,35.1,66111,21971,1715,1586
61021,23171,41.5,49105,26026,12340,10831
61024,2456,42.8,68125,28506,1210,1246
61025,4821,41.6,56960,26651,2487,2334
61027,0,-666666666,-666666666,-666666666,0,0
61028,2027,44.5,48864,27896,1017,1010
61030,2420,40,49043,21573,1258,1162
61031,1738,38.1,49667,24417,837,901
61032,31576,43.3,39547,22212,14991,16585
61036,6747,53.5,55491,36600,3238,3509
61037,324,42.4,95278,22042,127,197
61038,1083,48.1,53167,26233,570,513
61039,1035,37.4,58173,21670,558,477
61041,1304,52.2,47188,35183,709,595
61042,483,38.5,50972,24065,265,218
61043,86,43.9,56667,24653,61,25
61044,169,45.9,67054,32274,65,104
61046,2823,51,52944,29434,1391,1432
61047,1537,47.9,52222,27049,769,768
61048,4136,46.1,47955,25371,1913,2223
61049,522,44.6,60313,26004,295,227
61050,288,39.1,31875,17824,144,144
61051,1548,42.3,51058,24498,741,807
61052,1021,41.1,58355,28439,541,480
61053,3140,44.3,47143,30665,1548,1592
61054,4041,45.4,36816,23901,1694,2347
61057,146,56.1,72639,27495,80,66
61059,168,30,19408,13305,62,106
61060,1510,37.7,55000,23460,761,749
61061,6777,50,50494,30678,3388,3389
61062,1964,40.7,60000,26087,1055,909
61063,4260,39.1,56216,25443,2029,2231
61064,3659,42.9,51576,26792,1869,1790
61065,10984,35.6,57312,23901,5282,5702
61067,645,49.6,40726,37925,317,328
61068,14998,36.6,47912,22559,7603,7395
61070,1269,48.5,52607,23513,676,593
61071,14476,41.9,39823,21352,7335,7141
61072,11475,41.2,74668,30543,5749,5726
61073,19704,40.9,78285,32546,9701,10003
61074,4245,45.1,39115,23268,2168,2077
61075,981,44.9,55488,24657,513,468
61077,79,26.7,62838,40487,67,12
61078,1294,45.9,54097,28965,642,652
61079,117,50.1,40625,16456,73,44
61080,11032,36.4,55172,24166,5176,5856
61081,21711,41.3,46846,24839,10448,11263
61084,2794,33.9,77308,31097,1303,1491
61085,3365,44.6,40199,26082,1675,1690
61087,1665,45.4,45809,23720,887,778
61088,6045,38.3,73426,30421,3009,3036
61089,798,48.5,57037,25609,422,376
61091,93,53.7,67644,29433,40,53
61101,22680,32.5,30103,15209,11180,11500
61102,19691,34.2,32441,16082,9916,9775
61103,24378,38.7,35869,22118,12145,12233
61104,18345,30.3,23088,11979,8659,9686
61107,30695,43.1,57140,33025,14559,16136
61108,29642,39.4,46718,23821,14631,15011
61109,27845,37.2,41887,20271,13752,14093
61111,24034,37.7,50360,26203,11645,12389
61112,106,89.4,24200,73056,52,54
61114,14358,49.4,66303,39408,6523,7835
61115,23178,39.9,53094,23497,11503,11675
61201,39082,36.6,41547,23227,18459,20623
61230,1336,39.6,55847,26821,679,657
61231,5199,45.5,44306,25945,2502,2697
61232,1528,42.4,72604,29757,795,733
61234,1396,39.4,58429,28736,689,707
61235,1432,46.1,45441,26697,733,699
61236,70,41.3,31667,17900,33,37
61238,2927,40.9,56520,28113,1432,1495
61239,1247,28.9,28934,16056,656,591
61240,6160,45.2,71894,35791,3100,3060
61241,6806,38.8,55017,24837,3362,3444
61242,1047,50,64625,34872,565,482
61243,223,54.1,52500,34630,100,123
61244,24085,39,43741,23410,11969,12116
61250,2635,39.2,57875,25991,1273,1362
61251,324,51.9,58125,27877,170,154
61252,5329,43.3,53586,27928,2727,2602
61254,11374,43,69280,32218,5427,5947
61256,2146,43.6,66734,31391,1205,941
61257,1154,45.7,49643,26107,575,579
61258,371,32.1,46705,15087,176,195
61259,1109,46.6,64489,31614,591,518
61260,949,37,62025,26643,470,479
61261,925,43.3,54250,24880,473,452
61262,1388,48.4,70313,33478,640,748
61263,698,38,54732,22279,317,381
61264,10450,47,48977,27378,5208,5242
61265,44887,38.9,50092,27771,22166,22721
61270,7159,45.2,54206,27990,3580,3579
61272,1459,49,51750,24858,681,778
61273,3347,43.7,68190,30895,1685,1662
61274,282,48.1,85417,41673,157,125
61275,4406,43.3,80488,35883,2313,2093
61276,84,68.1,33229,33602,45,39
61277,3141,47.4,49427,25442,1492,1649
61278,297,44.6,91250,40938,141,156
61279,1074,38.7,52917,23791,558,516
61281,2602,44.1,70815,30103,1289,1313
61282,7694,40.4,42326,23985,3497,4197
61283,1763,30.4,42404,19171,847,916
61284,2338,52.4,83125,45649,1217,1121
61285,1605,43.5,45109,25261,857,748
61301,10565,38.8,48922,25356,5518,5047
61310,3970,46,44962,22873,1903,2067
61311,134,62.6,55000,60158,55,79
61312,548,40.4,55625,26820,249,299
61313,130,52.3,49107,28943,81,49
61314,952,39.4,52083,22913,410,542
61315,301,43.8,44107,23070,158,143
61316,264,33.2,54167,24340,122,142
61317,423,45.5,57625,29590,204,219
61318,655,37,57396,32511,346,309
61319,1104,40.6,61897,25093,528,576
61320,714,42.5,60156,24450,340,374
61321,285,48.6,70104,26814,171,114
61322,1744,32.6,38833,15922,993,751
61323,94,50.8,30313,13654,30,64
61324,60,51.6,-666666666,29703,32,28
61325,1008,38.4,63125,35112,517,491
61326,2295,41.7,44744,24522,1122,1173
61327,1265,49.8,62054,33339,690,575
61328,13,-666666666,-666666666,,6,7
61329,1428,40.7,50938,23472,632,796
61330,1387,42.6,56161,26642,676,711
61331,0,-666666666,-666666666,-666666666,0,0
61332,83,44.4,43906,25681,43,40
61333,256,45.4,50417,27382,119,137
61334,637,33.5,54750,26321,303,334
61335,453,52.6,78750,33384,236,217
61336,862,30.9,44130,18192,451,411
61337,590,31.5,36932,18455,283,307
61338,298,34.5,28594,14381,150,148
61340,355,41.5,56250,23228,173,182
61341,7645,43,49519,25012,3791,3854
61342,9255,37.4,51314,23802,4400,4855
61344,322,41.3,41042,29334,172,150
61345,753,50.4,48393,36727,351,402
61346,72,46,42500,20049,42,30
61348,4592,40.8,57361,24424,2261,2331
61349,862,45.1,54318,31124,425,437
61350,24105,43,51685,27818,12171,11934
61353,1374,41.5,56719,25900,675,699
61354,10878,45.6,51352,31375,5313,5565
61356,10900,47.1,47774,29312,5171,5729
61358,386,50.1,52639,27345,233,153
61359,290,42.8,57639,25103,140,150
61360,3749,37.2,63346,25982,2105,1644
61361,1366,46.1,46172,24043,668,698
61362,5604,40.8,48558,24048,2675,2929
61363,250,36.7,45250,26056,108,142
61364,20396,39.4,43910,22421,9634,10762
61367,770,43.6,51736,32498,378,392
61368,1432,53,59200,27902,734,698
61369,1531,47.1,43917,26658,728,803
61370,1422,41.1,55069,24909,751,671
61372,121,33.1,43500,23889,65,56
61373,1872,49.7,63393,30693,934,938
61374,121,42.8,37917,18842,49,72
61375,1065,55.9,52692,27377,525,540
61376,2575,39.8,65051,25165,1307,1268
61377,1664,40.5,43393,23200,773,891
61378,562,38,60114,22169,305,257
61379,1307,43.1,37188,17808,681,626
61401,34631,40.3,34779,20730,17375,17256
61410,3647,43.7,44385,23537,1726,1921
61411,311,61.2,45179,20047,156,155
61412,1281,44.3,47500,24315,592,689
61413,868,53.6,50461,29094,416,452
61414,656,43.3,40250,20582,339,317
61415,1555,50.1,52137,26984,792,763
61416,222,32.4,26705,11851,98,124
61417,210,64.9,31750,20303,101,109
61418,638,50.4,57440,31061,316,322
61419,127,54.8,64375,38181,60,67
61420,1074,51.8,46583,25248,536,538
61421,1456,36.7,48125,22389,743,713
61422,3310,41.4,34656,19095,1718,1592
61423,691,46.9,50906,25243,332,359
61424,94,44.2,54306,30385,55,39
61425,229,55.7,103833,42168,136,93
61426,115,57.5,59545,23881,57,58
61427,2479,47.1,50216,25882,1207,1272
61428,846,52.2,63788,36199,476,370
61430,807,42.5,51333,25695,419,388
61431,476,40.5,51250,19266,226,250
61432,638,37,54511,25113,302,336
61433,0,-666666666,-666666666,-666666666,0,0
61434,3226,48.2,40860,25222,1653,1573
61435,146,52.1,58313,23931,73,73
61436,1131,45.8,53813,28738,588,543
61437,900,47.4,55144,28458,454,446
61438,840,46.7,71875,34614,412,428
61439,282,47.3,50625,21745,136,146
61440,752,40.2,47813,21135,336,416
61441,1014,48,51146,28529,526,488
61442,659,48.7,34167,25012,328,331
61443,14037,38.2,40586,21787,7143,6894
61447,895,44,42011,23461,445,450
61448,3925,45.2,49776,23930,1945,1980
61449,590,47,30833,16799,330,260
61450,1751,46.9,39881,23797,894,857
61451,534,37,72386,41451,272,262
61452,392,46.6,49500,20873,219,173
61453,606,40.7,47798,24615,285,321
61454,490,52.1,46000,23489,236,254
61455,22084,24.2,31448,19265,10996,11088
61458,991,41.6,70517,26668,510,481
61459,428,48,42574,24945,188,240
61460,272,62,63125,34125,127,145
61462,11757,34.8,37487,19750,5907,5850
61465,1239,45,57434,27210,659,580
61466,356,50.9,70096,36297,203,153
61467,1085,41.2,58625,25199,568,517
61468,147,51.2,52841,25238,54,93
61469,2405,45.2,38684,25035,1234,1171
61470,633,37.7,39423,15870,300,333
61471,115,52.3,52500,25566,65,50
61472,711,44,60658,26244,357,354
61473,1649,50.3,44583,27919,745,904
61474,148,54.4,41071,21536,71,77
61475,320,35.7,68566,19138,142,178
61476,668,39,55365,20211,355,313
61477,671,49.9,39531,23298,295,376
61478,196,44.3,54167,27623,79,117
61479,182,30.7,72188,21797,115,67
61480,1506,44.6,41979,22155,656,850
61482,589,35.8,38487,19898,286,303
61483,1854,47.9,57731,29193,907,947
61484,982,38.9,37614,22450,514,468
61485,533,48.7,60833,30339,298,235
61486,1550,45.3,46250,26444,775,775
61488,1124,42.2,41250,23607,568,556
61489,957,44.7,47885,22961,486,471
61490,1366,37.5,59875,25404,715,651
61491,2247,43.5,55577,28652,1080,1167
61501,1956,39.4,38631,20525,1014,942
61516,684,43.9,60357,29100,370,314
61517,3154,43,75441,35638,1667,1487
61519,172,43.5,29375,18498,84,88
61520,17635,40.5,44542,21387,9483,8152
61523,11386,41.7,57399,26869,5693,5693
61524,176,37.7,47125,21221,90,86
61525,9146,35.7,103344,40473,4518,4628
61526,1047,43.6,99722,35133,484,563
61528,2409,42.4,79423,36611,1058,1351
61529,2934,39.2,65547,29902,1457,1477
61530,6500,38.7,56010,25245,3094,3406
61531,3360,38.7,50766,21737,1688,1672
61532,552,37.1,38333,19767,293,259
61533,2302,42.1,55208,26785,1100,1202
61534,1757,42.4,57321,24977,937,820
61535,1453,47.1,91452,38921,694,759
61536,2763,45.3,60758,29923,1313,1450
61537,2871,46.1,46893,25666,1329,1542
61539,200,44.8,41875,22555,95,105
61540,2843,46,57315,26656,1421,1422
61541,128,42.5,46591,23199,60,68
61542,3791,48.1,44325,24477,1933,1858
61543,126,41.2,28750,16770,65,61
61544,733,42.4,45833,20699,394,339
61545,870,38,58594,26386,381,489
61546,4554,42.7,59714,26510,2327,2227
61547,4267,38.6,82868,32037,2025,2242
61548,12257,40,83294,34748,6163,6094
61550,17777,41.2,70745,34605,9017,8760
61552,241,36.1,41042,15918,113,128
61553,231,38.5,34821,21606,126,105
61554,43781,39.9,48104,24466,21591,22190
61559,3308,41.2,56652,28026,1587,1721
61560,504,65.8,68889,34589,236,268
61561,2786,42.9,57473,30386,1547,1239
61562,62,48.4,-666666666,41102,41,21
61563,450,46,40250,22867,244,206
61564,1191,34.6,51667,20665,609,582
61565,1710,44.6,56750,26458,888,822
61567,478,54.7,40889,23037,267,211
61568,4514,40.6,66693,30134,2275,2239
61569,852,53,55476,35673,428,424
61570,1788,40.6,57303,26457,954,834
61571,24053,39.4,65747,30564,11598,12455
61572,1255,40.8,49423,19819,665,590
61602,1008,50.2,25875,38359,668,340
61603,16557,29.6,34422,17095,7586,8971
61604,31427,36.8,40630,21137,14868,16559
61605,15794,29.6,19442,11979,7260,8534
61606,7989,21.9,35904,17917,4090,3899
61607,11212,42.4,58366,29017,5865,5347
61610,5498,40.1,39827,21762,2592,2906
61611,25203,40.9,54765,28094,12397,12806
61614,28401,42.4,59920,38530,13663,14738
61615,23716,36.2,67246,40518,11654,12062
61616,6080,40.7,43486,30884,2987,3093
61625,570,19.8,-666666666,3969,248,322
61701,36129,32.9,42307,25949,17453,18676
61704,35677,35.3,86530,40330,17980,17697
61705,13044,37.1,95141,39265,6083,6961
61720,157,42.2,43750,16030,62,95
61721,613,33.9,58750,25705,332,281
61722,610,42.5,60227,26170,276,334
61723,1693,49.6,51776,28079,773,920
61724,450,38.5,59792,25232,191,259
61725,1514,37.6,68889,33799,759,755
61726,2597,40.6,53469,25331,1243,1354
61727,10268,41.1,50697,26549,5102,5166
61728,1418,41.9,63424,28841,759,659
61729,991,41.8,64333,37332,489,502
61730,378,46.1,57500,33920,215,163
61731,208,36,63047,20861,93,115
61732,2012,44.5,72386,42960,1101,911
61733,979,42,67014,41249,516,463
61734,2753,42.2,59070,28352,1301,1452
61735,576,48.3,40474,36943,273,303
61736,1676,37.6,78500,40408,801,875
61737,654,36.3,55000,29916,270,384
61738,4448,35,63200,29123,2126,2322
61739,5001,38.2,55648,28481,2452,2549
61740,1664,46.2,57847,28403,757,907
61741,1608,36.8,56071,26669,748,860
61742,1431,34.7,72727,29409,669,762
61743,219,46.5,62045,32117,106,113
61744,1827,40.7,63846,27221,906,921
61745,4340,38.2,80840,33127,2213,2127
61747,1511,47,53886,26769,721,790
61748,2692,46.8,78902,38796,1373,1319
61749,636,48.4,51333,24657,343,293
61750,59,67.2,30263,15602,25,34
61751,115,59.3,44000,20803,40,75
61752,4353,41.3,59974,27221,2171,2182
61753,3115,39.9,65585,29715,1535,1580
61754,1300,40,63309,38113,555,745
61755,4724,40.3,66623,32658,2348,2376
61756,2261,40.7,56140,25997,1117,1144
61759,1653,38.5,52734,28193,762,891
61760,2380,44.2,46023,25899,1126,1254
61761,53926,23.7,54027,24429,25700,28226
61764,14464,41.3,50460,23886,8210,6254
61769,541,47.5,64750,28448,291,250
61770,1127,41.5,54505,26309,538,589
61771,1120,30.5,54635,19311,573,547
61772,338,56.4,60859,26869,195,143
61773,553,37.2,63529,25862,262,291
61774,989,31.9,65789,20788,504,485
61775,338,44.2,57813,27133,182,156
61776,1716,41.1,77679,31237,845,871
61777,800,40,65938,30084,414,386
61778,688,51.9,61500,27701,360,328
61801,31196,22.8,25647,17327,15789,15407
61802,18944,37.7,43767,27678,8926,10018
61810,185,49,60556,30371,88,97
61811,664,43.3,52500,19544,387,277
61812,426,42.5,56250,27295,221,205
61813,2025,39.9,51944,27613,983,1042
61814,1268,39.2,67155,26374,656,612
61815,262,40,35500,19290,93,169
61816,465,40.6,71000,33889,236,229
61817,2912,33.1,62440,25674,1472,1440
61818,1544,39.4,55685,21531,714,830
61820,35792,21.9,22470,14431,19456,16336
61821,30631,34.8,52152,29091,14776,15855
61822,23086,36.5,77005,40492,11373,11713
61830,637,35.8,69659,24060,357,280
61831,109,52.6,68438,35532,60,49
61832,37343,37.5,34678,19426,17966,19377
61833,2153,47.1,48969,21662,1020,1133
61834,7774,43.4,48887,21626,4189,3585
61839,666,42.5,42837,21412,345,321
61840,778,46.7,71087,33365,425,353
61841,1316,45.9,55417,25581,624,692
61842,2843,44.6,51758,24282,1456,1387
61843,2318,38.6,57885,27073,1120,1198
61844,954,40.4,65536,26172,466,488
61845,403,41.4,69667,23791,178,225
61846,5057,42.5,37316,19706,2725,2332
61847,1268,41.6,62500,27662,629,639
61848,237,29.9,47000,15735,122,115
61849,1689,42.4,60083,34628,784,905
61850,582,38.8,70139,27478,330,252
61851,314,47.8,48929,27894,148,166
61852,283,54.3,41250,27616,153,130
61853,13142,40.4,73295,35474,6386,6756
61854,1689,45.1,56453,26092,870,819
61855,241,34.5,76442,22044,107,134
61856,7159,43.7,73805,38120,3534,3625
61857,108,49,35833,20713,57,51
61858,2965,41.1,53581,24808,1470,1495
61859,1263,39,75139,31482,636,627
61862,468,46.5,67969,33031,239,229
61863,662,57.3,59000,34806,305,357
61864,1912,36.1,71492,32289,988,924
61865,1441,38.9,52417,24096,777,664
61866,14113,33.3,38704,19943,7152,6961
61870,1495,38.5,51333,22495,692,803
61871,257,46.5,60000,34837,125,132
61872,918,48.1,68750,23857,496,422
61873,6244,36.3,73539,29741,2865,3379
61874,7050,32.9,58085,31081,3206,3844
61875,713,37.5,51944,29026,348,365
61876,1014,35.2,46193,18659,441,573
61877,2016,34.6,61383,27366,933,1083
61878,1356,40.6,55875,28592,673,683
61880,4420,35.2,65735,29485,2311,2109
61882,662,40.5,56094,30487,329,333
61883,4413,43.6,39075,22670,2267,2146
61884,1163,48.1,85260,31348,640,523
61910,4366,34.1,49613,22981,2066,2300
61911,5292,27.9,49000,18589,2792,2500
61912,1324,43.9,46458,24895,618,706
61913,1479,46.3,56000,26463,692,787
61914,1725,40.8,38972,23491,808,917
61917,604,38.3,46576,22880,339,265
61919,1046,39.9,57500,25808,533,513
61920,26109,24.6,31386,19790,12820,13289
61924,2538,40.7,45625,26144,1281,1257
61925,866,38.5,79219,29053,436,430
61928,1159,49.2,72933,28216,625,534
61929,652,45.7,47891,23964,322,330
61930,462,41.2,48036,21556,241,221
61931,1231,36.7,46438,21668,663,568
61932,467,41.5,33846,24428,228,239
61933,1119,48,39167,20290,531,588
61936,137,39.6,79125,33480,66,71
61937,1998,46,49813,28166,975,1023
61938,21927,39.3,38639,24286,10082,11845
61940,264,41.1,34875,17984,121,143
61941,37,66.8,54063,27600,17,20
61942,1279,38.7,51806,21327,622,657
61943,1342,51.2,42500,23026,642,700
61944,12399,44.1,41927,23691,5913,6486
61949,195,47.5,45750,20490,96,99
61951,8048,43,43958,23499,3860,4188
61953,6251,38.4,53584,25253,3086,3165
61955,149,47.3,32500,15056,80,69
61956,2642,48.1,46500,25060,1314,1328
61957,2119,41,50956,23889,1016,1103
62001,1620,45.8,75417,32389,820,800
62002,32345,37.5,40762,22613,15752,16593
62006,572,44,64167,32251,315,257
62009,1973,37.9,39444,20529,999,974
62010,11303,39.9,56587,27682,5591,5712
62011,271,46.5,32000,16711,156,115
62012,6809,42.3,64492,27186,3333,3476
62013,525,38.5,43906,24451,258,267
62014,4194,46.3,54770,24833,2128,2066
62015,370,55.7,39338,26329,175,195
62016,3717,46.8,46648,26031,1908,1809
62017,771,47.6,39762,26880,332,439
62018,4065,34.5,39375,18042,2092,1973
62019,401,48.9,47292,24313,182,219
62021,812,55.4,69417,41515,408,404
62022,987,44.8,46382,23689,528,459
62023,88,46.5,53750,27019,39,49
62024,9652,43.6,43592,23561,4853,4799
62025,33736,35.2,72877,34115,16550,17186
62027,557,41.9,49400,25873,290,267
62028,1316,21.6,67938,27434,602,714
62030,140,26.4,22143,8956,53,87
62031,825,45.7,48900,22605,431,394
62032,633,40.9,32279,19424,310,323
62033,4732,42.5,43482,23194,2463,2269
62034,14089,35.1,69696,32461,6553,7536
62035,16163,43.5,58481,29189,7665,8498
62036,660,53.9,54231,32862,334,326
62037,2001,45.6,48393,32620,940,1061
62040,43276,39.3,45737,22610,21735,21541
62044,2350,39.3,46313,22465,1157,1193
62045,515,46.9,46917,27862,262,253
62046,743,34.5,83281,32918,321,422
62047,1911,40.9,52214,25717,912,999
62048,1527,44.7,42902,22130,702,825
62049,10575,39.5,48026,14509,7106,3469
62050,346,47.3,33000,18466,210,136
62051,691,38.6,47150,35077,352,339
62052,13223,39.5,53457,24122,6511,6712
62053,515,43.3,44722,22110,278,237
62054,532,47.9,46786,23202,267,265
62056,8815,45.4,41370,22267,3788,5027
62058,732,37.7,41184,21364,359,373
62059,777,31.6,16016,15086,293,484
62060,4871,38.9,20692,17436,2323,2548
62061,2151,36.9,66875,31935,1109,1042
62062,8000,43.4,79841,38868,3939,4061
62063,1056,41.3,54074,25781,481,575
62065,64,49.5,-666666666,6794,35,29
62067,2202,41.7,50677,25676,1123,1079
62069,3235,41.7,46641,25677,1545,1690
62070,11,-666666666,-666666666,,0,11
62074,1165,39.8,58750,24322,597,568
62075,3466,41.5,40799,23301,1538,1928
62076,76,50.8,43125,21783,39,37
62077,230,47,28125,16417,96,134
62078,126,37.5,27250,16379,51,75
62079,407,37.3,55833,18981,185,222
62080,2830,41.7,44883,20547,1493,1337
62081,325,38.9,56429,27159,149,176
62082,2927,42.3,41891,20019,1529,1398
62083,385,25.5,33929,11963,191,194
62084,1601,35.7,44698,22125,777,824
62085,172,39.7,41023,18697,93,79
62086,1563,40.6,29890,17048,756,807
62087,2239,32.9,43281,19560,1163,1076
62088,7114,42.9,49073,25506,3224,3890
62089,369,45.3,39821,19699,158,211
62090,1114,31.5,21149,11651,372,742
62091,260,58.4,51538,26413,127,133
62092,3156,41.2,38214,19865,1507,1649
62093,398,31.5,28266,14098,206,192
62094,998,37.9,33750,18795,443,555
62095,11066,40.1,48790,23930,4860,6206
62097,2495,45.1,64196,31941,1233,1262
62098,122,44.3,61750,28493,66,56
62201,7065,23.5,16611,9503,3185,3880
62203,7542,42.2,28308,14057,3806,3736
62204,8806,32.8,16751,10885,4186,4620
62205,9203,38,22054,13251,4378,4825
62206,16556,31.9,31110,14996,7796,8760
62207,8374,33.3,19212,12154,3969,4405
62208,17185,40.9,62201,29990,8386,8799
62214,1095,36.8,59444,27325,559,536
62215,1742,38.1,75625,28386,914,828
62216,2678,37.6,75781,31978,1335,1343
62217,690,45.3,37596,22816,325,365
62218,1674,39.4,78958,30544,901,773
62219,956,35.2,49792,24158,437,519
62220,20366,36.7,51992,25206,9602,10764
62221,27656,38.5,56924,32156,13779,13877
62223,17698,41.2,54537,30748,7976,9722
62225,5590,22.6,51461,19282,3164,2426
62226,29913,39.6,51267,27635,14425,15488
62230,6350,36.2,68961,30598,3064,3286
62231,7354,40.2,51644,28481,3605,3749
62232,6970,42.4,42033,30744,3290,3680
62233,9834,38.6,46380,16015,6274,3560
62234,32843,38.1,52289,27249,16322,16521
62236,12648,39.1,68551,32463,6175,6473
62237,2776,42.8,52205,24931,1421,1355
62238,739,43.1,45104,21483,318,421
62239,4650,38.6,53750,25135,2318,2332
62240,2209,40.3,40018,18415,936,1273
62241,1288,32.9,58750,22733,753,535
62242,1357,45.3,53869,23182,629,728
62243,5989,45,75286,32503,2904,3085
62244,1300,45.4,72222,32235,627,673
62245,1610,42.7,62969,31275,793,817
62246,10321,36,53050,25618,5148,5173
62248,264,30.2,57679,21847,138,126
62249,15569,39.5,69653,30765,7461,8108
62250,552,34.1,60208,24974,288,264
62253,810,52.1,23947,18221,371,439
62254,5495,41.8,67009,33979,2554,2941
62255,892,43.8,45694,24434,446,446
62257,3032,46.2,53488,24827,1456,1576
62258,9418,38.8,68985,28792,4612,4806
62260,6763,41.3,76271,33193,3309,3454
62261,154,54.6,36250,28477,68,86
62262,1722,42.3,42723,19963,843,879
62263,5296,41.2,48458,24619,2656,2640
62264,3410,38.6,61535,29058,1781,1629
62265,4566,39.6,65563,27528,2290,2276
62266,342,45.6,90690,38230,153,189
62268,822,46.9,67159,31632,426,396
62269,32011,35.7,75903,35668,15600,16411
62271,1956,44.6,56000,28978,941,1015
62272,1589,40.3,34839,18648,823,766
62273,393,25.9,30547,9011,218,175
62274,8394,38,46516,16729,5115,3279
62275,3511,44.5,52296,23911,1721,1790
62277,1183,37.8,41023,19629,561,622
62278,7329,41.2,55852,27917,3495,3834
62279,62,26.5,-666666666,19477,47,15
62280,494,47.2,44097,25894,292,202
62281,2218,39.3,78516,32982,1050,1168
62282,475,43.8,52778,29449,237,238
62284,564,47.5,43355,20080,276,288
62285,4382,42.4,74231,30535,1806,2576
62286,6173,41.6,44974,24838,3150,3023
62288,2894,42.4,48262,22763,1369,1525
62289,327,47.7,43750,20796,182,145
62292,744,47.7,37188,18339,383,361
62293,4882,42.9,75160,33500,2435,2447
62294,14593,38.3,77671,31204,7726,6867
62295,1696,37.6,70957,27032,874,822
62297,203,66.5,25000,25693,116,87
62298,16471,43,69083,32594,8271,8200
62301,33125,38.3,37059,21581,15624,17501
62305,18624,43.1,59873,30165,9180,9444
62311,1018,38.7,51607,27811,531,487
62312,2285,41.5,38931,20877,1066,1219
62313,247,48.2,27368,22253,140,107
62314,498,42.8,37333,20384,276,222
62316,775,27.1,48750,16337,423,352
62319,256,58.5,37292,24610,141,115
62320,2105,44.7,48984,23463,1050,1055
62321,3978,45.5,49882,26267,1955,2023
62323,164,63.6,57321,29235,104,60
62324,1224,45.7,34464,21480,656,568
62325,374,39,35000,17702,196,178
62326,2267,44.9,38934,22239,1115,1152
62330,1852,39.5,39271,20130,851,1001
62334,134,44.3,32083,21085,68,66
62336,95,25.5,37031,19271,51,44
62338,1348,50.7,58795,26331,731,617
62339,916,45.5,42083,21372,432,484
62340,1569,43.8,38036,20380,745,824
62341,3545,45,49200,24186,1741,1804
62343,533,46.2,31838,21616,229,304
62344,134,41.4,46375,14428,50,84
62345,395,43.1,42500,20350,181,214
62346,183,46.6,28750,17118,97,86
62347,2612,38.3,60597,21180,1401,1211
62348,187,33.1,33375,16745,61,126
62349,495,50.6,46875,23209,221,274
62351,1882,38.5,50054,23571,1005,877
62352,400,28.9,43558,16690,213,187
62353,5414,35.7,39375,18582,3681,1733
62354,1578,55.6,39196,28399,733,845
62355,868,39,31917,18830,494,374
62356,583,47.3,40000,22444,309,274
62357,197,35.4,38750,16573,74,123
62358,752,32.5,31724,20914,339,413
62359,214,27.8,77813,20939,113,101
62360,1946,42.1,45000,19429,1019,927
62361,720,51.1,38942,21368,356,364
62362,343,57.4,38750,22191,138,205
62363,6049,42.4,45025,23837,3050,2999
62365,724,30.5,57083,23319,399,325
62366,1827,31.4,40556,17869,917,910
62367,1122,50.1,41875,24100,588,534
62370,528,52.1,36111,16445,268,260
62373,314,42.2,58382,22406,122,192
62374,327,34.9,28333,14403,180,147
62375,470,45.2,53333,32608,282,188
62376,1102,45.4,50594,24470,551,551
62378,1013,40.8,50163,25502,515,498
62379,2057,44.5,46400,23711,986,1071
62380,345,53.9,42132,22895,181,164
62401,18539,41.3,50363,29860,9093,9446
62410,942,38.6,55302,21846,479,463
62411,4653,42.3,53081,23499,2327,2326
62413,301,44.3,66000,27841,154,147
62414,1647,41.6,46797,22070,820,827
62417,2159,42,41847,17230,901,1258
62418,1884,41.1,42305,22015,967,917
62419,405,44.5,54632,22624,233,172
62420,4598,43,45951,25821,2307,2291
62421,1034,40.3,63558,24502,512,522
62422,1116,39.4,31597,18414,562,554
62423,810,36.7,50662,21947,367,443
62424,2185,36.1,47788,22085,1130,1055
62425,704,40.6,62750,25751,379,325
62426,1030,43.1,39120,22368,516,514
62427,1627,48.6,57652,24960,862,765
62428,3309,45.7,41469,22481,1613,1696
62431,1116,41.2,39604,19803,544,572
62432,468,44,50000,26757,245,223
62433,1049,47,50000,24841,498,551
62434,176,60.6,44375,34510,85,91
62436,688,36,40227,17694,329,359
62438,470,28.1,54318,20422,215,255
62439,7010,43.5,40199,19444,3172,3838
62440,1218,43.3,59231,26460,620,598
62441,7437,43,51680,24532,3646,3791
62442,2239,45.7,45147,21875,1081,1158
62443,1578,38.1,54891,19555,792,786
62444,407,47.9,45357,22996,204,203
62445,945,31.3,53438,16509,489,456
62446,389,41.5,34563,17480,188,201
62447,3158,46.6,45329,23571,1611,1547
62448,5658,45.6,49474,23738,2764,2894
62449,2971,41.5,46765,25332,1581,1390
62450,12211,43.4,42624,23298,5903,6308
62451,2429,39.9,40809,21141,1252,1177
62452,458,44.9,61202,26469,242,216
62454,11395,41.7,44690,25914,5935,5460
62458,2365,41.2,37955,19026,1203,1162
62459,223,49.7,47917,25186,103,120
62460,970,42.8,34583,18834,415,555
62461,827,44.4,55379,29738,502,325
62462,1117,34.9,51667,21708,635,482
62463,1246,47,46000,23845,638,608
62465,1023,39.2,58625,24934,479,544
62466,6412,35.3,38506,6397,5412,1000
62467,3919,36.4,73708,28382,2086,1833
62468,2649,40,41579,23396,1317,1332
62469,337,46.3,75000,31506,147,190
62471,9767,37.7,50984,22998,4888,4879
62473,1508,32.2,52386,18271,757,751
62474,896,46.8,40139,24223,414,482
62475,458,50,62841,26329,252,206
62476,2074,39.6,43269,20491,1026,1048
62477,1089,38.3,45735,23267,583,506
62478,318,37.8,49688,27890,135,183
62479,899,36.4,61739,26767,474,425
62480,765,34,52548,21073,386,379
62481,284,50.3,53875,27786,111,173
62501,2372,48.2,53807,32240,1147,1225
62510,1905,38.8,42073,19594,919,986
62512,387,35.4,50333,22709,171,216
62513,1690,34.8,52039,24130,785,905
62514,297,37.3,92875,27671,130,167
62515,966,46.8,54492,26193,436,530
62517,315,28.3,32292,17470,136,179
62518,377,40.4,59196,27621,196,181
62519,41,65.1,56094,28851,15,26
62520,1311,47.6,66711,31770,627,684
62521,35787,44,48288,28447,17511,18276
62522,16880,31.8,40210,20665,8292,8588
62523,906,36.3,8443,6582,647,259
62526,33559,40,38605,22817,14931,18628
62530,1539,36.6,60842,26463,722,817
62531,1811,40.4,72188,29305,877,934
62532,56,48.8,48875,31263,37,19
62533,764,45.9,50481,26725,346,418
62534,1224,43.3,44688,23605,632,592
62535,3876,42.7,94183,45719,1990,1886
62536,908,32,114178,39554,520,388
62537,37,53.9,67917,31578,20,17
62538,290,54.8,41528,26472,146,144
62539,1472,38,63672,26981,706,766
62540,1621,36.1,39650,21180,774,847
62541,155,30.4,39554,24812,67,88
62543,412,41.2,43000,22453,231,181
62544,1973,40.4,57031,35590,965,1008
62545,891,43.4,47760,24984,499,392
62546,1479,39.7,49732,24920,713,766
62547,870,42.1,46250,21154,451,419
62548,1787,51.8,57500,30023,839,948
62549,6101,37.8,64313,30102,3036,3065
62550,2801,43.5,54397,29025,1380,1421
62551,852,42,53355,26204,420,432
62553,478,34.5,41513,19289,234,244
62554,1495,39.8,62692,29278,694,801
62555,468,34.9,60536,25560,247,221
62556,362,40.8,40893,21329,160,202
62557,7132,43.2,36453,19077,3258,3874
62558,3630,41.6,65363,32003,1830,1800
62560,1119,45.5,47054,23734,489,630
62561,5281,39.6,54653,23431,2337,2944
62563,5844,42,89063,37952,2814,3030
62565,7562,46.1,45745,22943,3639,3923
62567,1038,36.7,49167,22718,456,582
62568,16512,43.4,47186,26197,9094,7418
62570,488,48,38967,21986,245,243
62571,1473,44.2,54091,22481,759,714
62572,577,48.3,42206,21467,249,328
62573,1511,40.3,54145,31059,840,671
62601,478,33.3,63906,30906,247,231
62610,273,33.9,28750,19380,172,101
62611,1227,45.1,58274,25014,602,625
62612,2065,40.7,57583,25515,1128,937
62613,3774,37.8,60284,28806,1836,1938
62615,5577,36.9,61074,26619,2882,2695
62617,706,40.3,43438,23189,356,350
62618,7843,36.8,42394,20170,3991,3852
62621,1308,40.1,55069,24979,690,618
62622,0,-666666666,-666666666,-666666666,0,0
62624,662,40.5,56750,25049,337,325
62625,754,51.3,84135,33627,409,345
62626,8227,42.5,52331,26207,4113,4114
62627,1093,40.9,45313,28590,536,557
62628,814,41,55125,31411,384,430
62629,13464,37.4,80301,33207,6336,7128
62630,546,34.3,54896,26634,269,277
62631,213,43.9,56250,27829,106,107
62633,690,50.3,56250,27852,350,340
62634,629,46.4,67750,29145,305,324
62635,613,41.6,54583,26208,336,277
62638,1206,42.7,55278,28447,622,584
62639,209,59.2,35000,26275,104,105
62640,3909,39.8,50380,25565,1946,1963
62642,1529,43.5,56940,28500,817,712
62643,365,41.9,51094,26639,163,202
62644,5316,44.4,35888,22063,2492,2824
62649,457,38.5,61719,24799,256,201
62650,27001,40.5,46486,23943,13530,13471
62655,611,48.1,49318,23403,314,297
62656,22626,37.7,42966,19243,11779,10847
62661,966,42.8,57672,25642,500,466
62663,454,46.5,48523,24437,206,248
62664,2998,45.5,42065,23062,1539,1459
62665,1524,44.6,38681,21321,763,761
62666,485,49.2,56875,36382,230,255
62667,390,39.3,36250,27933,169,221
62668,1393,39.8,50481,24183,704,689
62670,3692,38.1,72950,28809,1815,1877
62671,389,48.2,56094,27881,181,208
62672,217,46.5,38750,20137,96,121
62673,697,35.9,60179,19800,291,406
62674,1409,47.7,46324,23274,687,722
62675,6065,46.8,57995,29231,2947,3118
62677,2680,42.8,78444,34124,1458,1222
62681,5505,44.3,49103,23850,2904,2601
62682,667,43.3,51618,24431,331,336
62684,5608,42.9,88525,38910,2511,3097
62685,1893,42.7,56757,24028,965,928
62688,659,38.6,53000,21976,331,328
62689,488,42.6,55074,27221,281,207
62690,4210,37.7,41721,22999,2108,2102
62691,2119,45.8,47885,25618,1031,1088
62692,2010,39.8,50677,25222,1041,969
62693,1631,37.8,80625,33004,745,886
62694,2940,44.4,46683,24513,1373,1567
62695,233,43.5,35500,20781,89,144
62701,1095,43.3,25114,30519,682,413
62702,36300,38.7,39486,22791,17141,19159
62703,30644,32.3,35548,18855,14740,15904
62704,39883,40.5,51502,32254,18861,21022
62707,7783,43.4,69212,29837,3816,3967
62711,16364,44.1,91667,47027,7621,8743
62712,9835,41,84485,42699,5029,4806
62801,22585,41.7,38169,20546,11651,10934
62803,1099,40.4,58676,22276,547,552
62806,3389,42.7,36818,20366,1700,1689
62807,1063,38.6,49821,18774,527,536
62808,1570,40,52778,26553,761,809
62809,100,59.1,66719,30810,55,45
62810,1006,34.1,47000,21662,504,502
62811,208,45.8,31944,20413,109,99
62812,11349,42.1,34640,21740,5506,5843
62814,1907,40.7,53226,21458,946,961
62815,394,47.5,47000,20470,156,238
62816,1433,43.9,50809,24065,806,627
62817,685,46.3,36522,21479,333,352
62818,341,47.9,40341,20225,174,167
62819,440,34.1,30000,14597,212,228
62820,170,60.8,59375,31299,81,89
62821,7578,45.7,39010,25685,3555,4023
62822,2830,40.7,33587,20149,1465,1365
62823,1880,46.5,48203,22026,962,918
62824,1862,46.8,40339,20602,989,873
62825,222,41.4,39375,17267,122,100
62827,1282,37,43750,21545,618,664
62828,1264,34.4,52396,22257,626,638
62829,122,38.6,29010,27027,69,53
62830,1354,40.6,39722,20037,669,685
62831,511,54.6,46974,26008,281,230
62832,8835,41.1,37407,22184,4347,4488
62833,206,52.2,48750,29271,111,95
62835,1052,41.8,38375,21789,538,514
62836,676,39.7,51250,24125,337,339
62837,8914,43.3,38603,22763,4252,4662
62838,1764,36.6,37569,20128,925,839
62839,6678,42,40309,20806,3032,3646
62841,137,26.8,102833,25142,62,75
62842,837,39.4,48469,21907,374,463
62843,89,54.5,29063,20813,47,42
62844,1960,47.6,38045,21839,898,1062
62846,2580,38,39038,8710,2142,438
62848,529,44.2,42500,27606,261,268
62849,2409,40.8,49702,20126,1202,1207
62850,235,51.5,31667,21330,122,113
62851,242,54.8,49615,45512,130,112
62852,135,38.9,40625,19101,81,54
62853,857,47.4,42000,20327,408,449
62854,1645,38.6,42521,19959,844,801
62856,279,54.7,35179,22517,135,144
62858,3260,43.3,46094,26433,1724,1536
62859,5577,44.9,35362,21477,2745,2832
62860,485,47.1,52656,24033,223,262
62861,136,41.5,38125,14711,68,68
62862,333,47.8,46719,42091,196,137
62863,10047,43.2,47261,24860,4869,5178
62864,24124,41.5,40036,24414,11717,12407
62865,1686,47.7,59688,24904,816,870
62867,450,46.8,33125,18624,227,223
62868,1695,40.6,47500,23813,867,828
62869,2841,41.9,53056,28297,1454,1387
62870,2009,42.2,41512,21164,987,1022
62871,675,45.6,65625,32603,350,325
62872,1196,35.2,47240,19427,600,596
62874,377,44.1,32188,17989,162,215
62875,1110,43.8,46917,24116,533,577
62876,206,45,29861,20807,110,96
62877,579,47.1,51182,23464,308,271
62878,328,54.4,55125,28427,163,165
62879,86,46,32000,14416,51,35
62880,528,49.3,38357,22170,289,239
62881,11164,40.7,42810,23333,5384,5780
62882,2239,39.7,34639,19518,1096,1143
62883,820,41.7,50750,20974,447,373
62884,2890,44.6,37781,20338,1449,1441
62885,945,34.8,41908,17688,481,464
62886,559,34.7,50278,18448,284,275
62887,303,30,37404,21903,98,205
62888,2460,44.8,46894,22494,1270,1190
62889,920,41.8,47750,20300,406,514
62890,3318,35.4,42969,17707,1717,1601
62891,631,46.5,33875,19147,350,281
62892,238,47.6,48125,22107,115,123
62893,910,47.5,67946,27968,476,434
62894,969,39,51500,24460,516,453
62895,2178,35.9,48590,20640,1080,1098
62896,12359,40,35750,19780,5931,6428
62897,413,47.5,31250,20044,219,194
62898,2125,40.5,55900,22142,1069,1056
62899,1697,37.7,38229,21209,906,791
62901,27417,23.9,20995,16604,13904,13513
62902,4544,34.9,47134,28759,2263,2281
62903,2646,26.7,25150,24575,1267,1379
62905,799,43.4,26940,14458,404,395
62906,6988,46.3,43816,24072,3554,3434
62907,2406,38.5,62213,26042,1213,1193
62908,419,43.4,23750,19509,213,206
62910,2496,45.6,42121,23683,1073,1423
62912,1119,41.1,45882,20747,563,556
62914,3013,38,16747,10681,1297,1716
62915,312,30.1,37604,12238,179,133
62916,743,46.1,46731,22383,427,316
62917,2391,49.5,30769,18483,1189,1202
62918,9731,39.4,51782,27217,4680,5051
62919,931,51.7,41458,21495,513,418
62920,3558,40,41996,22938,1730,1828
62921,510,34.7,17621,10848,222,288
62922,3192,46.9,51932,21562,1570,1622
62923,590,42.8,30893,17601,275,315
62924,2788,36.9,37218,20074,1445,1343
62926,2130,42.9,43309,19586,1061,1069
62927,285,47.7,33125,20734,128,157
62928,257,32.9,40938,17928,123,134
62930,6153,44.3,29972,19824,2826,3327
62931,1610,52,44286,28820,860,750
62932,1667,40.3,38229,25342,864,803
62933,1085,37.8,37697,20009,512,573
62934,983,46.4,44554,33506,471,512
62935,1757,39.6,40000,20485,846,911
62938,2985,47.4,38809,21496,1482,1503
62939,3176,44.4,42850,22143,1512,1664
62940,391,42.3,43125,22936,210,181
62941,729,45.6,34688,23693,347,382
62942,556,46.2,31645,17248,265,291
62943,668,39.4,28500,13576,400,268
62946,13336,39.9,40384,23040,6681,6655
62947,579,55.9,39688,23552,272,307
62948,12888,38.3,39502,22206,6320,6568
62949,760,40.4,32396,17626,388,372
62950,226,52.8,20000,15279,112,114
62951,5747,38.6,39468,20370,2753,2994
62952,3205,42.2,34342,18728,1578,1627
62953,299,35.7,38750,14856,153,146
62954,571,35.5,68750,23170,263,308
62956,902,46.1,47500,21001,382,520
62957,1044,44.4,38454,19547,507,537
62958,2037,42.6,55000,33484,962,1075
62959,27205,42.4,45947,25225,13807,13398
62960,11841,41.7,44233,21909,5639,6202
62961,70,37.5,53750,19870,33,37
62962,83,46.4,91250,24835,44,39
62963,715,30.9,32143,14770,370,345
62964,1553,36.3,27331,16104,718,835
62965,74,56.7,40625,25386,29,45
62966,15876,39.9,37526,21171,7768,8108
62967,312,37.9,30104,18906,170,142
62969,667,55.8,40833,18540,362,305
62970,708,46,31875,24390,346,362
62972,1151,53,40714,19968,584,567
62974,1364,46.3,36848,19256,679,685
62975,209,58,33906,22253,107,102
62976,436,52.1,45833,24859,241,195
62977,552,38.8,42589,22184,267,285
62979,1171,51.5,36141,22621,544,627
62982,1363,35.2,20486,14406,800,563
62983,1365,45.9,33854,19595,715,650
62984,1869,41.5,33702,19414,878,991
62985,1304,45.2,34349,16599,778,526
62987,887,46.7,41702,20670,450,437
62988,2130,38.3,31250,13339,1330,800
62990,1023,32.1,26447,12567,560,463
62992,835,46.1,31181,16330,455,380
62994,612,44.2,47448,22738,336,276
62995,5130,40.1,40132,16054,3295,1835
62996,508,43.9,47731,32601,295,213
62997,475,37.5,24318,14401,208,267
62998,369,43.6,26481,14609,231,138
62999,1915,40.6,31859,16800,945,970
63005,17700,42.1,163413,70343,8950,8750
63010,36472,37.9,58204,25935,17971,18501
63011,36799,43.5,85133,40529,17712,19087
63012,10762,37,66667,25590,5341,5421
63013,1689,38.4,71296,26044,968,721
63014,467,48.4,32188,19712,210,257
63015,2045,44.2,57900,26000,955,1090
63016,7630,41.2,50292,22453,3783,3847
63017,41732,48.5,93110,50218,19973,21759
63019,4474,32.8,53114,23499,2326,2148
63020,20437,39.8,44640,20785,10193,10244
63021,56217,38.7,82449,39518,26771,29446
63023,5336,47.4,52621,24408,2744,2592
63025,13267,39.8,86412,35832,6542,6725
63026,44349,37.8,70132,31110,21707,22642
63028,26982,39.5,51828,24008,13306,13676
63030,315,41,49441,22871,144,171
63031,49650,37.4,55260,25519,23482,26168
63033,41434,39.8,51707,25561,19098,22336
63034,17976,45.3,72231,32498,8471,9505
63036,841,55.6,30930,16730,436,405
63037,3032,45.5,37651,19361,1533,1499
63038,6631,45.5,106513,54149,3243,3388
63039,1297,31.7,44521,18539,698,599
63040,8901,38.4,108655,41821,4271,4630
63041,409,42.8,30326,21152,260,149
63042,19895,34.6,42648,22921,9716,10179
63043,22286,38.1,61300,30590,10913,11373
63044,10634,45.4,47415,26317,5103,5531
63045,0,-666666666,-666666666,-666666666,0,0
63047,0,-666666666,-666666666,-666666666,0,0
63048,3469,33.7,52951,21393,1650,1819
63049,15879,37.9,60511,29521,8207,7672
63050,15152,41,56330,23488,7324,7828
63051,14450,37.2,53532,22036,7371,7079
63052,25362,35.9,63183,26107,12340,13022
63053,94,31.3,51094,23496,59,35
63055,2188,42.1,43385,30932,1118,1070
63056,2136,38.1,44345,18598,1069,1067
63057,61,68.3,-666666666,22259,61,0
63060,2723,44.6,57235,25233,1318,1405
63061,223,39.7,36648,18943,57,166
63068,5228,40.2,60464,25346,2491,2737
63069,14883,38.7,50956,28399,7772,7111
63070,7762,34.2,40795,21845,4043,3719
63071,1407,38.4,33462,13277,650,757
63072,3187,41.4,47623,22328,1632,1555
63073,574,37.7,238661,83054,278,296
63074,15202,36.1,35590,21372,7322,7880
63077,11154,40.6,39424,19899,5912,5242
63079,9,-666666666,-666666666,,9,0
63080,14333,36,36099,19142,7062,7271
63084,17990,37.4,51667,24622,8875,9115
63087,976,42.8,45278,20388,412,564
63088,8427,35.5,60471,35242,3964,4463
63089,5409,45.1,49159,23388,2797,2612
63090,21743,39.9,54120,28645,10508,11235
63091,1105,43.6,48250,24532,510,595
63101,2613,30.4,54417,42701,1383,1230
63102,2216,33.6,54018,32318,1647,569
63103,6824,30.4,34719,30274,3321,3503
63104,19520,31.2,45498,29780,9281,10239
63105,17361,33.8,86031,57408,9158,8203
63106,11736,25.2,15126,9532,4550,7186
63107,12127,36.7,23276,12838,5932,6195
63108,21277,29.8,30157,31477,10290,10987
63109,27658,37.9,51951,32976,13354,14304
63110,16635,33.9,38036,26387,7913,8722
63111,20891,34.7,30334,17518,10794,10097
63112,20110,31.8,27383,20775,9345,10765
63113,12239,39.1,24561,14068,5934,6305
63114,36307,35.9,41771,20814,17883,18424
63115,21059,35.8,26183,14527,9490,11569
63116,44010,35.7,40251,23436,21665,22345
63117,9221,37.7,62593,48558,4294,4927
63118,27350,31.5,28630,18570,13510,13840
63119,33929,40.7,68348,40788,16035,17894
63120,9022,36,23996,12516,4159,4863
63121,26316,38.2,33704,19084,11520,14796
63122,38585,43.8,80682,48813,17869,20716
63123,49390,41,52877,28928,24049,25341
63124,10594,47.6,118816,83169,4976,5618
63125,32219,40.7,44458,23446,15478,16741
63126,14920,45.7,64436,34290,7075,7845
63127,4784,50.7,88469,57261,2391,2393
63128,29973,49.1,73440,39328,14271,15702
63129,52733,43,65861,34609,25599,27134
63130,30810,34.7,55976,36054,14650,16160
63131,17410,47,132500,77115,8383,9027
63132,13816,38.5,55687,38152,6238,7578
63133,8210,34.8,25239,13025,3635,4575
63134,13927,33.5,36539,17954,5849,8078
63135,21940,34.3,40443,20755,9517,12423
63136,47220,33.7,31051,16086,20429,26791
63137,20546,34.2,34019,16315,9243,11303
63138,20863,30.3,33691,17488,8981,11882
63139,22212,38.2,47280,30918,10707,11505
63140,252,38.4,21750,9908,140,112
63141,19915,43,102708,62160,9993,9922
63143,9996,36.8,36210,25539,4683,5313
63144,8850,36.4,68367,42936,4118,4732
63146,30127,42.4,63921,36537,14534,15593
63147,10534,39.6,29816,16969,5403,5131
63155,0,-666666666,-666666666,-666666666,0,0
63301,49549,37.2,52633,26636,25315,24234
63303,46318,38.4,67179,34336,22155,24163
63304,40094,39.8,85329,35568,19531,20563
63330,141,59.1,36375,29189,98,43
63332,1306,49.5,82206,37200,690,616
63333,830,38.5,36438,17843,409,421
63334,9422,37.4,38921,16108,5642,3780
63336,957,52.6,45185,26692,487,470
63339,1028,42.6,48542,21946,503,525
63341,3704,50,90605,37721,1814,1890
63343,4394,40.1,38802,18086,2241,2153
63344,1903,33.5,57601,21758,874,1029
63345,528,40.1,41563,18890,254,274
63347,3011,39.8,53415,20285,1581,1430
63348,6224,40.4,72380,29592,3209,3015
63349,1647,41.4,57857,20223,840,807
63350,769,44,44464,22732,399,370
63351,1613,50.6,51364,22739,748,865
63352,1008,45.6,41776,19852,494,514
63353,4543,41.2,36179,18504,2312,2231
63357,5291,42.6,64757,31052,2829,2462
63359,1138,44.1,47981,23346,566,572
63361,4508,41,43264,21844,2359,2149
63362,6346,31.5,41700,18545,3071,3275
63363,1844,50.1,38380,22776,949,895
63366,47697,34.4,66352,28052,23394,24303
63367,20532,37.3,84756,38098,9972,10560
63368,42886,36.5,84333,34324,21406,21480
63369,2006,42.3,51722,27609,1011,995
63370,17,80.1,-666666666,29559,13,4
63373,577,45.2,55833,26313,285,292
63376,71988,38.1,74161,30709,34378,37610
63377,2766,40.6,54461,21789,1385,1381
63379,23383,35.6,57289,23938,11390,11993
63381,448,49.4,65000,26830,273,175
63382,4926,38.9,35545,13934,1789,3137
63383,15126,39.8,47723,22047,7394,7732
63384,1858,48,32458,18357,847,1011
63385,35253,34.5,72207,29390,17480,17773
63386,610,46.6,44875,21712,354,256
63387,74,47.5,30938,16124,30,44
63388,851,40,32682,18033,433,418
63389,7051,33.7,52659,21309,3728,3323
63390,10736,36.2,48922,24886,5361,5375
63401,21795,39.4,39600,20788,10719,11076
63430,501,46.6,41250,23902,264,237
63431,117,51.3,31667,23085,70,47
63432,451,49.6,44097,21730,222,229
63433,31,64.8,-666666666,32081,22,9
63434,732,37.5,39375,17509,378,354
63435,4506,31.3,40890,18331,2244,2262
63436,1074,49.4,51563,22898,595,479
63437,1356,45.5,28750,19192,678,678
63438,721,34.7,58523,35293,354,367
63439,44,67.8,38500,38045,23,21
63440,1451,39.9,44535,21684,750,701
63441,1122,44.2,42546,19691,591,531
63443,460,51,39821,16413,228,232
63445,3675,41.1,41711,20818,1829,1846
63446,704,42.5,34261,18460,332,372
63447,1192,37.5,34010,17176,673,519
63448,1595,42.8,51042,21953,734,861
63450,132,60.1,32500,18080,65,67
63451,335,28.6,54167,23697,158,177
63452,1043,44.4,36620,18279,512,531
63453,613,37.9,47917,19194,269,344
63454,809,52.3,51970,22469,399,410
63456,3839,46,43284,22956,1738,2101
63457,255,35.5,36442,18005,149,106
63458,205,48.8,48500,24295,104,101
63459,4583,39.2,54708,23959,2174,2409
63460,331,48.5,36667,22401,141,190
63461,5685,39.9,46830,24122,2619,3066
63462,1528,47.5,37500,21576,757,771
63463,728,42.3,47222,21234,374,354
63464,43,70.2,16250,9998,33,10
63465,491,43.6,44500,18822,270,221
63467,31,55.5,-666666666,35477,22,9
63468,2310,45.3,33224,18824,1039,1271
63469,1280,37.5,42050,21713,689,591
63471,577,48.1,41434,25254,316,261
63472,564,36.8,26635,12896,264,300
63473,372,49.7,42250,22999,195,177
63474,435,48.1,35208,19100,214,221
63501,21559,26.7,33685,19214,10047,11512
63530,871,44.2,39271,20305,434,437
63531,453,30,27159,20819,209,244
63532,1131,50.2,36875,21621,583,548
63533,841,39.7,43125,20115,419,422
63534,823,41.2,43516,20448,436,387
63535,176,38.4,11875,15116,74,102
63536,719,35.8,34896,14299,361,358
63537,1782,46.2,30685,18576,881,901
63538,310,42,39750,17573,169,141
63539,201,58.4,43000,21176,105,96
63540,307,33.1,28125,10838,156,151
63541,325,47.8,38194,20531,166,159
63543,386,30.6,33000,17938,190,196
63544,1011,42.9,38700,20182,535,476
63545,1053,49.8,35809,21557,525,528
63546,1154,53,41713,25707,599,555
63547,667,30.7,39615,18717,352,315
63548,1247,36.8,32625,19615,553,694
63549,2642,37.6,33647,15204,1266,1376
63551,255,61.5,15156,12551,93,162
63552,7932,41.9,40919,21357,3696,4236
63555,3261,36.4,39464,21332,1652,1609
63556,3716,37.1,41774,18813,1917,1799
63557,240,52.7,63125,25623,90,150
63558,758,50.7,34500,20185,377,381
63559,1515,44.1,40139,18419,824,691
63560,293,48.5,31875,18827,148,145
63561,1462,43.1,37500,16717,740,722
63563,591,38.5,33750,23936,274,317
63565,3980,43.4,38297,19735,2071,1909
63566,118,38.9,34107,15108,57,61
63567,237,33.9,14839,8026,87,150
63601,16707,38.2,31351,17424,7783,8924
63620,1418,40.6,33750,16833,667,751
63621,1437,45.8,42955,22263,687,750
63622,726,47.9,36211,20127,376,350
63623,841,51.1,36071,16985,435,406
63624,3579,45.9,29868,17337,1779,1800
63625,394,52.3,51875,18881,213,181
63626,1085,47.5,20941,16262,450,635
63627,2612,45.8,37188,21993,1305,1307
63628,16088,37.4,40126,16504,9709,6379
63629,1541,44.1,28478,15531,838,703
63630,4226,36.2,29449,20363,2088,2138
63631,1120,37.3,55217,18591,600,520
63633,914,44.3,26458,18352,465,449
63636,599,51.6,28068,17213,237,362
63637,1108,37.7,18764,18616,530,578
63638,2601,49.1,31207,18870,1246,1355
63640,26933,39.2,45749,21264,15016,11917
63645,11341,41.9,35180,16962,5566,5775
63648,1623,31.2,37262,15797,801,822
63650,4447,42.2,40554,21249,2353,2094
63653,1471,26.7,30313,13635,729,742
63654,562,47.1,55221,24523,275,287
63655,1480,38.6,36406,17549,738,742
63656,326,40.9,32955,16605,183,143
63660,4023,41.1,30553,15213,2449,1574
63662,1313,40.4,44659,21752,653,660
63663,661,49.4,28966,16397,332,329
63664,8234,39.9,34681,17709,4024,4210
63665,278,45.2,48750,21644,169,109
63666,178,26.2,35625,10288,96,82
63670,11034,43,47304,23278,5496,5538
63673,2014,46.3,50214,20788,1031,983
63674,150,42.8,39628,21687,82,68
63675,200,45.9,52625,21302,102,98
63701,36346,33,47890,25169,17731,18615
63703,8853,32.8,26552,16543,4068,4785
63730,3968,40.9,39583,19906,1894,2074
63732,688,39.5,58654,22206,300,388
63735,801,43.4,36518,23148,382,419
63736,3341,40.5,48654,23792,1560,1781
63738,15,-666666666,-666666666,,6,9
63739,469,47.2,42917,21113,292,177
63740,5504,40.4,38380,18582,2856,2648
63742,54,29.7,41250,19587,31,23
63743,79,50,86500,28076,33,46
63744,136,46.2,37639,13721,75,61
63745,38,48.7,40469,18411,20,18
63746,30,42.8,59000,23763,16,14
63747,517,44.1,54107,22193,234,283
63748,1162,47.2,63636,30597,623,539
63750,5,-666666666,-666666666,,0,5
63751,1185,48.3,31250,14944,558,627
63755,24358,38.5,52144,25214,11360,12998
63758,153,52.8,68750,31484,75,78
63760,831,28.2,49954,18671,419,412
63763,244,37.3,27000,58604,156,88
63764,5538,40.6,31082,18146,2731,2807
63766,1503,41,44191,22159,816,687
63767,756,36.4,45662,18747,375,381
63769,1572,42.2,42917,20074,846,726
63770,121,35.8,48750,27215,55,66
63771,2576,43.5,44196,20841,1267,1309
63774,127,42.3,26250,14015,92,35
63775,16429,39.1,45046,22742,8212,8217
63780,6623,38.8,39281,21206,3162,3461
63781,1150,46.6,47545,21753,548,602
63782,312,44.5,31953,15051,154,158
63783,216,47.7,89167,34232,110,106
63784,335,26.6,31786,16727,149,186
63785,1108,35.9,49545,19211,557,551
63787,806,46.1,32778,17151,439,367
63801,23415,39.1,39853,21135,11220,12195
63820,328,45.5,27500,14009,172,156
63821,974,45,29010,16361,514,460
63822,3249,38,39779,17989,1469,1780
63823,1274,52.1,31302,21652,714,560
63824,174,27.6,34219,13434,80,94
63825,4129,42.6,40085,20183,2122,2007
63826,41,46.3,49167,16559,17,24
63827,913,41.7,39107,20015,461,452
63828,289,36.1,30341,12934,163,126
63829,1117,39.5,28750,16209,539,578
63830,7122,37.2,29272,17182,3253,3869
63833,282,45.9,14701,12405,99,183
63834,6801,37.8,29401,14214,3945,2856
63837,1533,40.8,26528,14299,758,775
63839,464,36,41167,16417,232,232
63841,13003,42.1,37442,28202,6124,6879
63845,5775,36.4,31098,16247,2714,3061
63846,1623,41.3,40250,19141,833,790
63847,37,-666666666,-666666666,,19,18
63848,1318,41.1,30385,18752,617,701
63849,241,27.3,39219,20376,119,122
63851,4163,37,21923,13522,2112,2051
63852,1402,32.9,35156,16627,762,640
63853,266,44.8,28125,15558,119,147
63855,1261,37.5,41447,19802,695,566
63857,12999,38.7,33404,19978,6205,6794
63860,167,27.7,37500,18550,45,122
63862,1512,45.5,22123,13939,671,841
63863,6123,43.2,30620,17424,2918,3205
63866,476,30.3,26500,13743,230,246
63867,1257,47.2,41875,21595,603,654
63868,753,38.2,30093,15952,370,383
63869,3789,41.7,34293,26192,1799,1990
63870,1099,40.6,31078,13728,545,554
63873,4841,37.9,41188,22278,2355,2486
63874,389,37.2,58125,20819,187,202
63876,2314,40.3,25409,16851,1097,1217
63877,3779,35.9,31815,18850,1690,2089
63878,139,37,35500,13778,68,71
63879,774,41,34318,16267,375,399
63880,92,29.9,38929,22162,55,37
63882,462,39.9,24722,14981,243,219
63901,34486,40,35678,19810,16579,17907
63902,0,-666666666,-666666666,-666666666,0,0
63932,1341,50,33929,16685,640,701
63933,3890,41.4,30000,15122,1720,2170
63934,103,48.2,-666666666,12054,54,49
63935,9863,42.5,31208,16144,4890,4973
63936,734,41.6,40250,20386,413,321
63937,2883,35.9,32083,15240,1469,1414
63939,1434,42,30833,14861,658,776
63940,1473,47.2,40854,20124,818,655
63941,434,49,50603,26826,215,219
63942,800,50.6,39440,23875,384,416
63943,1032,34.9,21953,14439,509,523
63944,1772,42.5,29808,20478,868,904
63945,1234,32.5,24250,16433,465,769
63951,219,48.8,47768,20417,121,98
63952,415,57.1,27250,12793,204,211
63953,1968,40.2,39565,16908,962,1006
63954,1071,45.5,26468,13931,573,498
63955,140,54.7,19402,20549,78,62
63956,1064,45.2,32286,21355,541,523
63957,6042,44.9,32177,17980,2979,3063
63960,3142,43.9,37756,20208,1619,1523
63961,2086,35.8,26822,14531,908,1178
63962,0,-666666666,-666666666,-666666666,0,0
63964,644,56.3,34770,17100,280,364
63965,2771,45,35372,21852,1335,1436
63966,2068,53.5,33776,21420,1044,1024
63967,1800,40.9,38041,16853,956,844
64001,625,53.3,59583,32796,284,341
64011,3297,46.1,68500,28915,1616,1681
64012,27338,34.7,53803,25148,13501,13837
64014,25640,34.7,68665,29759,12189,13451
64015,30828,39,64344,29507,15397,15431
64016,4775,37.5,57981,24547,2315,2460
64017,427,50.1,66389,30134,205,222
64018,823,46,61786,30507,437,386
64019,1732,39.9,47928,24406,825,907
64020,3324,44.4,55109,25087,1459,1865
64021,625,33.3,43750,18241,341,284
64022,126,53.4,42083,19929,56,70
64024,16628,38.7,51679,23544,8086,8542
64029,16745,33.5,66773,25968,8097,8648
64030,24673,33.2,43121,20569,11885,12788
64034,8191,35,77500,33163,3977,4214
64035,1031,35,54605,21656,554,477
64036,355,34.9,28984,12823,207,148
64037,6347,38.3,45062,22266,3343,3004
64040,5954,42.7,49755,24221,2963,2991
64048,4111,46.5,74720,30487,2105,2006
64050,21395,39.3,33776,18876,10127,11268
64052,21723,38.1,35954,19886,10222,11501
64053,4798,38.5,35115,16885,2371,2427
64054,3684,33.3,32470,18934,1809,1875
64055,33281,43.7,51375,26826,15946,17335
64056,16538,32.3,53093,21591,7823,8715
64057,14593,40.7,58500,29003,6670,7923
64058,6898,36.3,61356,23927,3308,3590
64060,13615,38,81670,32712,6744,6871
64061,3709,43,52188,25010,1820,1889
64062,5441,42.3,64111,29009,2706,2735
64063,20254,35.2,63065,28166,9939,10315
64064,16774,38.9,81950,40643,8106,8668
64065,72,19.9,31250,12919,31,41
64066,18,55.5,51875,24922,12,6
64067,5627,48.7,47479,24724,2816,2811
64068,36798,38.2,66225,31331,18403,18395
64070,3118,37.5,73291,28790,1457,1661
64071,1168,41.3,46964,22863,579,589
64072,220,49.3,36667,22280,109,111
64074,820,41.6,60000,26397,466,354
64075,11888,36.2,55746,23673,5748,6140
64076,9259,35.7,50616,23026,4548,4711
64077,1742,41.8,52235,24785,934,808
64078,9375,39.3,69360,27254,4845,4530
64079,12664,36.5,81778,34449,6383,6281
64080,12351,38.7,57870,27800,5813,6538
64081,23549,41.3,76684,35039,11147,12402
64082,14634,35.5,104975,36169,7355,7279
64083,20563,39.1,72221,30886,10014,10549
64084,1695,42.9,60647,23982,820,875
64085,8938,39.2,47038,22051,4272,4666
64086,21430,35.9,78203,34998,10448,10982
64088,1196,48.5,57614,31073,614,582
64089,11194,39.2,72423,32047,5582,5612
64090,69,48.5,37500,20475,37,32
64092,106,-666666666,-666666666,,49,57
64093,28045,26.8,43894,20434,14169,13876
64096,1204,39.6,35238,18995,559,645
64097,1362,35.9,46250,25318,722,640
64098,2858,42.8,73142,30324,1464,1394
64101,291,37.8,-666666666,5226,261,30
64102,0,-666666666,-666666666,-666666666,0,0
64105,3712,29.9,41928,41565,2040,1672
64106,8125,28.1,25649,18949,4371,3754
64108,8535,36.9,35521,27727,4430,4105
64109,8764,37.3,19149,20015,4427,4337
64110,15063,31.4,40066,24241,7695,7368
64111,16083,33.2,37695,29875,8636,7447
64112,8308,31.8,54679,70500,3848,4460
64113,11718,41.7,113536,66601,5738,5980
64114,24720,39.9,54532,34380,11657,13063
64116,14938,40.9,42940,30844,7633,7305
64117,14015,33.7,42742,21359,6847,7168
64118,41146,34.9,49994,25491,19760,21386
64119,27232,38.8,60787,30498,13453,13779
64120,346,58.5,57674,33291,171,175
64123,9511,30.8,30383,13068,4475,5036
64124,11340,31.9,26288,13260,5721,5619
64125,1665,31.3,23462,11639,860,805
64126,6011,28.8,25009,9196,3046,2965
64127,15419,34.5,21494,12924,7111,8308
64128,12339,34.5,23805,13355,5402,6937
64129,9100,36.2,32377,19682,4042,5058
64130,21000,39.2,28493,15238,9827,11173
64131,22850,38.1,40128,25512,11314,11536
64132,13621,30.3,26536,14035,6147,7474
64133,33567,40.1,48407,24573,16528,17039
64134,22292,32.2,38913,17299,10472,11820
64136,2148,38.3,31008,23150,953,1195
64137,12148,32.9,50315,21751,6247,5901
64138,25090,38.2,45904,23012,11792,13298
64139,1854,42.2,82829,30512,963,891
64145,4915,53.1,62054,38822,2330,2585
64146,1689,43.3,40993,28252,884,805
64147,817,19.2,14659,5098,362,455
64149,193,52.7,54792,44857,111,82
64150,3131,37.9,39390,22313,1537,1594
64151,24580,38.4,63957,34310,11944,12636
64152,26430,38.3,79368,39910,12934,13496
64153,5168,35.4,58845,33953,2609,2559
64154,9811,35.8,53586,36394,4894,4917
64155,22581,35.1,72990,31264,10891,11690
64156,5400,31.8,69643,33597,2404,2996
64157,17030,31.4,100873,35494,8084,8946
64158,5082,33.6,73125,29243,2567,2515
64161,328,43.8,63281,31019,188,140
64163,785,31.3,40125,21028,451,334
64164,341,58.6,31406,33330,170,171
64165,55,32.2,-666666666,,18,37
64166,252,36.7,132708,45977,164,88
64167,280,36.9,138333,49219,114,166
64192,0,-666666666,-666666666,-666666666,0,0
64401,1463,43.8,70333,28498,737,726
64402,2594,43.7,37321,18948,1119,1475
64420,99,43.2,38750,15178,43,56
64421,607,42.6,43676,20154,263,344
64422,228,44,50156,20367,113,115
64423,767,45.7,53295,27618,373,394
64424,4353,38.7,37885,19116,2165,2188
64426,360,49.2,36667,19597,162,198
64427,672,36,53158,22878,315,357
64428,867,33.6,41292,22190,419,448
64429,13218,38.7,42946,17075,8185,5033
64430,659,49.5,48929,22587,318,341
64431,446,52.5,45278,21918,240,206
64432,150,63,39167,14227,50,100
64433,246,20.9,77083,13961,175,71
64434,482,35.6,51339,21180,260,222
64436,779,39.6,74293,25487,367,412
64437,669,52.1,37656,20593,349,320
64438,353,37.9,58839,27996,139,214
64439,1618,38.5,58750,27296,791,827
64440,610,50.3,57344,28127,305,305
64441,106,56.2,52604,18644,49,57
64442,739,41,40833,18609,369,370
64443,1301,35.3,56833,22523,538,763
64444,1682,43.9,67750,27179,771,911
64445,312,40.5,37614,18972,152,160
64446,939,49.2,47125,26011,480,459
64448,1088,49.5,72500,29385,521,567
64449,493,39.2,57813,28695,275,218
64451,460,46.5,45375,31629,219,241
64453,160,55.1,38291,20925,104,56
64454,2664,38.8,61507,26127,1336,1328
64455,315,50.6,43542,25407,170,145
64456,1303,49.7,33359,20851,639,664
64457,187,48.8,52917,24423,102,85
64458,173,58,42708,36269,84,89
64459,380,54.6,41071,26562,202,178
64461,767,39.6,52596,23702,366,401
64463,1597,43.8,43438,21666,849,748
64465,4255,38.4,52729,22848,2153,2102
64466,524,41.5,40500,26939,263,261
64467,171,45.8,14886,15209,97,74
64468,16028,24,31243,16510,8085,7943
64469,2295,38.4,44222,20151,1129,1166
64470,1629,45,44375,23190,768,861
64471,505,41.9,36354,18196,258,247
64473,1458,46.5,48661,23512,744,714
64474,920,36.8,47083,21947,481,439
64475,287,43.1,53750,25870,153,134
64476,377,34.5,49000,18816,184,193
64477,3671,43.6,53260,26073,1827,1844
64479,1270,36.3,48611,21305,554,716
64480,325,57.5,65000,34670,125,200
64481,1187,47.4,36544,18059,603,584
64482,2106,45.3,43992,25412,1020,1086
64483,653,30.7,57237,22452,309,344
64484,1009,39.3,38938,19244,462,547
64485,8052,41.3,46362,22287,4059,3993
64486,599,45.8,48558,29801,301,298
64487,856,44.1,39402,21125,456,400
64489,2056,37.2,42694,19291,1148,908
64490,2239,45.6,50000,25026,1130,1109
64491,1861,47.2,42250,23633,911,950
64492,1752,44.5,53194,24572,956,796
64493,511,46.4,60938,25939,274,237
64494,858,44.5,50962,25289,445,413
64496,122,44.5,37917,19215,77,45
64497,442,41.3,52188,21736,201,241
64498,416,42.5,50313,23856,208,208
64499,99,46.3,49306,24951,51,48
64501,12311,32.1,29257,15832,5912,6399
64503,12902,36.2,44645,19635,6169,6733
64504,10746,37.4,41286,19579,5877,4869
64505,12890,41.1,45996,24162,6410,6480
64506,23744,39.6,53908,28212,12406,11338
64507,15282,30.7,42255,19846,7121,8161
64601,12085,41,39989,20961,5295,6790
64620,556,35.4,50625,18486,262,294
64622,621,36.2,54063,22637,362,259
64623,486,49.9,44773,21443,257,229
64624,1728,40.8,39712,20458,837,891
64625,549,43.7,36250,20795,292,257
64628,5833,43.1,37768,23309,2902,2931
64630,455,49.8,29688,18863,228,227
64631,851,49.9,34688,18311,437,414
64632,553,59.4,33750,20200,261,292
64633,5224,41.4,44050,24938,2406,2818
64635,590,33.5,45500,18400,266,324
64636,328,36.6,40000,15061,135,193
64637,585,47.3,42188,21545,262,323
64638,459,44.6,36406,20195,220,239
64639,257,48.9,57917,25446,111,146
64640,3255,45.5,42956,22880,1647,1608
64641,644,40.6,45865,20127,307,337
64642,1097,40.4,41250,23850,574,523
64643,1318,37.8,39833,17106,697,621
64644,3150,42.4,41953,20950,1480,1670
64645,151,44.9,22143,19195,83,68
64646,329,34.9,39688,18798,181,148
64647,378,46.7,40000,19816,192,186
64648,2272,26.3,38077,15346,1130,1142
64649,665,45.6,54081,26668,329,336
64650,759,40.3,43500,19955,442,317
64651,645,42.3,57847,22166,276,369
64652,542,43.6,33929,17254,253,289
64653,668,40.5,34375,17993,352,316
64654,50,26.5,27143,10776,21,29
64655,254,57.3,48000,26224,117,137
64656,254,45.8,35625,27384,126,128
64657,393,39.5,38250,15916,161,232
64658,3308,45.5,38681,19492,1512,1796
64659,1012,31.6,51389,19841,509,503
64660,537,37.5,40833,19934,309,228
64661,1068,40.6,31250,16129,501,567
64664,399,53.6,47917,21888,205,194
64667,366,49.4,35227,16723,190,176
64668,1460,44,59231,26293,731,729
64670,1003,40.6,44032,19110,560,443
64671,2159,40.5,49559,21231,1158,1001
64672,91,66.6,57969,34638,51,40
64673,2357,43.4,47772,21666,1181,1176
64674,445,47,32188,16950,215,230
64676,302,27.5,43750,14413,160,142
64679,662,43.8,33563,16747,311,351
64681,240,34.3,41250,14185,90,150
64682,247,62.3,27500,26294,153,94
64683,7935,43.7,37845,19946,3793,4142
64686,266,39.8,44375,21770,143,123
64688,626,41.9,42396,24807,275,351
64689,507,42.7,38047,18993,245,262
64701,14807,40,52328,24354,7141,7666
64720,4342,40,45417,21954,2212,2130
64722,462,37.7,33295,18866,192,270
64723,606,39.8,34875,19078,291,315
64724,1860,44.5,33355,19206,889,971
64725,2095,37.4,59792,26082,1012,1083
64726,521,44.5,54250,20900,220,301
64728,665,42.3,40156,21443,330,335
64730,7078,44.3,34383,22228,3359,3719
64733,1225,40.4,49808,23848,625,600
64734,1837,46.8,80329,37546,917,920
64735,13794,44.7,41293,22983,6619,7175
64738,1092,53.2,41932,20869,601,491
64739,916,44.5,48618,22775,445,471
64740,1625,49.2,29972,18067,828,797
64741,394,46.9,30682,20019,215,179
64742,2306,41.7,45625,24611,1085,1221
64743,267,33.8,51250,21553,125,142
64744,7263,45.1,29788,17291,3591,3672
64745,148,62.3,38750,16331,67,81
64746,1686,42.8,61864,23025,744,942
64747,3959,38.3,49329,21442,2027,1932
64748,1312,43.2,31208,15453,635,677
64750,355,41.9,29125,16757,176,179
64752,686,35.7,43438,15596,353,333
64755,2317,45.9,45766,24690,1147,1170
64756,682,52.4,33575,16725,355,327
64759,8778,38,45781,21039,4348,4430
64761,1523,43.2,41856,21515,721,802
64762,1329,41.8,34432,21086,634,695
64763,1449,51.5,29025,15480,771,678
64765,60,52.5,31250,15085,34,26
64767,380,51.4,53750,22759,194,186
64769,559,46.1,35917,20999,274,285
64770,985,50.8,42614,24008,519,466
64771,694,37.2,42431,19354,316,378
64772,13687,40.6,39693,20235,6498,7189
64776,3707,48.5,29077,16365,1853,1854
64778,594,35.5,36583,27235,273,321
64779,2566,35.8,36500,16678,1266,1300
64780,793,45.2,35179,16722,412,381
64781,145,34.7,20556,9677,59,86
64783,617,45.2,33438,18949,309,308
64784,1814,37.4,34356,16668,956,858
64788,1380,40.4,42721,19533,730,650
64790,847,43.2,31071,16277,380,467
64801,35191,36.2,37262,22225,17718,17473
64804,36502,39.2,42143,25679,17380,19122
64830,710,32.9,50357,21642,386,324
64831,6411,39.1,39181,17775,3074,3337
64832,758,43.6,44250,21606,398,360
64833,102,30.2,23750,13424,66,36
64834,9784,34.9,53544,24067,4429,5355
64835,1777,35.7,32170,14606,882,895
64836,24239,35.6,38727,18751,11637,12602
64840,3142,34.2,44219,21834,1473,1669
64841,304,34,40694,19971,142,162
64842,942,35.4,34514,17194,506,436
64843,3331,34.8,36616,16272,1785,1546
64844,4634,34,36228,16183,2335,2299
64847,563,34.6,26042,10904,318,245
64848,747,29.9,41346,15627,334,413
64849,218,29.7,59375,17758,131,87
64850,23715,38.5,40375,20044,11787,11928
64854,4081,32.9,33333,14218,2023,2058
64855,3027,32.4,63452,23032,1555,1472
64856,3498,42.1,38996,17958,1699,1799
64857,493,33.4,48125,16197,214,279
64858,160,21.3,-666666666,4116,86,74
64859,1127,43.4,37917,19393,563,564
64861,1653,34.5,42083,16305,947,706
64862,2690,39,37722,20189,1346,1344
64863,1703,29.2,31071,18884,920,783
64865,5643,40.8,41688,17744,2579,3064
64866,1543,40.1,38750,14625,869,674
64867,1846,35.4,31889,16170,972,874
64870,14451,31.8,42156,19964,7285,7166
64873,895,46.3,36339,18195,462,433
64874,834,29.9,29716,15151,392,442
65001,316,44.5,56597,26357,161,155
65010,6070,34.9,60467,27749,2836,3234
65011,2380,28.7,45565,15931,1072,1308
65013,3414,39.4,30913,16900,1640,1774
65014,2414,46.1,38222,20587,1314,1100
65016,1628,34,63917,23065,825,803
65017,1580,44.2,42083,19123,756,824
65018,7562,37.9,45645,22486,3606,3956
65020,14474,45.6,41997,21833,7066,7408
65023,1450,44.2,59966,25977,780,670
65024,1058,47.2,51016,26783,530,528
65025,745,39.7,39338,19381,366,379
65026,10672,39.1,31603,17991,5222,5450
65032,1998,38.3,58500,21553,995,1003
65034,629,37.4,47708,14743,271,358
65035,1835,39.3,62331,24724,959,876
65037,4864,56.6,35868,21001,2322,2542
65039,2614,48.6,67481,29797,1406,1208
65040,1463,36.2,68438,23540,697,766
65041,5791,48,39875,23760,2695,3096
65043,10151,36.4,54063,25875,5148,5003
65046,1289,37.1,50469,21407,702,587
65047,1386,46.4,33889,18232,653,733
65048,147,45.3,31458,20748,50,97
65049,6166,51.5,46814,29135,3185,2981
65050,889,21,50938,14128,445,444
65051,5088,38,42204,19673,2661,2427
65052,4048,44.5,51935,24215,2040,2008
65053,1408,44.8,73750,31473,758,650
65054,691,56.5,70561,29829,324,367
65058,1103,42.9,52717,23330,578,525
65059,797,41.8,47188,22790,288,509
65061,762,46.3,38750,19441,397,365
65062,25,-666666666,-666666666,,11,14
65063,3743,35.2,58141,21206,1735,2008
65064,379,60,44569,27488,191,188
65065,6645,49.2,43900,24606,3184,3461
65066,6427,42,44143,20246,3283,3144
65067,471,39.5,51071,22953,257,214
65068,888,34.8,46607,18886,456,432
65069,809,37.3,46979,21704,434,375
65072,1695,54.2,42222,20722,903,792
65074,3037,37.3,57212,20437,1476,1561
65075,951,38.2,61406,25427,466,485
65076,817,38.2,61875,19807,430,387
65077,625,43.6,63080,21792,341,284
65078,3283,46.9,33444,17174,1668,1615
65079,4575,58.8,45575,25174,2316,2259
65080,737,45,54871,29928,392,345
65081,4048,38.1,44583,13712,2574,1474
65082,1211,46.5,40375,19670,645,566
65083,220,36.9,30714,20972,104,116
65084,7388,39.7,32469,15835,3708,3680
65085,1114,43.1,56250,25717,605,509
65101,29610,34.7,47111,23017,15863,13747
65109,39253,40.6,56501,29126,18737,20516
65201,40024,22.6,30468,19716,19424,20600
65202,46268,31.1,48011,23416,22457,23811
65203,55284,33.3,56313,34590,26428,28856
65215,283,19.6,-666666666,2761,31,252
65230,665,47.5,53109,19958,363,302
65231,3003,42.8,41035,21693,1484,1519
65232,219,41.9,55000,24791,122,97
65233,11728,38.3,44920,21634,6392,5336
65236,1418,46.5,33527,19199,746,672
65237,829,48.5,37011,22966,452,377
65239,1237,36.3,49167,20624,623,614
65240,7610,39.5,50988,24347,3852,3758
65243,3176,29.3,55885,16802,1704,1472
65244,297,57,24444,17683,121,176
65246,169,32.3,36250,17364,82,87
65247,857,38.8,32721,17129,400,457
65248,4451,34.7,39211,19612,2164,2287
65250,689,35.7,66875,21552,390,299
65251,21687,36.9,45413,22410,11355,10332
65254,1884,39.7,46061,28174,918,966
65255,3928,38,63352,25712,1852,2076
65256,1635,40.9,62976,27472,788,847
65257,1337,48.3,29348,18368,753,584
65258,492,34.5,53281,20541,258,234
65259,2773,41,39200,18296,1430,1343
65260,659,38.3,51016,21021,366,293
65261,1022,50,31528,18832,452,570
65262,844,36.9,44882,20896,493,351
65263,2015,40.9,40721,18646,1012,1003
65264,662,38.7,48750,21706,310,352
65265,15150,40.6,44155,21507,7057,8093
65270,18027,37,35758,16971,9422,8605
65274,1982,46.4,39125,21200,913,1069
65275,2577,45.2,40457,21653,1297,1280
65276,1577,40.9,50625,21424,805,772
65278,111,50.4,54375,20860,66,45
65279,1500,56,79659,50166,779,721
65280,317,35.4,34907,16074,199,118
65281,3046,45.3,41133,20469,1490,1556
65282,181,56.8,49271,20490,77,104
65283,431,55.4,57629,22267,258,173
65284,2210,44.2,62132,29330,1153,1057
65285,898,46.4,54236,22700,514,384
65286,121,59.4,38333,16062,57,64
65287,419,30.8,70250,60455,172,247
65301,34227,37.6,37362,20059,16515,17712
65305,3832,21.4,44355,15995,2266,1566
65320,37,71.2,48750,27489,15,22
65321,497,44.1,49444,23302,278,219
65322,585,43.6,69688,33120,296,289
65323,921,46.5,42167,18766,469,452
65324,1575,57.3,36411,22481,869,706
65325,3489,42.7,36612,18182,1798,1691
65326,1778,50.2,39412,23520,964,814
65327,242,40.5,45179,17826,128,114
65329,464,59.5,44063,20556,232,232
65330,426,41.8,31500,16906,240,186
65332,1656,40.3,40511,18929,811,845
65333,661,43.9,51029,21729,364,297
65334,894,36.9,51094,20319,434,460
65335,108,53,31250,18957,66,42
65336,5707,27.9,46506,21206,2966,2741
65337,2035,32.6,43317,16916,1098,937
65338,2827,50,31056,17661,1365,1462
65339,690,47.3,48214,20414,312,378
65340,15928,34.4,38659,18474,7831,8097
65344,317,53.2,43281,18192,114,203
65345,748,19.4,21607,8496,420,328
65347,842,50.4,44554,22747,440,402
65348,1499,37.4,45288,20576,705,794
65349,2391,47.1,39583,19718,1229,1162
65350,1629,43.1,40833,18771,798,831
65351,2417,45.9,39861,20419,1270,1147
65354,531,58.5,29643,21741,308,223
65355,10380,55.2,32934,20487,5221,5159
65360,4449,41.7,35091,21941,2169,2280
65401,32051,30.7,40751,20884,17201,14850
65436,41,52.3,-666666666,9180,20,21
65438,2620,47.3,35568,18321,1409,1211
65439,396,31.4,41944,16683,174,222
65440,374,50.6,46875,23739,220,154
65441,5340,42.8,40790,19695,2598,2742
65443,105,28.5,61250,28685,38,67
65444,934,44.5,37500,22882,440,494
65446,393,48.8,27143,22272,246,147
65449,381,31.4,37548,12560,140,241
65452,3264,34.3,39348,19001,1465,1799
65453,8494,37.3,35580,18176,4332,4162
65456,392,48,51389,26968,257,135
65457,318,20.5,23050,22177,128,190
65459,7749,40.7,50963,22097,4134,3615
65461,99,33.4,41111,17954,53,46
65462,1494,44.7,48603,20226,715,779
65463,865,45.3,48867,22472,480,385
65464,507,57.6,27232,20442,267,240
65466,1535,39.9,31298,19704,690,845
65468,498,37.2,32829,5857,167,331
65470,850,50.2,33188,17383,397,453
65473,16963,20.8,44692,16498,11765,5198
65479,415,25.1,21354,7971,252,163
65483,4862,45.3,37716,20102,2334,2528
65484,201,54.1,71417,29659,78,123
65486,3605,34.3,29321,16016,1820,1785
65501,222,48.3,26688,12626,134,88
65529,213,36.6,66875,15358,96,117
65534,1570,32.4,58973,19847,813,757
65535,1689,36.4,31875,21659,859,830
65536,29673,38.3,38377,19391,14478,15195
65541,98,56.7,79375,24551,34,64
65542,6862,38.7,34951,15136,4040,2822
65543,511,28.4,42202,16938,217,294
65548,5770,40.7,28676,15278,2579,3191
65550,4191,41.3,41287,18162,1933,2258
65552,2117,32.3,50765,22868,1035,1082
65555,1077,52.1,38125,18221,585,492
65556,5834,41.7,41895,22020,2880,2954
65557,92,45.9,66136,18262,34,58
65559,9069,42.7,46015,22732,4438,4631
65560,14536,43.6,36963,18971,7104,7432
65564,376,40.3,12075,9861,249,127
65565,5581,47.2,32035,17008,2651,2930
65566,819,41.2,38375,21839,409,410
65567,1186,49.1,39250,18508,540,646
65570,564,38.1,41000,23865,271,293
65571,1801,45.5,33839,18358,877,924
65580,780,55.2,42188,23490,454,326
65582,1873,50.9,45305,24862,955,918
65583,11002,34.4,61486,26650,5663,5339
65584,9637,29.5,52416,23828,4677,4960
65586,17,-666666666,-666666666,,9,8
65588,2844,39.7,30759,14757,1363,1481
65589,346,23.8,36161,16746,254,92
65590,934,43.2,33550,16292,448,486
65591,1788,32.7,44886,16099,968,820
65601,662,56.7,28194,16653,330,332
65603,249,30.8,38750,14847,155,94
65604,3658,46.8,45511,21258,1857,1801
65605,11360,37.3,34392,16895,5618,5742
65606,3559,42.1,24405,12549,1673,1886
65608,9734,46.7,31572,15762,4746,4988
65609,565,40.8,42917,20528,273,292
65610,5573,44.2,47217,21535,2774,2799
65611,1895,50.2,47143,22286,847,1048
65612,1581,40.9,53021,23077,873,708
65613,16862,35.7,41961,21706,8232,8630
65614,775,36.4,39375,17323,377,398
65616,23468,41.3,42033,23267,11345,12123
65617,2361,27.3,39449,12824,1405,956
65618,240,30.4,25333,12804,70,170
65619,7966,38.1,56044,27024,4113,3853
65620,222,39.2,54514,17873,124,98
65622,8963,42.7,42058,19186,4485,4478
65623,32,38,25625,15253,15,17
65624,1892,55.1,40750,22968,873,1019
65625,8043,43.6,41904,20004,3864,4179
65626,1957,36.7,30972,12319,922,1035
65627,470,54,56771,33344,215,255
65629,584,40.2,39464,16760,295,289
65630,215,59.8,68864,38860,108,107
65631,4787,31.4,55518,22093,2282,2505
65632,2516,39.7,42440,16201,1188,1328
65633,4335,43.6,37679,17635,2264,2071
65634,776,47.1,23615,15729,390,386
65635,656,43.8,53182,19414,346,310
65637,1451,55.6,37951,18828,695,756
65638,404,55.5,26750,14904,188,216
65640,868,37.3,22134,14743,457,411
65641,964,54.9,40060,21143,502,462
65644,2909,35.9,40724,17103,1596,1313
65646,2131,41.4,41125,19676,1094,1037
65647,2454,39.5,31190,17210,1275,1179
65648,6408,39.1,55540,23039,3445,2963
65649,1267,54.1,34167,20729,605,662
65650,1139,57.7,36500,18878,504,635
65652,3485,42.1,47500,20673,1999,1486
65653,5681,47.9,36985,18457,2835,2846
65654,150,52.3,21333,15203,78,72
65655,3494,48.2,30368,14960,1728,1766
65656,5009,47.3,35444,18057,2441,2568
65657,109,46.9,47361,26724,55,54
65658,1668,57,43929,24841,774,894
65660,97,65.3,17431,13312,44,53
65661,2042,57,29018,19940,981,1061
65662,1050,40.6,36250,18262,478,572
65663,2816,36.6,41125,17063,1382,1434
65664,118,48.8,15625,12709,52,66
65667,3502,40.1,32500,14715,1738,1764
65668,1730,61.7,31108,18918,737,993
65669,1988,47.8,41637,22976,928,1060
65672,9078,37.2,34634,18030,4426,4652
65674,2985,45.7,33990,14333,1402,1583
65676,532,57.2,46875,20336,273,259
65679,3545,27.3,37500,16389,1603,1942
65680,1109,48.7,28765,15781,624,485
65681,2363,49.8,43341,23559,1247,1116
65682,2294,43.1,39713,23014,1147,1147
65685,661,45.7,40068,21449,326,335
65686,4409,61,42574,24723,2125,2284
65689,4466,47.8,33377,16778,2080,2386
65690,211,58,29688,14171,91,120
65692,1579,43,31042,17379,807,772
65702,502,48.5,23586,12935,210,292
65704,3347,40.6,32517,17167,1674,1673
65705,4190,39.9,34713,16526,1992,2198
65706,14281,39.5,45052,21468,6883,7398
65707,2163,40,43047,20181,1137,1026
65708,13107,34,39705,19417,6614,6493
65710,1437,34.3,55071,20423,711,726
65711,10178,40.4,29063,15358,4823,5355
65712,8543,45,43116,24192,4354,4189
65713,2445,45.5,41663,20220,1199,1246
65714,29641,37.8,56212,27197,14640,15001
65715,46,36.3,-666666666,25400,20,26
65717,2790,35.6,30152,14607,1488,1302
65720,742,31.4,34545,13540,370,372
65721,29950,35.2,52863,25984,14283,15667
65722,1289,45.1,35804,21661,649,640
65723,4148,39.1,42532,19350,1967,2181
65724,1588,56.8,24438,15224,751,837
65725,2421,34,29792,16745,1133,1288
65727,260,50.2,31500,15112,161,99
65728,59,15.9,-666666666,7807,25,34
65729,337,54.1,67350,32609,197,140
65730,70,56.1,-666666666,63053,30,40
65731,137,59.2,97813,28418,57,80
65732,748,53.3,24257,21055,352,396
65733,653,51.3,33618,16655,304,349
65734,3664,38.1,40711,18429,1744,1920
65735,192,43.8,26458,20327,89,103
65737,8085,49.3,41518,21920,3903,4182
65738,17677,35.2,49780,22308,8177,9500
65739,1312,53.8,43452,20089,526,786
65740,3662,43.5,30111,17456,1825,1837
65742,11918,39.7,52789,26899,6130,5788
65744,170,54.3,41912,19915,71,99
65745,2209,39.4,29500,20612,1101,1108
65746,8616,31.9,39097,15212,4526,4090
57004,3563,39.7,53958,25930,1781,1782
57005,10610,34.6,69690,27832,5216,5394
57006,24816,24,43155,22827,12619,12197
57010,505,45,79625,29787,299,206
57012,971,47.5,56136,28199,462,509
57013,4434,42.7,48958,27944,2325,2109
57014,1537,41.4,48512,24448,781,756
57015,687,47.3,67132,28525,342,345
57016,647,54.6,56591,33318,324,323
57017,1567,34.4,62596,29065,841,726
57018,1498,38.8,63156,26247,725,773
57020,1894,32.8,80855,26026,948,946
57021,395,34.5,81875,28762,226,169
57022,4664,38.1,56081,27352,2273,2391
57024,547,32.4,49306,20164,275,272
57025,2849,40.1,51458,27177,1422,1427
57026,1401,35.5,61830,23642,748,653
57027,128,39.5,49107,19353,81,47
57028,3150,42.1,47217,25896,1514,1636
57029,1849,49.2,42297,25705,928,921
57030,3432,41.8,67500,29738,1710,1722
57031,692,40.7,58854,26223,358,334
57032,6864,28.6,78700,30538,3400,3464
57033,5216,35.2,71189,26168,2563,2653
57034,740,36.8,58281,26894,432,308
57035,1176,47.3,64545,31390,544,632
57036,637,45.7,56406,29601,332,305
57037,1044,41.3,43654,24861,535,509
57038,1592,39.1,73844,45751,765,827
57039,3162,35.3,58298,31427,1484,1678
57040,383,52.3,46736,25907,196,187
57041,48,35.3,-666666666,29840,23,25
57042,9062,36.8,47978,24737,4491,4571
57043,1362,50.4,46406,28925,650,712
57045,1061,51.7,33864,23906,544,517
57046,651,37.1,55417,23256,293,358
57047,308,36.8,53333,25229,143,165
57048,1204,41.5,58036,25139,659,545
57049,5853,39.3,71328,45847,2858,2995
57050,224,47,39722,31346,131,93
57051,257,50.9,42000,30294,133,124
57052,373,46.7,44559,21657,248,125
57053,1965,40.3,53672,24373,1034,931
57054,558,54.3,54375,33602,307,251
57055,1029,44.6,72000,30568,591,438
57057,122,49.5,87000,50790,57,65
57058,2040,43,55236,30387,1027,1013
57059,1325,45.6,42772,26538,546,779
57061,127,21.5,24167,14914,70,57
57062,2325,38.1,34487,15220,1687,638
57063,977,48.5,42708,22071,508,469
57064,5291,28.7,74359,32497,2753,2538
57065,418,47.2,47206,19474,231,187
57066,1606,46.4,43077,24389,829,777
57067,439,46.7,72375,24650,244,195
57068,1343,40.7,71944,33360,671,672
57069,11884,23.7,33648,19234,5838,6046
57070,1466,50.1,41250,23008,672,794
57071,2922,34.6,58056,24905,1511,1411
57072,710,44.2,57109,31945,308,402
57073,841,53.5,46563,30040,399,442
57075,791,52.9,49375,39309,445,346
57076,300,48.5,49500,49475,171,129
57077,1252,32.6,69907,24769,602,650
57078,18894,40.7,50660,27293,9996,8898
57103,34784,36.6,52229,27631,17741,17043
57104,26246,32.2,35827,18743,14160,12086
57105,21984,38.2,52255,30000,10644,11340
57106,41258,32.2,56104,27152,20371,20887
57107,8174,32,55141,24528,3868,4306
57108,17846,36.5,86182,43299,8696,9150
57110,13395,35,68940,28506,6533,6862
57117,55,74.5,-666666666,35975,55,0
57197,713,19.9,-666666666,3979,246,467
57201,24982,37.5,46681,25697,12390,12592
57212,1816,50.1,47083,25625,908,908
57213,431,41.1,49625,26480,201,230
57214,55,61.5,53125,28036,26,29
57216,1018,48.9,59917,28543,522,496
57217,288,40.3,50250,22876,150,138
57218,327,55.7,72933,32754,177,150
57219,727,50.1,57574,22913,363,364
57220,764,30,55543,21914,380,384
57221,829,36.6,52109,29231,414,415
57223,1311,43.1,59219,25862,708,603
57224,202,30.7,51250,23735,108,94
57225,1645,49.2,49236,33353,754,891
57226,2233,42.7,54974,24159,1150,1083
57227,315,53.4,62188,31530,169,146
57231,1744,46.3,51205,29483,852,892
57232,266,57.2,56875,31259,122,144
57233,126,42.5,47321,21873,61,65
57234,1271,37.3,52353,24700,626,645
57235,1064,34.3,60000,22597,590,474
57236,65,48.3,97750,28603,33,32
57237,475,55.9,35804,45456,237,238
57238,416,38.4,56477,25036,215,201
57239,257,65,82857,31437,146,111
57241,1003,23.1,49943,19908,542,461
57242,263,37.9,82031,38285,161,102
57243,696,45.2,53500,25173,346,350
57245,109,36.2,87083,30335,52,57
57246,164,42,73125,35193,94,70
57247,229,63.2,75714,39947,119,110
57248,1374,33.9,57750,27829,618,756
57249,923,47.8,54911,27278,473,450
57251,181,30.6,42500,19104,116,65
57252,4580,47.2,46313,23786,2270,2310
57255,440,44.1,39750,34864,232,208
57256,91,50.9,50000,36027,51,40
57257,928,34.4,45357,15071,417,511
57258,370,50,37500,15459,188,182
57259,485,45.1,57500,26812,281,204
57260,1205,44.5,60789,24330,632,573
57261,231,63.4,40167,28453,119,112
57262,5430,34.3,39738,19945,2641,2789
57263,368,51.5,43438,26063,211,157
57264,262,38.5,41875,23664,163,99
57265,211,48.3,34286,19006,133,78
57266,682,30.1,47500,19456,363,319
57268,496,36,37125,19409,274,222
57269,527,34,53393,24346,224,303
57270,771,31,31042,23100,445,326
57271,311,34.6,42368,17831,177,134
57272,144,50.5,39375,29476,81,63
57273,1192,41.8,35357,16802,612,580
57274,2759,47.3,39338,22982,1342,1417
57276,1243,35.4,55417,22589,659,584
57278,933,32.1,44808,19641,499,434
57279,1034,48,43250,27971,555,479
57301,18239,38.1,47962,24771,9217,9022
57311,1530,39.4,52308,22223,748,782
57312,441,35.9,37125,30557,218,223
57313,1196,48.2,46250,24737,610,586
57314,849,43.9,54375,27279,463,386
57315,1141,40.3,44813,21359,632,509
57317,615,44.1,36538,20397,331,284
57319,1202,39.7,50117,19022,540,662
57321,357,46.8,47813,21436,181,176
57322,320,56.8,64167,30288,174,146
57323,201,61.4,35313,28165,96,105
57324,407,37.5,65893,25746,185,222
57325,3534,36.7,46776,21580,1662,1872
57328,1130,47.6,54688,27759,527,603
57329,453,32.5,39000,17077,235,218
57330,740,48.6,44732,22218,377,363
57331,627,40.5,65962,30722,327,300
57332,772,29.9,58250,26804,416,356
57334,789,43.4,49479,23102,392,397
57335,297,49.7,34500,19368,156,141
57337,85,67.9,55417,36554,45,40
57339,1430,23.4,30645,10319,755,675
57340,333,40,57589,23163,157,176
57341,168,31.6,32159,18471,79,89
57342,509,41.1,45556,29596,267,242
57344,136,64.3,68750,36374,83,53
57345,1268,45.3,48438,26072,583,685
57346,18,30.5,59167,23733,10,8
57348,523,53.7,59091,33081,269,254
57349,1631,39.9,49500,28431,817,814
57350,14899,38.6,41130,23467,7349,7550
57353,807,39.8,53375,26340,392,415
57355,1030,48.5,41399,23538,526,504
57356,1915,26.1,31296,13874,924,991
57358,50,38,57679,13876,23,27
57359,625,46.1,38542,27575,351,274
57361,118,51.3,15833,11712,71,47
57362,2258,47.1,42736,24949,1160,1098
57363,1122,35.1,56522,23218,562,560
57364,73,25.5,45294,11655,25,48
57365,580,47,55250,26072,312,268
57366,2425,37.7,43672,30536,1158,1267
57367,191,46.3,64375,29461,103,88
57368,1224,39.3,50192,23936,601,623
57369,2344,47.7,46196,23758,1086,1258
57370,859,39.9,44583,20329,442,417
57371,117,75,24554,26563,54,63
57373,492,55.5,66750,28996,263,229
57374,243,47.2,38393,16767,112,131
57375,659,45,49375,25651,335,324
57376,919,53.5,38646,23988,461,458
57379,54,48.5,26667,25293,23,31
57380,3555,36,33818,16537,1783,1772
57381,574,45.4,35625,23118,326,248
57382,1492,49.2,50031,25927,718,774
57383,770,45.7,36154,20860,398,372
57384,886,38.4,49286,30539,472,414
57385,1166,51.1,46622,24998,617,549
57386,154,51.3,72031,33197,79,75
57401,30402,37.8,50577,26788,14634,15768
57420,121,57.1,29875,17091,52,69
57421,57,48.2,19750,16596,39,18
57422,261,36,37569,24159,148,113
57424,324,44.1,62500,28151,183,141
57426,63,53.6,57083,19938,33,30
57427,629,36.6,70143,24740,317,312
57428,753,49.4,56667,25925,369,384
57429,109,36.1,40000,20763,42,67
57430,2303,44.2,50270,26840,1135,1168
57432,579,45.5,65625,26478,319,260
57433,457,34.8,43750,29456,249,208
57434,549,49.7,41111,28308,319,230
57435,262,50,38333,23158,142,120
57436,447,49.9,54219,36567,243,204
57437,1220,56.3,38567,24902,569,651
57438,1346,47.5,40888,26709,709,637
57439,60,-666666666,-666666666,,32,28
57440,492,40.6,53750,21523,268,224
57441,755,44.2,48365,22411,418,337
57442,1702,50.5,48108,27539,813,889
57445,2185,39.7,62109,30510,1107,1078
57446,344,65.2,38750,25736,155,189
57448,410,46.8,40179,25228,205,205
57449,100,61.1,31818,40935,60,40
57450,684,51.5,43125,27532,323,361
57451,2265,48,52852,28141,1202,1063
57452,261,50.8,32292,21961,116,145
57454,590,48.8,46250,22336,312,278
57455,64,56.6,36000,24711,35,29
57456,876,42.6,35385,21712,469,407
57457,74,50,46250,18030,40,34
57460,364,40.7,56875,29777,214,150
57461,435,40.5,55714,36883,242,193
57465,412,34.4,57917,30248,196,216
57466,112,47.3,41875,25734,65,47
57467,280,49.6,53500,26395,151,129
57468,202,48.9,50750,39030,98,104
57469,3345,44.5,40025,22869,1616,1729
57470,208,14.8,51111,8729,102,106
57471,670,46,44000,25946,330,340
57472,1055,48.5,46442,23101,551,504
57473,295,28,42566,12848,91,204
57474,176,41.7,54688,31064,86,90
57475,91,49.5,26000,20787,57,34
57476,436,42.2,53229,47168,220,216
57477,132,43.1,60938,30702,74,58
57479,685,42.9,82656,30436,339,346
57481,621,43.9,47500,16236,395,226
57501,16302,40.3,60096,31013,8015,8287
57520,201,50.1,48750,28151,106,95
57521,201,32.9,46307,30285,113,88
57522,480,42.2,56667,24398,227,253
57523,1222,45.7,39073,26279,620,602
57528,893,37.1,42244,21497,468,425
57529,490,47.4,44792,26557,261,229
57531,291,51.3,51250,25653,131,160
57532,2802,38.5,56125,31060,1416,1386
57533,1802,50.6,34000,22135,918,884
57534,111,61.7,43750,24860,59,52
57536,677,41.3,31691,17225,324,353
57537,146,61.2,54423,31402,67,79
57538,239,50.7,30625,19113,125,114
57540,101,42.8,40000,28168,54,47
57541,65,52.8,12188,8438,34,31
57543,1030,48,47386,24317,516,514
57544,514,31.2,39676,23901,291,223
57547,231,38.8,85385,36025,130,101
57548,1428,23.9,37955,11794,752,676
57551,2009,36.7,41364,22182,952,1057
57552,489,53.5,42404,28827,247,242
57553,338,33.4,69044,22759,187,151
57555,3467,27.3,36731,13950,1738,1729
57559,615,45.1,37386,20634,329,286
57560,339,24.6,17344,11175,168,171
57562,52,29.9,77188,49794,17,35
57563,219,27.8,22000,6837,75,144
57564,982,44.5,59500,29940,550,432
57566,1462,18.5,27740,7801,743,719
57567,1191,50,45234,24232,571,620
57568,647,45.2,51700,28055,322,325
57569,368,43.5,71250,26456,177,191
57570,2230,21.1,25278,8982,1082,1148
57571,25,54.6,9432,14140,6,19
57572,2104,20.6,27738,7214,1063,1041
57574,76,56.4,41429,21787,40,36
57576,123,62.1,47583,24386,71,52
57577,966,23.6,45077,16435,462,504
57579,1409,32.9,33167,15609,693,716
57580,4203,45.1,38493,23687,2160,2043
57584,50,57.6,37750,34468,24,26
57585,296,43.6,51750,21195,144,152
57601,3933,44.6,40737,25551,1902,2031
57620,473,54.9,46250,28019,235,238
57621,452,23,12857,5017,219,233
57622,246,28.5,9792,4530,131,115
57623,1139,28,44773,16569,539,600
57625,4368,25.2,27813,12209,2114,2254
57626,914,38.4,45987,20090,471,443
57630,46,57.7,29167,19667,24,22
57631,320,51.1,60938,26903,158,162
57632,636,50.5,33594,23431,307,329
57633,537,41.8,54792,18787,272,265
57634,76,41.2,45938,94766,38,38
57636,50,42.8,27750,25488,29,21
57638,1929,49.5,35625,24064,964,965
57639,377,24,20000,6590,194,183
57640,200,50.9,50385,24975,115,85
57641,322,47.7,42000,18481,161,161
57642,2016,26.7,30882,11790,995,1021
57644,187,44.4,49583,27604,98,89
57645,206,35,36250,22976,130,76
57646,238,50,36607,23230,110,128
57648,267,60.6,31012,23791,121,146
57649,271,42.6,56389,30024,136,135
57650,77,61.3,36875,19712,40,37
57651,151,28.1,55000,17563,60,91
57652,386,24.2,22679,14344,185,201
57656,673,39.9,54500,25730,347,326
57657,202,50.7,69531,34202,105,97
57658,329,33.5,15833,7979,183,146
57660,70,53,33333,17630,38,32
57661,118,19.7,31635,18369,64,54
57701,43679,33.5,39611,21076,21864,21815
57702,33336,44.2,67817,37204,16315,17021
57703,14417,34,57368,24213,7300,7117
57706,2640,22.6,38819,17921,1731,909
57714,1077,18.7,23723,4872,532,545
57716,445,30.5,45750,22540,188,257
57717,7574,39.3,41997,22390,3841,3733
57718,7069,35.9,59143,26442,3657,3412
57719,7134,30.4,47892,21554,3807,3327
57720,593,40.2,44286,24134,298,295
57722,491,47.5,91094,35830,289,202
57724,261,27.9,36250,22062,175,86
57725,110,66.6,57841,21549,57,53
57730,5707,52.7,44183,25812,2805,2902
57732,2260,49.7,49375,28851,1198,1062
57735,1483,54.6,33311,26980,763,720
57738,91,29.3,34205,20633,54,37
57741,75,61.9,-666666666,33256,45,30
57744,1847,43.5,64688,30086,943,904
57745,2188,48.4,54432,24629,1083,1105
57747,5426,51.3,40645,23230,2719,2707
57748,325,33.7,31071,13459,184,141
57750,556,24.8,34861,11415,296,260
57751,767,49,49274,28145,366,401
57752,1840,25.7,26331,9304,909,931
57754,3543,46.3,41535,21715,1752,1791
57755,101,51.4,50417,22717,51,50
57756,1387,20.6,21667,4536,638,749
57758,215,34.9,24327,15813,137,78
57759,780,22.5,80679,20968,504,276
57760,1585,44.9,45250,19294,685,900
57761,1061,46.3,59063,30499,550,511
57762,591,47.1,38324,23223,302,289
57763,331,43.7,49643,25444,140,191
57764,1706,23.3,24779,8851,683,1023
57766,222,65.2,25395,29210,137,85
57767,143,42.2,46786,24599,65,78
57769,3501,39.3,62132,27753,1693,1808
57770,5634,22.8,28663,9681,2723,2911
57772,1833,25.7,22400,8698,1071,762
57773,377,39.1,62292,32716,195,182
57775,352,32.8,46413,21024,200,152
57776,0,-666666666,-666666666,-666666666,0,0
57779,300,34.6,43636,20064,169,131
57780,120,51.3,85625,33305,63,57
57782,60,66.1,22375,18022,28,32
57783,14349,39.2,42565,29412,7080,7269
57785,9276,45.9,38638,24036,4479,4797
57787,364,36.6,29858,22433,184,180
57788,635,29.7,31486,19387,324,311
57790,1234,36.4,48550,26162,652,582
57791,177,50.4,36250,30146,91,86
57792,58,48.8,61500,34886,27,31
57793,2122,42.1,57663,39895,987,1135
57794,1095,26,13693,4009,568,527
57799,559,19.5,-666666666,7590,240,319
58001,92,45.4,82500,37849,47,45
58002,18,-666666666,-666666666,,9,9
58004,256,42.4,67344,27932,146,110
58005,640,37.5,86705,36930,329,311
58006,466,43.9,54821,33539,208,258
58007,58,58.1,62969,51645,31,27
58008,285,46.1,64531,33187,148,137
58009,14,-666666666,-666666666,,6,8
58011,354,50.6,56667,47440,179,175
58012,2565,35.3,68889,28416,1311,1254
58013,113,51.4,46705,51323,65,48
58015,310,45.8,73125,36044,181,129
58016,151,45.2,58750,29129,96,55
58017,376,47.9,39063,22342,200,176
58018,296,46.1,63125,36820,193,103
58021,438,31.3,62614,27468,226,212
58027,1135,53,44395,32452,582,553
58029,201,32.4,73250,21787,124,77
58030,575,41.8,53750,27623,290,285
58031,374,47.7,51250,32528,191,183
58032,760,44.3,53269,29611,395,365
58033,478,48.9,62663,22397,238,240
58035,155,54.4,32391,27563,69,86
58036,288,53.5,69583,30194,138,150
58038,326,46.3,76389,30846,172,154
58040,873,40,61375,27711,449,424
58041,1662,46.3,53542,29363,810,852
58042,1506,39.7,84432,32505,735,771
58043,160,55.9,58438,52893,81,79
58045,2453,38.8,46202,27869,1215,1238
58046,590,44.3,57813,33790,301,289
58047,3755,35.2,85571,43550,2071,1684
58048,602,33.3,66250,30565,303,299
58049,278,52.3,39750,23969,126,152
58051,1313,38.5,79211,49076,662,651
58052,668,37.6,66944,29432,349,319
58053,1361,48.3,43447,22717,676,685
58054,3134,42.7,50978,26059,1578,1556
58056,189,52.4,80962,35222,109,80
58057,134,44.8,85833,37903,73,61
58058,125,48.4,47250,26308,70,55
58059,1117,36.5,67500,30317,607,510
58060,1315,40.7,53646,26743,708,607
58061,380,37.4,65227,29681,188,192
58062,178,53.5,40313,26887,94,84
58063,339,45.1,41250,23226,181,158
58064,476,36.6,63523,29011,252,224
58065,40,61.4,36563,30870,23,17
58067,235,51.3,53500,32125,120,115
58068,401,48.3,51500,20342,200,201
58069,116,49.6,48750,33113,64,52
58071,426,40.4,53194,28543,215,211
58072,7924,42.6,48484,32411,3899,4025
58075,9028,35.9,51179,27588,4647,4381
58076,325,19.9,-666666666,5091,242,83
58077,674,43.6,63482,32553,353,321
58078,27479,33.6,68917,31144,14148,13331
58079,450,51.2,73875,47223,246,204
58081,871,41,53250,26506,449,422
58102,31210,31.1,41737,27744,16565,14645
58103,47859,31,41479,27721,23709,24150
58104,29892,30.6,65445,36160,13993,15899
58105,1895,19.1,-666666666,4080,1164,731
58201,35843,34.6,48390,31745,17526,18317
58202,1845,19.3,-666666666,5766,1110,735
58203,17798,24.4,35078,20075,9753,8045
58204,2045,22,46188,16683,1117,928
58205,387,21.9,-666666666,20378,322,65
58210,306,51.5,60156,33195,157,149
58212,525,52.6,58125,30994,277,248
58214,282,46.4,58750,33189,138,144
58216,85,60.1,46667,32974,49,36
58218,656,40.6,73500,28162,352,304
58219,29,46.8,41563,36628,21,8
58220,2381,46.6,49565,26812,1207,1174
58222,384,42.7,47303,24391,224,160
58223,231,50.4,72625,34790,111,120
58224,24,36.5,-666666666,33967,19,5
58225,985,48,54563,30502,483,502
58227,433,54.5,58542,41167,230,203
58228,856,39.5,58750,30477,474,382
58229,205,42.5,47026,35007,101,104
58230,625,41,48068,28161,317,308
58231,616,46.3,48958,24507,331,285
58233,213,47.3,71750,42341,111,102
58235,416,40.2,44531,24455,206,210
58237,5485,44.5,47737,26651,2678,2807
58238,162,57.3,43333,65425,59,103
58239,23,54.1,42083,75970,19,4
58240,1306,49.4,44103,23847,655,651
58241,89,59.1,44583,44753,54,35
58243,693,35.5,49635,24306,377,316
58244,196,41.3,60795,27584,116,80
58249,2611,47.6,57292,30223,1326,1285
58250,254,48,42031,47144,150,104
58251,2328,43.1,56292,24976,1158,1170
58254,478,55.8,38462,21984,218,260
58256,849,39.3,70357,31365,442,407
58257,1969,39.5,44792,26615,983,986
58258,243,45.6,63750,28883,149,94
58259,384,54.1,48295,31803,206,178
58260,172,57.6,60313,39122,86,86
58261,1119,41.4,59432,26503,547,572
58262,115,62.9,30682,21128,46,69
58265,484,52.7,49271,26788,230,254
58266,268,59.5,58393,31888,136,132
58267,1345,43.6,50833,25549,631,714
58269,160,63.5,50568,34206,75,85
58270,1987,51.3,41023,30457,969,1018
58271,720,44.6,61563,30083,385,335
58272,375,37.5,50795,32141,210,165
58273,167,47.2,41136,28513,113,54
58274,1118,44.4,60795,28110,583,535
58275,810,41.4,55682,26441,397,413
58276,520,44.7,54583,24997,271,249
58277,249,53.6,48750,26891,128,121
58278,1829,43.8,83750,37338,931,898
58281,99,43.9,39118,20721,33,66
58282,1472,47.3,36474,23204,760,712
58301,9772,41.6,47705,26422,4951,4821
58311,76,45.4,59375,17512,34,42
58316,6726,27.2,30287,13161,3366,3360
58317,240,53.5,61250,34113,118,122
58318,3673,47.3,50625,32219,1837,1836
58321,227,47.2,45833,28853,102,125
58323,31,66.6,88194,65042,20,11
68638,1746,47.5,41538,24534,885,861
68640,1592,43.2,51806,22168,787,805
68641,1100,45.2,55278,33997,559,541
68642,1744,35.8,58529,25260,898,846
68643,931,46,53365,31545,478,453
68644,893,45.4,56731,23911,482,411
68647,557,42.7,36250,18907,297,260
68648,438,50.4,68750,28897,244,194
68649,1962,38.3,56205,27691,945,1017
68651,1467,46.6,54350,26301,717,750
68652,825,44.6,52500,34489,465,360
68653,1020,29.8,70852,20902,582,438
68654,471,50.5,46250,30518,230,241
68655,107,46.1,47083,32049,66,41
68658,758,47,58438,29270,398,360
68659,156,47.7,71667,28723,72,84
68660,1196,49.2,41875,23633,592,604
68661,7074,31.4,51341,20125,3619,3455
68662,1119,45.6,51184,28375,520,599
68663,607,49.6,40682,25597,323,284
68664,338,38.9,51667,24284,142,196
68665,896,49.6,54063,31188,422,474
68666,1720,42.3,54268,26727,848,872
68667,152,70.1,85270,30034,71,81
68669,400,44.7,57917,30161,214,186
68701,30292,36.2,46546,24817,14895,15397
68710,689,42.7,46042,24326,329,360
68711,258,52.8,55536,26073,161,97
68713,2112,40.7,47941,23074,1013,1099
68714,1217,48.2,48661,25144,586,631
68715,1336,41.1,57109,27007,678,658
68716,878,53,45417,24187,429,449
68717,197,49.6,61250,30636,95,102
68718,1879,52.6,41190,30891,918,961
68719,89,56.9,46750,60192,49,40
68720,335,49.7,43438,31566,192,143
68722,584,52.7,42813,19957,283,301
68723,513,51.2,59000,25617,256,257
68724,157,47.5,46875,16998,85,72
68725,452,57,38125,25575,207,245
68726,850,45.4,41726,22499,432,418
68727,848,49.7,39821,23280,414,434
68728,251,43.8,47917,20756,129,122
68729,1995,38.6,45417,23571,1006,989
68730,1868,44.5,50743,26285,963,905
68731,2764,39.2,57813,23871,1400,1364
68732,234,52.5,53333,24965,119,115
68733,1289,41.7,51250,27848,632,657
68734,156,30.6,67656,28783,68,88
68735,1020,38.8,38681,20843,534,486
68736,667,38.8,55104,35763,313,354
68739,2744,45.8,48750,23914,1377,1367
68740,661,46.5,51667,27058,381,280
68741,853,41.2,55833,25114,416,437
68742,173,39.6,28594,15760,60,113
68743,659,44.4,68594,29252,304,355
68745,1853,34.7,54063,28034,949,904
68746,487,43.8,38000,20634,264,223
68747,132,34.6,65625,32583,70,62
68748,3563,36.7,55327,21307,1820,1743
68749,31,56.2,26250,16716,16,15
68751,106,36.7,58750,20834,54,52
68752,835,35.3,51250,21880,402,433
68753,50,62.7,30000,25334,26,24
68755,303,47.4,57500,26395,156,147
68756,2003,48,43750,25381,996,1007
68757,743,45.1,45625,26477,392,351
68758,961,54.5,42283,23865,474,487
68759,234,54.3,33333,21479,117,117
68760,1423,40.4,29605,15896,709,714
68761,452,45.5,38417,23642,213,239
68763,4977,47.6,42270,24673,2446,2531
68764,702,44.7,46389,23436,334,368
68765,1426,39.5,56250,25668,787,639
68766,428,49.6,28333,20275,216,212
68767,3296,41,59053,25556,1692,1604
68768,688,45.1,54583,22057,350,338
68769,1585,49.7,39911,23031,739,846
68770,1585,40.6,59107,28034,774,811
68771,1459,45.6,45577,24857,736,723
68773,180,39.6,53750,23551,80,100
68774,343,52.8,19464,24075,200,143
68776,15206,30.4,43227,17851,7508,7698
68777,678,54.4,40491,22941,333,345
68778,499,52.6,34091,22689,235,264
68779,2687,40.3,48675,22076,1299,1388
68780,1045,43,61094,26748,532,513
68781,1562,35.6,45417,26567,800,762
68783,933,54.6,41602,27089,469,464
68784,2309,37.2,43750,20913,1206,1103
68785,196,44,46094,32914,108,88
68786,1014,45.1,48313,28050,471,543
68787,6736,25.6,49167,24289,3336,3400
68788,5116,42.6,47344,23878,2545,2571
68789,152,39.3,61250,20374,74,78
68790,845,36.5,51696,21125,419,426
68791,1794,36.7,45435,26485,870,924
68792,342,50.4,39000,20121,153,189
68801,30923,33.4,45136,20094,15748,15175
68803,22312,39.4,53164,27198,10664,11648
68810,1322,35.2,46324,17738,730,592
68812,769,43,62813,26930,383,386
68813,563,45.4,46250,28129,298,265
68814,1000,46.8,48009,21682,486,514
68815,654,40.7,50278,22599,327,327
68816,144,42,55625,19131,70,74
68817,289,52,30568,21667,152,137
68818,5289,40,56583,25567,2681,2608
68820,398,54.6,40938,22731,217,181
68821,75,56.9,14375,20251,40,35
68822,4609,38.4,42219,23012,2210,2399
68823,2260,50.4,42436,22499,1132,1128
68824,1251,42,62778,23957,616,635
68825,1061,47,50179,23318,523,538
68826,3965,40.3,51523,25212,1956,2009
68827,700,52.3,50417,24935,334,366
68828,214,43.5,27125,17963,98,116
68831,745,48.3,54677,27213,404,341
68832,2005,39.8,68194,28452,1001,1004
68833,446,40.8,50063,20682,232,214
68834,354,26.7,46667,29373,180,174
68835,426,42.8,36250,21976,215,211
68836,1640,36.2,54519,25915,847,793
68837,53,74.6,29583,23155,18,35
68838,241,51.9,39625,26282,130,111
68840,2847,37.2,50714,21056,1426,1421
68841,690,39.7,60469,28547,372,318
68842,653,45.8,36806,21411,332,321
68843,734,44.8,56354,26300,348,386
68844,265,49.3,63750,31085,138,127
68845,21039,26.5,53642,25486,10386,10653
68846,362,48.8,41000,23224,192,170
68847,16312,35.3,48949,25163,8115,8197
68849,314,19.6,-666666666,3717,117,197
68850,12077,30.3,42099,16289,6140,5937
68852,712,43,48750,24268,376,336
68853,1496,54.1,41510,27223,715,781
68854,943,46,50255,23762,448,495
68855,467,33.1,46875,21211,235,232
68856,547,42.4,47083,25877,256,291
68858,268,36.3,31250,18869,139,129
68859,523,42,41346,19093,258,265
68860,244,55.5,29107,20584,116,128
68861,61,44.8,47500,25130,39,22
68862,2949,49.4,40543,24763,1438,1511
68863,1262,33.9,47361,19430,650,612
68864,1295,42.5,45927,19963,647,648
68865,829,49.6,74583,35432,368,461
68866,900,42.2,56806,25710,407,493
68869,2110,44.1,43646,22759,1038,1072
68870,356,43.1,54432,32942,182,174
68871,264,29.3,45500,17369,118,146
68872,910,36.9,61625,25967,496,414
68873,3329,39.5,49455,29149,1620,1709
68874,1027,48.6,45156,22244,551,476
68875,698,37.1,44688,18133,365,333
68876,1454,42.5,55859,23026,690,764
68878,447,40.3,41528,23491,237,210
68879,413,41.3,34808,17929,229,184
68881,98,42,41042,18960,45,53
68882,512,43.8,47250,18659,277,235
68883,2337,43.4,62045,28250,1193,1144
68901,26199,36.9,45430,24842,13067,13132
68920,1293,55.1,39659,26331,668,625
68922,1184,47.3,39583,23622,551,633
68923,107,43.8,50000,25934,50,57
68924,1113,44.8,52273,24303,551,562
68925,644,29.4,64167,24572,332,312
68926,910,48,30893,17125,432,478
68927,1291,39.6,50000,23297,658,633
68928,544,41.4,53125,23248,278,266
68929,177,46.3,63125,21279,73,104
68930,1430,44.7,44643,22939,644,786
68932,340,58.6,28542,17957,162,178
68933,969,46.8,50750,26495,481,488
68934,65,57.3,40313,47849,41,24
68935,946,35.5,32981,16992,482,464
68936,235,20.9,38125,13160,123,112
68937,1781,47.2,44545,25746,847,934
68938,482,39.8,41875,21098,264,218
68939,1286,47.5,40428,21074,665,621
68940,532,40.7,73333,29587,304,228
68941,868,41.3,48813,24575,379,489
68942,411,57.8,34107,21529,200,211
68943,269,49.8,41875,17249,128,141
68944,1134,45.6,46438,20706,585,549
68945,394,35.4,61594,30214,189,205
68946,120,57,72661,27687,65,55
68947,622,45.5,56250,33158,320,302
68948,261,38.1,50375,24682,132,129
68949,6464,45,45240,26991,3119,3345
68950,323,47.4,55192,29632,182,141
68952,94,49.8,31875,20545,50,44
68954,157,28.8,53750,16824,86,71
68955,1987,37.5,72692,28417,992,995
68956,1289,44.5,65625,30442,689,600
68957,598,43.6,62589,23709,305,293
68958,633,40.6,68977,30723,333,300
68959,3753,40.5,56213,29284,1831,1922
68960,216,36.6,49583,35727,102,114
68961,835,54.8,34881,22243,391,444
68964,95,55.8,45625,31639,49,46
68966,758,41.6,46905,20372,360,398
68967,1300,47.2,44485,26237,674,626
68969,36,57.1,80278,25581,18,18
68970,1426,50.7,34010,21202,685,741
68971,494,54.1,49107,28722,266,228
68972,251,52.9,41429,31333,127,124
68973,394,46,55125,26690,201,193
68974,146,49.8,25417,27486,88,58
68975,120,29.5,47333,25284,70,50
68976,198,47.1,63125,29961,94,104
68977,330,51.3,45556,22491,161,169
68978,2159,52.3,36198,24603,986,1173
68979,2049,40.5,54044,25250,1070,979
68980,449,35.6,60455,33355,241,208
68981,248,48.6,55417,30732,113,135
68982,654,45.7,54500,27517,347,307
69001,9142,40.9,41549,22816,4598,4544
69020,392,50.6,49375,29383,204,188
69021,1466,47,48750,27751,704,762
69022,1575,45,44688,26277,789,786
69023,433,44.8,76250,52809,237,196
69024,1350,48.5,52411,27965,668,682
69025,1082,38.3,43750,24906,529,553
69026,182,60,31250,19572,85,97
69027,93,63.9,72857,30353,54,39
69028,844,49.2,63077,27249,425,419
69029,378,48.5,47500,22277,187,191
69030,302,43.3,38398,23905,175,127
69032,466,50.9,45000,24380,245,221
69033,2521,44.5,47807,28141,1167,1354
69034,1140,42.3,49423,21615,509,631
69036,42,59.5,26875,31683,25,17
69037,46,67.6,27250,40435,27,19
69038,524,45.8,48750,22757,292,232
69039,65,42.9,42500,15352,27,38
69040,774,46.1,40560,21497,415,359
69041,115,53.3,39833,46462,65,50
69042,63,40.2,43750,20589,30,33
69043,446,49,31607,23479,222,224
69044,748,50.3,31607,19357,375,373
69045,1178,41.9,38967,18328,604,574
69046,156,56,41250,23267,83,73
69101,29745,38.4,45156,25867,14731,15014
69120,1025,47.9,46875,35567,557,468
69121,479,37.3,40455,17050,235,244
69122,729,47,45208,28540,390,339
69123,919,37.6,52857,25842,394,525
69125,409,41.5,37125,21555,228,181
69127,993,49.6,45500,25082,504,489
69128,322,55.7,57411,29381,153,169
69129,1265,49.1,42500,26177,637,628
69130,5411,41.6,46899,21825,2568,2843
69131,512,43.5,54688,29099,258,254
69132,162,37.5,60357,22676,71,91
69133,430,37.3,41691,29231,221,209
69134,353,35.9,61591,37064,182,171
69135,67,28.4,26620,16528,20,47
69138,4313,42.4,54091,26045,2258,2055
69140,1839,45.3,54925,27427,917,922
69141,308,52.5,52321,28660,161,147
69142,93,58.9,61563,40981,50,43
69143,1354,41.1,74844,36606,703,651
69144,208,42.7,48854,16846,91,117
69145,3143,45.9,41734,23347,1599,1544
69146,304,69.4,29917,24746,170,134
69147,628,62.1,31100,27142,298,330
69148,141,58.6,41375,56826,62,79
69149,704,40.8,57109,34221,399,305
69150,555,46.3,65938,24589,256,299
69151,838,46.3,53750,24609,433,405
69152,843,50.8,40871,21995,432,411
69153,5499,48.1,41853,25582,2667,2832
69154,1340,51.3,40568,22872,676,664
69155,1004,39.7,51107,25060,558,446
69156,637,42.3,49583,23179,344,293
69157,21,29.8,53000,12786,6,15
69161,74,50.7,43125,20538,33,41
69162,7972,38.8,50382,28031,3860,4112
69163,828,50.4,45481,25348,362,466
69165,1964,42.4,63810,27154,932,1032
69166,682,42.9,52500,27668,337,345
69167,278,40,54219,23123,132,146
69168,178,52.5,47750,28965,84,94
69169,605,38.4,55481,23379,349,256
69170,338,49,45114,22223,170,168
69171,11,-666666666,-666666666,,6,5
69201,3903,48.7,45700,25415,1899,2004
69210,2478,46.9,33237,21460,1218,1260
69211,307,47.3,48333,28815,167,140
69212,361,39.9,54185,23653,197,164
69214,244,42.5,47375,37552,143,101
69216,167,41.1,45625,25070,89,78
69217,482,43.3,30682,17163,212,270
69218,186,30.3,36875,14235,100,86
69219,156,27.2,63681,19503,50,106
69220,56,51.1,53472,32684,33,23
69221,205,45.3,37667,23060,115,90
69301,10189,40.9,45934,24968,4953,5236
69331,33,34.2,-666666666,10233,8,25
69333,223,44.7,52813,27139,125,98
69334,2305,46.5,43575,21241,1200,1105
69335,5,-666666666,-666666666,,2,3
69336,2540,39.4,45591,23264,1265,1275
69337,7390,30.2,39746,20416,3562,3828
69339,1490,48.4,42353,24930,698,792
69340,171,26.8,70724,29255,79,92
69341,10734,38.3,50060,26471,5335,5399
69343,2583,46.1,40095,24706,1305,1278
69345,546,48.4,36719,27439,266,280
69346,516,54.1,27813,36162,252,264
69347,1113,52.6,40250,23501,559,554
69348,1415,40.3,51583,25988,657,758
69350,307,52.8,40714,20788,158,149
69351,129,32.5,39688,16048,45,84
69352,760,34,47361,21451,389,371
69353,18,56.5,11250,18506,10,8
69354,107,48.3,22500,11712,57,50
69355,159,28.7,46250,14096,87,72
69356,1905,38,50000,23026,883,1022
69357,3609,41.5,43053,22178,1705,1904
69358,1684,42.3,41781,23171,832,852
69360,1451,46.8,33074,20147,650,801
69361,18225,38.9,39206,21912,8665,9560
69365,21,49.6,-666666666,27586,8,13
69366,297,24.9,29833,15458,138,159
69367,268,37.3,52813,21143,115,153
70001,38844,37.5,47075,30771,18701,20143
70002,18453,39.8,52132,36529,9116,9337
70003,39446,41.4,55614,28298,19354,20092
70005,25071,42.7,55561,41786,12376,12695
70006,16064,38,55361,29670,8037,8027
70030,4674,38.6,65744,28457,2324,2350
70031,1204,46.2,61250,33250,657,547
70032,4305,33.7,39886,19535,2148,2157
70036,1057,59.9,67578,39864,477,580
70037,16412,34.4,64423,28032,8071,8341
70038,437,38.6,24583,19168,264,173
70039,2044,31.5,47750,21434,938,1106
70040,1415,43.2,35921,20036,674,741
70041,2153,45.7,47703,25234,1042,1111
70043,18019,31.8,39461,21237,9123,8896
70047,12943,39.8,67107,30774,6288,6655
70049,2175,41.7,41227,17622,960,1215
70050,14,-666666666,-666666666,,14,0
70051,1802,43.7,39583,24060,860,942
70052,3677,35.2,44760,22159,1837,1840
70053,16617,35.9,32561,20307,8759,7858
70056,39917,34.5,50672,24355,19702,20215
70057,4642,36.9,42262,20217,2416,2226
70058,39499,34.5,47898,22458,18832,20667
70062,17348,37.5,34778,17844,8560,8788
70065,50989,39.1,53282,28849,24588,26401
70067,3220,39.6,49761,24817,1662,1558
70068,34192,34.7,54048,22243,16793,17399
70070,12584,37.5,61760,28594,6018,6566
70071,3599,36.4,60536,26674,1731,1868
70072,56088,37,41948,21205,26570,29518
70075,4527,33.1,60135,21869,2419,2108
70076,390,13.6,31250,6969,227,163
70079,3093,37,56100,25786,1580,1513
70080,1041,46.1,61806,22885,588,453
70082,259,37,84643,23514,138,121
70083,2415,39.5,40194,16833,1260,1155
70084,7419,39.2,47721,20183,3720,3699
70085,4239,37.3,36185,17125,2095,2144
70086,2383,29.3,32656,14872,1027,1356
70087,8871,33.3,48125,21719,4227,4644
70090,7767,42.3,60000,25609,3699,4068
70091,280,25,41591,14760,136,144
70092,7760,32.8,41236,19450,3729,4031
70094,31549,36.2,34922,17845,14832,16717
70112,3489,29.9,20457,26012,1797,1692
70113,8154,35.7,18446,14380,4189,3965
70114,25161,33.5,31537,17974,11777,13384
70115,34633,36.9,50765,42425,17007,17626
70116,12069,42.3,33091,34167,6221,5848
70117,21488,39,26431,18744,10658,10830
70118,33036,30.6,39576,30677,15140,17896
70119,36558,34.6,29071,21062,18949,17609
70121,11735,46.5,39350,26281,5906,5829
70122,31187,37.2,37433,23123,14449,16738
70123,26726,43.9,59087,36550,12650,14076
70124,18546,37.5,74683,44865,9035,9511
70125,16117,32.2,38912,25525,7548,8569
70126,23327,34.9,27823,15572,10842,12485
70127,22490,29.9,27096,14864,10511,11979
70128,17911,33.9,40168,20203,8219,9692
70129,9603,34,34635,15265,4871,4732
70130,13870,36,50914,51579,7152,6718
70131,29374,36.9,50934,28827,13664,15710
70139,0,-666666666,-666666666,-666666666,0,0
70163,0,-666666666,-666666666,-666666666,0,0
70301,43699,36.7,50428,25208,21557,22142
70339,5983,43.4,52574,26160,2673,3310
70340,214,35.5,14348,6643,91,123
70341,4369,38.6,28670,17720,1896,2473
70342,4983,30.8,45518,23319,2547,2436
70343,5115,34.3,67621,26481,2677,2438
70344,6430,36.2,43074,18642,3218,3212
70345,9421,35,56941,23231,4288,5133
70346,11282,34.7,35586,18635,5210,6072
70352,207,48.9,39792,20154,79,128
70353,873,45.1,55333,21522,371,502
70354,4490,39.9,42350,21801,2026,2464
70355,1189,36.7,42770,20348,580,609
70356,2265,37.8,19135,15859,1108,1157
70357,3151,38.8,50000,26801,1548,1603
70358,854,46.4,39886,20292,399,455
70359,8510,30.9,46577,21422,3671,4839
70360,26718,37.3,66316,31192,13264,13454
70363,27182,32.8,45722,19456,13535,13647
70364,29909,34.2,51060,23535,15111,14798
70372,2474,38.4,44202,21416,1297,1177
70373,6633,39.4,44901,24096,3314,3319
70374,7251,37.2,53410,28491,3919,3332
70375,131,38.4,-666666666,29577,39,92
70377,4679,43.7,51176,19907,2583,2096
70380,22591,38.8,43417,22338,11313,11278
70390,7360,38.7,45774,20985,3779,3581
70391,246,52.9,62647,24694,136,110
70392,8433,35.3,50748,23148,4053,4380
70393,476,36.3,17465,14559,322,154
70394,14606,36.5,48196,24991,7176,7430
70395,5112,36.9,47304,33652,2675,2437
70397,1645,25.9,30893,11525,759,886
70401,20681,30.1,36727,24123,10073,10608
70402,1054,19.7,-666666666,3140,276,778
70403,26041,34.6,39793,21625,12419,13622
70420,9243,38.9,60976,25613,4476,4767
70422,15082,33.6,36263,17851,7766,7316
70426,6649,37.3,31028,13723,3910,2739
70427,19880,38.3,29319,17191,9186,10694
70431,4860,46.9,64877,30415,2534,2326
70433,31031,40.6,62889,34147,15155,15876
70435,17629,40.4,59045,28665,8146,9483
70436,679,57.5,21000,11618,389,290
70437,7927,45.7,47806,25995,3906,4021
70438,17868,40.6,35622,20447,8657,9211
70441,4796,36.5,30759,19182,2371,2425
70442,203,65.2,45673,46162,143,60
70443,9318,34.1,35408,17246,4445,4873
70444,9745,40.8,32477,19800,4661,5084
70445,10898,43.4,42603,24681,5413,5485
70446,6357,36.8,58224,21874,3193,3164
70447,10900,33.9,96146,41862,5644,5256
70448,24901,40,79838,36180,12415,12486
70449,3849,45.3,48857,30133,2072,1777
70450,2955,37.9,25327,15707,1526,1429
70451,52,33.1,-666666666,14313,26,26
70452,11667,43.8,47909,24026,5648,6019
70453,1059,37.5,75096,21105,455,604
70454,26413,36.2,52638,24740,12387,14026
70455,1229,41,34727,15952,480,749
70456,2980,31.8,30930,13452,1692,1288
70458,35971,39.3,52571,26698,17338,18633
70460,22106,34.5,43944,22361,11086,11020
70461,28194,37.9,59006,27864,13112,15082
70462,5224,41.1,46042,26282,2610,2614
70463,115,47.9,75485,41159,84,31
70464,623,31.5,14859,13722,174,449
70465,661,36.1,26053,13621,255,406
70466,8670,33.2,40440,18794,4546,4124
70471,21429,41.1,80132,41063,10384,11045
70501,29360,35.3,24411,15707,14605,14755
70503,28097,34.5,64778,36639,13733,14364
70506,43797,31.8,43491,25212,21544,22253
70507,16755,33.4,53289,26085,8073,8682
70508,36238,34.8,69131,38622,17430,18808
70510,25353,37.1,41077,21704,12615,12738
70512,10199,38.9,47027,20128,4896,5303
70513,105,51.6,-666666666,81946,71,34
70514,2188,42.7,30865,19476,1107,1081
70515,3694,32.4,37391,16088,2032,1662
70516,1059,39.6,66250,22861,496,563
70517,26453,35.4,42767,22239,13019,13434
70518,12761,35.2,62279,34999,6128,6633
70519,132,52.3,56906,44810,94,38
70520,19164,34.1,50129,25130,9055,10109
70523,625,48.6,26250,15142,269,356
70524,492,45.7,47115,18482,268,224
70525,13480,31.6,35788,20154,6463,7017
70526,20062,34.5,34447,17900,9885,10177
70528,2388,36.1,41923,19933,1072,1316
70529,11564,32.1,44354,26034,5618,5946
70531,1177,39,35133,18026,527,650
70532,2720,42.3,44795,23195,1262,1458
70533,6952,38.8,48112,22245,3215,3737
70534,1039,32.2,60833,22754,524,515
70535,18022,36.3,39645,20375,9254,8768
70537,550,44.9,33875,17692,286,264
70538,14767,38.8,37010,19944,7279,7488
70541,381,32.4,31467,23026,203,178
70542,3458,38.8,45438,23170,1654,1804
70543,4304,34.5,43567,20169,2104,2200
70544,11619,36.1,36598,18510,5663,5956
70546,16119,35.9,41711,21222,8038,8081
70548,10028,38.2,37330,20656,4941,5087
70549,4125,40.6,33182,19041,1884,2241
70550,323,34,-666666666,52356,138,185
70552,1639,35.7,40571,23679,789,850
70554,5832,32.6,25198,15979,2695,3137
70555,8508,33.1,61971,27190,4042,4466
70556,278,27.6,22604,21309,123,155
70558,93,-666666666,-666666666,,54,39
70559,2278,34.5,37875,22352,1072,1206
70560,42529,34.1,40663,19700,20737,21792
70563,18592,39.2,62208,33352,9151,9441
70570,39387,35.1,31958,17373,18238,21149
70575,36,80.2,-666666666,24372,26,10
70576,1633,32.2,38500,13530,1089,544
70577,4641,30.4,42784,20149,2245,2396
70578,16425,39.3,42263,21921,7758,8667
70580,75,49.1,-666666666,8541,16,59
70581,817,53.2,45167,27015,434,383
70582,19483,37.6,37292,20783,9419,10064
70583,10468,38.5,48964,26249,5396,5072
70584,7534,35.9,50775,24031,3681,3853
70585,207,44.3,82250,34930,120,87
70586,19688,37,33019,19009,9541,10147
70589,3011,40.8,35625,22553,1449,1562
70591,5233,35.1,40381,18766,2553,2680
70592,19749,33.1,82115,32578,9913,9836
70601,31403,37.6,29882,19235,14689,16714
70605,34320,38.1,57490,35541,16433,17887
70607,26446,31.6,36201,20473,12982,13464
70611,19313,37.2,65534,28634,9656,9657
70615,12721,35.3,32711,17960,6799,5922
70630,1231,41.3,72649,29913,684,547
70631,821,45.4,63571,31951,456,365
70632,425,51.1,59219,26735,246,179
70633,7449,37.9,39311,19941,3937,3512
70634,24766,36.1,46123,22405,11949,12817
70637,785,23.8,49291,20838,252,533
70638,866,31.3,50769,19352,451,415
70639,578,36.8,34398,17351,274,304
70640,303,42.1,27750,14077,163,140
70643,326,33.8,51250,28694,158,168
70644,218,19.5,47768,16774,83,135
70645,1265,42.9,62895,33943,584,681
70646,625,22.6,52596,11092,372,253
70647,8862,36,53397,24145,4279,4583
70648,8535,38.6,41967,18514,5044,3491
70650,418,30.8,83529,26552,215,203
70651,204,39.5,64688,25747,107,97
70652,2219,36.3,46856,27155,1154,1065
70653,3056,41,41607,22408,1580,1476
70654,131,47.3,67670,21750,75,56
70655,3136,39.2,36447,20264,1579,1557
70656,3569,39.2,34637,20876,1945,1624
70657,5201,34.6,54138,24196,2729,2472
70658,1263,35.2,50372,24537,687,576
70659,1407,34.9,44167,21289,755,652
70660,3228,41.2,54353,15464,2055,1173
70661,2189,39.3,29412,19315,965,1224
70662,483,35,24894,19458,206,277
70663,28184,37.6,45326,23553,13161,15023
70665,10933,32.1,59524,24639,5500,5433
70668,6727,41.6,36548,21487,3321,3406
70669,10024,34.4,46862,22816,5012,5012
70706,22040,34,67098,25761,10935,11105
70710,3812,29.8,46777,22616,1772,2040
70711,5440,30.9,47759,20428,2648,2792
70712,4446,42.5,73906,4174,4156,290
70714,20194,35.4,44439,21124,9018,11176
70715,1709,41.4,43177,18581,812,897
70719,4409,37,54514,26526,2157,2252
70721,1161,24.6,53203,16062,611,550
70722,6026,38.5,42687,24169,2938,3088
70723,1884,30.6,26444,13904,947,937
70725,1932,33.8,69067,28199,924,1008
70726,52962,33.8,57246,25447,26123,26839
70729,986,35.5,71625,29211,527,459
70730,3686,46.3,53333,29917,1910,1776
70732,1093,50.5,49432,25198,548,545
70733,1649,44.9,37122,24110,776,873
70734,7207,31.8,74555,28687,3743,3464
70736,663,24.5,53393,16252,320,343
70737,39141,34.8,60590,26991,19466,19675
70739,13844,38.6,73424,33352,6445,7399
70740,1295,37.5,49250,28272,584,711
70743,215,46.7,146111,48587,131,84
70744,6099,37.9,38856,22015,2847,3252
70747,93,40.7,24479,20252,47,46
70748,6440,43,41489,17350,4104,2336
70749,1381,47.4,42716,32112,622,759
70750,1598,42.8,31188,20711,796,802
70752,970,39.5,62863,28435,516,454
70753,975,46.8,41250,18865,454,521
70754,9013,38.8,55758,24260,4406,4607
70755,2221,39.8,60787,25483,1090,1131
70756,354,50.3,30972,49989,156,198
70757,3207,38,40089,25404,1522,1685
70759,1368,50.1,32396,19750,685,683
70760,6478,43.6,33176,21094,3119,3359
70761,951,44.9,34583,18604,401,550
70762,732,51.2,54167,33743,412,320
70763,3539,40,71661,33581,1781,1758
70764,17881,35.6,45608,22396,8944,8937
70767,14864,36.5,50000,24600,7358,7506
70769,37603,34.1,88494,32972,18532,19071
70770,3543,41,86958,34196,1626,1917
70772,777,43.4,43281,26802,420,357
70773,230,28.3,54429,27293,143,87
70774,10644,37.7,54357,26048,5287,5357
70775,10705,41.4,62517,29004,5903,4802
70776,5238,41.9,60726,14395,3202,2036
70777,4600,37.2,64718,26629,2349,2251
70778,2331,34.8,67951,30322,1318,1013
70780,1293,41.6,54345,25973,575,718
70782,297,48.6,26000,24396,190,107
70783,2943,40.3,51198,24087,1373,1570
70785,20861,34.2,61977,25132,10225,10636
70787,74,72.1,-666666666,11443,48,26
70788,3975,38.4,33942,19106,1820,2155
70789,547,33.2,30036,11456,267,280
70791,24783,35.5,61561,26026,11648,13135
70801,10,-666666666,-666666666,,10,0
70802,27332,31.4,25043,14499,13434,13898
70803,1057,19.5,21333,4376,720,337
70805,30474,28.5,28031,13418,13709,16765
70806,28020,33.8,38504,27541,12573,15447
70807,19910,27.5,24646,12025,9071,10839
70808,32149,31.3,64650,38609,15816,16333
70809,23397,35.5,59230,43085,10888,12509
70810,37296,34.4,73894,42161,18273,19023
70811,13647,32.6,44965,19410,6666,6981
70812,11358,34.4,43948,19871,5350,6008
70814,15321,34.2,53073,22500,7535,7786
70815,29419,34.2,47979,24507,14066,15353
70816,43144,31.9,50057,28140,20731,22413
70817,32327,39.2,88490,39184,15713,16614
70818,9536,41,65948,29116,4649,4887
70819,4756,32.2,45032,18603,2481,2275
70820,18708,22.5,25790,21163,10727,7981
70836,0,-666666666,-666666666,-666666666,0,0
71001,4579,43.8,29153,21822,2133,2446
71003,1450,37.9,32321,21013,856,594
71004,443,45.4,28988,18614,228,215
71006,12601,39.7,75120,29679,6346,6255
71007,1158,36,71447,31919,626,532
71008,731,38.3,38929,19627,385,346
71016,1876,39.8,34360,19574,894,982
71018,1317,51,34948,20358,624,693
71019,8621,38.2,37588,21132,4183,4438
71021,617,46.1,18015,13609,267,350
71023,3250,42.8,38632,22830,1558,1692
71024,1522,38.1,27266,17587,845,677
71027,2145,41.6,36514,18970,972,1173
71028,1467,50.1,32955,22002,715,752
71029,130,59.6,29063,22751,67,63
71030,1478,37.4,43893,20083,643,835
71031,1012,49.8,44250,20250,460,552
71032,2017,43.6,48958,28672,1030,987
71033,3424,46.1,46442,25701,1727,1697
71034,354,31.3,37250,15176,179,175
71037,19425,36.2,64447,29374,9783,9642
71038,4304,45.2,30017,19705,2055,2249
71039,2194,40.6,41108,19709,1294,900
71040,8868,38.8,34936,16237,5313,3555
71043,729,31.7,33816,15624,358,371
71044,632,56,32153,28171,331,301
71045,829,39.3,39167,23064,460,369
71046,1491,37.9,41825,23280,799,692
71047,11839,39.1,52837,22112,6228,5611
71048,95,53.6,26500,23888,47,48
71049,3351,37.3,31761,18151,1480,1871
71051,2732,41.2,42332,30631,1271,1461
71052,10370,37,28528,19432,4837,5533
71055,20291,41.1,37870,21084,10062,10229
71060,2600,42.3,50380,20908,1287,1313
71061,1415,50.8,32773,21683,683,732
71063,662,49,27566,21674,309,353
71064,4019,48.8,34030,19982,2274,1745
71065,1199,41.5,36125,22113,552,647
71067,3751,33.7,45420,18744,1821,1930
71068,3512,44.2,30846,18430,1627,1885
71069,545,46.8,19875,16859,269,276
71070,2079,44.6,40536,18272,1047,1032
71071,2922,31.8,49737,18999,1338,1584
71072,1467,46.2,43015,24082,702,765
71073,2195,37.5,37900,18912,1005,1190
71075,6544,39.9,26146,16263,3055,3489
71078,5361,42.1,63343,26732,2637,2724
71079,384,20.2,65625,10556,235,149
71082,4953,48,29505,22587,2216,2737
71101,8737,36.3,20410,12931,4282,4455
71103,8449,36.2,22695,13335,4240,4209
71104,14466,32.8,41970,24887,7277,7189
71105,22793,35.4,57798,34128,11453,11340
71106,35163,39.1,49644,33917,16702,18461
71107,34019,34.9,38920,19372,16696,17323
71108,19036,31.2,31034,14019,7861,11175
71109,21512,36.1,22255,14792,9548,11964
71110,3129,22.1,41886,19524,1930,1199
71111,39900,33.2,50526,28181,19173,20727
71112,31483,34.8,51790,25153,14893,16590
71115,14460,37.5,57650,40078,6560,7900
71118,26102,35.2,48041,24182,12108,13994
71119,12404,39.3,56113,29078,6072,6332
71129,13164,33.1,44738,25050,6070,7094
71201,19721,39.6,42507,33747,8776,10945
71202,31078,30.3,22386,10704,15787,15291
71203,36950,31.4,41229,21853,17094,19856
71209,113,19.4,-666666666,2012,24,89
71219,1123,41,29516,25851,549,574
71220,23428,37.5,28600,16288,10901,12527
71222,3797,39.5,25020,13605,2025,1772
71223,374,30.6,15833,9715,205,169
71225,7900,34.4,60108,26156,3774,4126
71226,1761,40.8,31018,18076,941,820
71227,3673,32.8,46328,25237,1893,1780
71229,1686,35.9,45658,18849,1086,600
71232,6506,40.8,38207,19010,2962,3544
71233,235,40.8,31333,22772,152,83
71234,3621,46.2,50052,23213,1783,1838
71235,3974,44.6,47038,23069,2038,1936
71237,2048,29.8,30380,12101,1217,831
71238,2365,40,59643,25711,1133,1232
71241,9385,39.1,36541,20505,4613,4772
71243,114,42.9,26875,18631,57,57
71245,4620,24.7,24104,9844,2159,2461
71247,1102,29.2,28750,14271,584,518
71250,60,55,28750,15608,44,16
71251,9169,39.4,37775,18510,4686,4483
71253,368,23.5,23750,14231,176,192
71254,6564,32.6,22460,11044,3691,2873
71256,882,34.8,22500,11935,584,298
71259,1936,35.4,36477,16988,985,951
71260,3584,43.7,43526,20802,1738,1846
71261,1437,52,24444,20060,689,748
71263,7926,42.3,33203,19164,3862,4064
71264,1095,45.4,39514,22529,542,553
71266,1572,39.9,40705,19605,722,850
71268,2486,39.8,40889,23433,1263,1223
71269,12809,36.8,37490,18803,6338,6471
71270,31181,27.6,34546,21917,14516,16665
71272,1985,19.6,-666666666,2206,1037,948
71275,2673,37.2,42670,21590,1472,1201
71276,357,51,32273,12464,204,153
71277,1736,44.9,39659,17316,818,918
71279,66,10.5,-666666666,,22,44
71280,3424,37.8,43033,23962,1497,1927
71282,11222,34.1,25155,13222,5536,5686
71286,529,49.5,33438,24237,314,215
71291,34018,36,48191,25180,15872,18146
71292,19974,37.6,35491,19616,10465,9509
71295,14624,35.9,31850,16495,7335,7289
71301,22796,35.1,32065,18587,10845,11951
71302,15682,34.6,29306,14805,7006,8676
71303,20766,37,48356,27502,9703,11063
71316,27,66.5,-666666666,56874,9,18
71322,6994,39.5,30662,16203,3686,3308
71323,958,31,52500,28650,422,536
71325,1410,28.3,31599,31326,669,741
71326,1109,39.5,30538,15047,479,630
71327,6315,36.5,38795,14055,3758,2557
71328,7637,39.1,49284,21422,3769,3868
71331,841,34.3,37109,18372,505,336
71333,681,46.2,24128,25946,338,343
71334,9747,34.9,21291,13884,4773,4974
71336,1361,46.4,33646,23484,531,830
71339,141,59.2,80972,53312,78,63
71340,1612,33.7,30560,19909,1169,443
71341,2874,41.6,35426,17833,1353,1521
71342,8516,37.8,47457,24146,4123,4393
71343,7752,40.3,41734,21212,4005,3747
71345,124,56,9931,8495,63,61
71346,2688,37.9,38125,24903,1480,1208
71350,3971,45.1,35417,20321,1901,2070
71351,11031,39.9,32115,17723,5405,5626
71353,1646,43.4,26719,19660,849,797
71354,1854,38.2,39539,20273,907,947
71355,3387,35.1,33266,21398,1579,1808
71356,812,34.1,16523,12479,393,419
71357,2291,43,29306,17770,1162,1129
71358,1018,48.9,37500,17670,457,561
71360,34973,38.4,44004,24148,17221,17752
71362,1813,32.5,39491,20790,778,1035
71366,1595,41.9,28333,19602,794,801
71367,1190,40.6,40341,17379,694,496
71368,1525,40,22287,15253,771,754
71369,2669,35.3,30298,14390,1104,1565
71371,1627,39.2,54219,27720,908,719
71373,7069,38.6,36201,18136,3657,3412
71375,1219,37.7,22344,12880,490,729
71377,78,60.5,15833,5441,43,35
71378,2567,42.4,25625,17362,1140,1427
71401,0,-666666666,-666666666,-666666666,0,0
71403,4514,39.4,45923,22917,2149,2365
71404,588,39.6,45583,23852,338,250
71405,5687,35.8,55242,23941,2686,3001
71406,367,39.4,66036,20629,128,239
71407,653,37.1,39196,19977,313,340
71409,6769,43.1,46067,22858,3520,3249
71410,134,36.9,35625,11067,61,73
71411,2757,33.4,39464,19664,1443,1314
71414,171,42.5,31250,18430,89,82
71416,988,37.5,30263,17031,483,505
71417,4717,37.9,32077,19554,2421,2296
71418,6289,40.2,39329,23980,3124,3165
71419,2694,44.8,37227,22414,1387,1307
71422,1616,45,35048,16948,857,759
71423,4932,36.6,50259,23171,2545,2387
71424,1610,38.6,39125,19104,749,861
71425,296,50.2,41250,20491,115,181
71426,207,37.9,63125,21817,96,111
71427,228,51.9,26685,20912,113,115
71429,2501,48,35208,21778,1293,1208
71430,3485,30,47786,17511,1773,1712
71432,1085,37.7,40357,18300,459,626
71433,4078,36.8,40231,18820,2006,2072
71435,3896,45.3,38720,21643,2186,1710
71438,1363,41.9,45781,23034,653,710
71439,1729,38.2,38468,20342,798,931
71441,536,31.5,27589,16956,242,294
71446,23446,33.9,48170,23718,11930,11516
71447,1309,35.1,35764,17264,567,742
71449,9455,43,34385,24060,4709,4746
71450,1269,33,53750,19133,641,628
71452,37,53.8,33571,20854,17,20
71454,2780,42.9,40025,20099,1295,1485
71455,270,34.9,28173,13404,155,115
71456,902,50.9,34200,23886,393,509
71457,27634,30.6,31515,21112,12958,14676
71459,12356,22,46517,16843,7082,5274
71461,2568,33.6,40318,21612,1221,1347
71462,1222,37.4,29231,22933,617,605
71463,10155,40.8,30955,16738,6285,3870
71465,2857,36.2,35081,19568,1350,1507
71466,750,32.3,39063,14553,340,410
71467,7643,36.5,44839,16533,5263,2380
71468,886,38.9,37500,17091,428,458
71469,3022,35.6,42500,19831,1443,1579
71472,80,55.7,14118,7940,41,39
71473,389,43.1,39375,15985,137,252
71474,731,35.3,62188,28330,366,365
71479,709,55.7,41389,21443,340,369
71480,1124,37.4,38182,11477,865,259
71483,11237,38.4,34489,16803,6044,5193
71485,2289,41.7,62470,33235,1059,1230
71486,5824,35.5,34645,20242,2982,2842
71601,17718,28.9,25268,13493,8261,9457
71602,16472,39.6,43982,22298,8161,8311
71603,34047,39.4,40730,21576,16409,17638
71630,553,39.4,36146,18641,273,280
71631,652,47.6,20114,15129,319,333
71635,12463,41,39646,20518,5943,6520
71638,3714,38.6,20226,10743,2025,1689
71639,6090,40.3,25201,21239,2706,3384
71640,3465,41.8,21276,13053,1646,1819
71642,508,30.6,26458,14269,199,309
71643,1413,36.6,21719,12003,739,674
71644,4256,36.2,34167,6281,3658,598
71646,6607,37,32689,20056,3336,3271
71647,2006,37.5,33889,22261,992,1014
71651,160,43.6,81087,41193,68,92
71652,1145,50.6,30375,18773,603,542
71653,4828,48.7,34414,23411,2204,2624
71654,4761,33.6,29675,18074,2178,2583
71655,15510,34.8,30280,16795,7448,8062
71658,733,35.1,31250,14102,384,349
71659,119,67.1,38324,18813,34,85
71660,797,39.6,43935,20199,372,425
71661,349,38.6,23250,12887,181,168
71662,154,24,13125,6975,112,42
71663,816,37.9,25500,16617,335,481
71665,6215,38.3,42935,21180,3079,3136
71666,51,38.4,14659,27078,27,24
71667,7995,37.2,32024,19427,4025,3970
71670,1575,46.5,51316,23670,789,786
71671,8595,40.3,30439,18843,4236,4359
71674,621,50.2,46923,19664,368,253
71675,1996,48.6,33696,18715,983,1013
71676,532,52.7,27500,17377,241,291
71677,168,35.6,16042,8511,91,77
71701,19886,42.5,31388,18810,9222,10664
71711,11,42.5,-666666666,-666666666,10,1
71720,2921,34.2,42011,19921,1423,1498
71722,94,57,13750,9570,48,46
71724,347,53,32931,19373,156,191
71725,583,54.3,26563,15185,280,303
71726,1071,58.5,26484,16281,513,558
71730,32016,39.1,37795,21067,15665,16351
71740,1620,38,47596,20953,830,790
71742,6321,38.2,28685,16078,3135,3186
71743,4478,40.6,36413,17974,2131,2347
71744,3217,48.5,30149,18403,1645,1572
71745,258,44.1,25625,18721,115,143
71747,909,47.8,32841,16495,430,479
71749,2374,41.2,36250,18473,1151,1223
71751,970,44.2,53657,25375,587,383
71752,898,38.4,24426,17435,428,470
71753,17225,33.3,35205,19710,8181,9044
71758,330,55.3,50556,25394,155,175
71759,797,34.2,39821,19945,381,416
71762,2533,39.5,37500,21167,1287,1246
71763,1314,53.3,31875,17689,719,595
71764,2051,46.7,36588,18317,1043,1008
71765,2253,47.2,30394,16512,978,1275
71766,630,46,25833,18010,329,301
71770,3283,39.8,29274,17783,1534,1749
71772,0,-666666666,-666666666,-666666666,0,0
71801,16845,35.9,29738,16958,8011,8834
71820,115,8,-666666666,19347,59,56
71822,9118,41,41324,20125,4682,4436
71823,51,43.3,43125,24947,29,22
71825,686,32.6,35625,13098,330,356
71826,1367,38.3,26506,13926,669,698
71827,769,45.6,33333,14917,425,344
71832,10950,33.9,30908,15096,5213,5737
71833,2235,37,38317,15912,1097,1138
71834,1385,53.3,39821,23159,657,728
71835,1219,38,39899,20042,599,620
71836,2935,44.7,37629,19814,1290,1645
71837,5586,38.1,43498,17366,2727,2859
71838,944,49.5,28512,18092,430,514
71839,410,31,19464,11007,197,213
71841,903,38,45048,16040,398,505
71842,2300,29.3,39410,13905,1181,1119
71845,2186,42.2,22321,17521,1034,1152
71846,3053,36.5,45125,20872,1646,1407
71847,769,49.4,28333,15050,322,447
71851,2481,38.8,32500,17582,1176,1305
71852,9978,37.2,40631,19457,5054,4924
71853,233,36.6,29583,14615,124,109
71854,36134,36.7,41329,21154,17800,18334
71855,526,50.2,42167,17324,279,247
71857,5905,40,29196,18262,2829,3076
71858,1824,43,38447,19115,880,944
71859,466,52.5,56111,43699,214,252
71860,3153,37.4,31379,16479,1535,1618
71861,1635,53.2,50240,26358,760,875
71862,680,47.2,39306,26427,345,335
71865,234,39.3,32083,18146,97,137
71866,334,44.5,36500,19302,164,170
71901,29728,39.5,31323,20503,13700,16028
71909,15043,66.9,51880,33326,7200,7843
71913,43180,44.5,39713,24699,20891,22289
71921,3566,38.1,32448,16319,1882,1684
71922,192,56.5,30625,18946,88,104
71923,14970,33.1,32189,19018,6936,8034
71929,4522,40.6,45223,23111,2274,2248
71933,1748,35.3,58750,18094,940,808
71935,779,53.8,27639,27561,396,383
71937,2169,43.6,32188,17603,1037,1132
71940,1485,48.1,31007,23442,707,778
71941,2329,43.2,44745,21262,1210,1119
71943,5080,39.7,30597,16616,2477,2603
71944,838,30.5,37375,17285,431,407
71945,1625,41.5,26211,15679,803,822
71949,2605,31.6,43492,15114,1241,1364
71950,826,47.7,30125,19913,426,400
71952,181,42.2,30313,14803,65,116
71953,14271,47.1,33139,20460,6952,7319
71956,2169,39.2,29583,12364,1077,1092
71957,3004,54.9,35445,21459,1513,1491
71958,2227,42.1,38625,19686,1023,1204
71959,753,46,30443,15729,348,405
71960,1442,40.1,28750,14795,671,771
71961,1259,43.6,29779,13326,591,668
71962,1181,41.4,33430,17628,612,569
71964,4202,36.8,39632,18771,2076,2126
71965,190,33.7,17330,13818,89,101
71968,4205,44.5,49607,23168,2307,1898
71969,315,56.6,50069,23005,178,137
71970,951,45.8,29261,19022,470,481
71971,587,32.3,43750,20355,220,367
71972,323,23.5,10000,11292,153,170
71973,1442,29.3,29397,13955,761,681
71998,372,21.1,-666666666,3279,302,70
71999,503,20.4,-666666666,2868,119,384
72001,447,51.7,35250,20143,230,217
72002,14801,35.5,56133,24555,7494,7307
72003,906,35.5,55132,24855,452,454
72004,1130,37.4,31406,15953,559,571
72005,146,49.7,30521,16940,74,72
72006,2530,43.7,22364,17399,1312,1218
72007,6065,34.7,53125,21845,2899,3166
72010,6656,36.2,38563,18880,3262,3394
72011,4406,37.2,54180,21119,2190,2216
72012,12758,37.3,42005,22971,5650,7108
72013,1944,49.3,32051,19247,1080,864
72014,66,50.9,22386,17048,35,31
72015,28277,36,45978,21463,13851,14426
72016,3086,45.7,48294,21991,1595,1491
72017,788,45.2,32500,15635,455,333
72019,23996,39.1,68093,30783,11973,12023
72020,4134,42.1,39309,18610,1971,2163
72021,4025,45.5,25521,15633,1979,2046
77316,15465,41.8,72458,34016,8135,7330
77318,13133,46.7,78194,37464,6306,6827
77320,36855,38.4,44130,14904,24438,12417
77326,19,-666666666,-666666666,,0,19
77327,20829,35.2,46936,19537,10461,10368
77328,15666,34,48250,19670,7955,7711
77331,6219,54.5,41596,28728,3073,3146
77334,98,25.5,-666666666,16470,68,30
77335,2447,33.9,23958,15301,1235,1212
77336,12022,36,62995,30721,5978,6044
77338,34410,31.7,48046,22614,16496,17914
77339,39840,38,73135,37255,19828,20012
77340,25784,25.8,30933,17230,13307,12477
77342,344,39,-666666666,151,344,0
77345,28239,41.3,119708,55096,14482,13757
77346,54627,33.6,86523,34639,27006,27621
77350,106,46.1,86563,30576,52,54
77351,33044,43.4,39967,19671,18023,15021
77354,32363,36.7,75269,31848,16198,16165
77355,25007,38.5,71326,30692,11482,13525
77356,24694,47.4,78353,43107,12035,12659
77357,19992,34.6,48979,21485,10392,9600
77358,5242,41.2,57656,28939,2563,2679
77359,825,33.4,36646,26862,417,408
77360,4739,50.7,32380,20266,2424,2315
77362,4841,30,59576,22628,2401,2440
77363,3251,38.5,46842,21297,1547,1704
77364,2062,50.3,44595,24977,1199,863
77365,26617,33.8,58109,24044,13572,13045
77367,218,36.7,75556,21003,83,135
77368,151,59.4,58182,50873,67,84
77369,708,40.3,19485,17482,366,342
77371,8468,35.7,38595,18378,3802,4666
77372,12276,35.6,44896,18826,6034,6242
77373,55927,32.4,67742,25921,28024,27903
77374,577,27.4,67500,20382,309,268
77375,41919,31.8,60782,26527,21109,20810
77376,320,39.5,17286,7861,231,89
77377,30791,33.1,87474,34212,15400,15391
77378,14151,34.7,48136,24117,7534,6617
77379,72579,37.3,97692,42442,36468,36111
77380,24771,36.3,67616,42469,12342,12429
77381,37028,43.1,101383,50632,18098,18930
77382,36764,35.9,131564,52691,18224,18540
77384,12443,41.5,80032,41931,5934,6509
77385,19546,35.1,82175,33498,9618,9928
77386,42574,31.4,82747,33601,20950,21624
77388,40175,36.1,82936,33848,20676,19499
77389,24561,35.7,99702,39950,12459,12102
77396,45778,30.1,56575,24505,23810,21968
77401,17874,41.9,144821,76324,8888,8986
77406,35276,37.9,110294,43521,18796,16480
77407,31973,32.6,85219,30557,15353,16620
77412,112,43.1,30000,16820,60,52
77414,23132,39.4,43186,24937,11482,11650
77415,12,-666666666,-666666666,,0,12
77417,2445,34.4,35833,18948,1110,1335
77418,9296,41.5,46250,26250,4574,4722
77419,1524,28.8,21857,14201,822,702
77420,1960,37.3,27660,18805,828,1132
77422,13227,40.3,49262,23102,7426,5801
77423,9587,33.1,36667,15813,5061,4526
77426,2103,44.6,56420,27343,1276,827
77428,0,-666666666,-666666666,-666666666,0,0
77429,74313,34,96695,38998,36869,37444
77430,2007,45.6,68889,27298,1040,967
77432,66,29.9,-666666666,30524,52,14
77433,55563,30.8,89258,31913,27389,28174
77434,4701,34.2,35105,16735,2138,2563
77435,4462,39.4,49604,22349,2266,2196
77436,0,-666666666,-666666666,-666666666,0,0
77437,17007,35.4,43599,20928,8353,8654
77440,0,-666666666,-666666666,-666666666,0,0
77441,5409,45.1,123703,56727,2666,2743
77442,996,38.5,35208,24241,437,559
77443,66,-666666666,-666666666,,53,13
77444,999,33.1,59808,32198,447,552
77445,12526,33.9,43066,22833,6520,6006
77446,5403,20.3,33897,9578,1756,3647
77447,13542,33,65682,24336,6922,6620
77448,109,64,-666666666,12182,57,52
77449,95615,30.2,65420,22477,47212,48403
77450,70538,36.4,100957,40815,33314,37224
77451,87,56.3,23438,14685,48,39
77453,441,31.9,26435,15498,193,248
77454,283,60.1,72500,22654,177,106
77455,1850,41,50000,25757,973,877
77456,1172,43.4,44878,21998,525,647
77457,544,47.5,41912,26881,329,215
77458,286,64.4,19934,28519,186,100
77459,58197,36.8,104547,41744,28272,29925
77460,174,39.3,63462,16859,124,50
77461,9695,39.1,59220,26548,4630,5065
77464,254,36.6,49432,15686,120,134
77465,7353,37.3,42623,21310,3797,3556
77466,905,30.5,60742,22247,539,366
77467,119,26.5,16667,18274,63,56
77468,177,79.2,17820,12207,117,60
77469,36305,33.4,67088,27179,18417,17888
77470,208,35.9,34667,16561,107,101
77471,35184,30.6,43798,19085,16755,18429
77473,76,53.8,20357,18078,33,43
77474,13015,37.4,56905,25875,6576,6439
77475,688,29.1,42404,18866,337,351
77476,177,54.2,25000,23193,97,80
77477,36043,32.7,54917,24649,17666,18377
77478,23853,45.3,89549,43947,11522,12331
77479,78289,38.7,123935,46356,38756,39533
77480,8074,39.5,53639,24556,3806,4268
77481,3,-666666666,-666666666,,0,3
77482,1963,26,51887,22187,931,1032
77483,481,36.5,122935,29492,155,326
77484,10898,37.7,63045,27493,5910,4988
77485,3790,41,60900,31883,1835,1955
77486,6738,42.7,58049,26983,3100,3638
77488,14797,37.4,36257,18804,7191,7606
77489,35540,35.4,58315,22086,16381,19159
77493,23628,32.9,78452,28932,11785,11843
77494,71613,34.4,126425,44621,36238,35375
77498,52545,32.9,72232,26637,26285,26260
77502,36712,28.8,43014,16069,17975,18737
77503,25103,30.9,44939,17186,12665,12438
77504,24922,31.4,40321,19707,12323,12599
77505,23550,34.2,72695,30956,11517,12033
77506,35875,27.6,30617,12391,18126,17749
77507,0,-666666666,-666666666,-666666666,0,0
77510,13605,42.9,60074,28223,6909,6696
77511,46889,35.2,52507,24075,23438,23451
77514,4315,41.6,44375,24375,2324,1991
77515,30036,37.4,55911,24283,15563,14473
77517,6235,33.5,83472,27085,3155,3080
77518,7815,34.6,40612,20754,3973,3842
77519,1517,31.8,36487,19941,745,772
77520,37735,32.1,43409,18650,18812,18923
77521,50406,32.2,53726,24200,24450,25956
77523,18668,33.5,90229,33359,9268,9400
77530,30368,28.9,44786,17963,14704,15664
77531,15358,31.1,47121,21638,7755,7603
77532,27208,34.5,63236,26268,13003,14205
77533,827,34,47500,18294,441,386
77534,2988,35.3,77045,31157,1549,1439
77535,31019,36.6,54553,19665,14831,16188
77536,31295,35.5,77824,31636,15105,16190
77538,1124,40.3,44625,26611,573,551
77539,40368,35.1,66129,26875,19838,20530
77541,17535,34.5,39304,19057,9234,8301
77545,19868,30.2,67970,23960,9255,10613
77546,49255,38.6,98442,40652,24858,24397
77547,9782,31.2,38692,13408,4616,5166
77550,22759,36,32447,22919,10876,11883
77551,18649,38,42575,25826,9152,9497
77554,8591,48.9,64583,45582,4536,4055
77560,892,38.3,41463,17749,413,479
77561,105,71.7,12250,19981,28,77
77562,10751,32.3,57394,23525,5351,5400
77563,9839,40.8,50498,25046,4880,4959
77564,1914,41.5,48657,24271,930,984
77565,5735,43.6,80000,42941,2975,2760
77566,28484,35.9,75066,32680,13696,14788
77568,14645,33.7,42196,20443,7162,7483
77571,36116,35.6,68102,27483,18508,17608
77573,73615,35.7,92559,39228,36968,36647
77575,15833,37.2,42765,20535,7934,7899
77577,1366,42.4,52606,22589,693,673
77578,14152,37,92826,37682,7269,6883
77580,319,31.8,131641,47816,137,182
77581,41813,36.1,83709,34421,20659,21154
77583,30837,35.5,68939,18614,18301,12536
77584,74761,33.9,94103,38793,35894,38867
77585,1175,30.9,37299,17582,596,579
77586,22044,39,86786,42779,11134,10910
77587,16734,26.6,36083,14251,8384,8350
77590,29980,38.2,45343,21807,14743,15237
77591,13906,34.7,46096,23153,6356,7550
77597,659,45.5,81125,39074,339,320
77598,23738,28.7,46682,24456,11849,11889
77611,8415,31.8,63640,24109,4085,4330
77612,9157,42.5,50144,23359,4408,4749
77613,889,44.5,61563,36017,410,479
77614,733,48.2,49960,46726,353,380
77615,828,40.4,50250,21229,438,390
77616,904,47.8,50921,28720,471,433
77617,99,55.2,35625,29086,64,35
77619,15966,38.4,50559,25371,7951,8015
77622,1628,40,84766,28778,871,757
77623,816,38.6,61364,16800,416,400
77624,1121,49.2,39662,22098,619,502
77625,8253,43.7,45515,23526,4169,4084
77627,21368,38.2,59701,32555,10683,10685
77629,641,46.5,52813,26982,362,279
77630,26851,39.9,42131,22848,13733,13118
77632,24158,39.3,64694,28261,11835,12323
77640,16409,38.8,29096,18687,7811,8598
77642,37724,32.3,32039,17619,18667,19057
77650,1349,44.3,79000,31121,776,573
77651,12931,40.5,61363,29391,6383,6548
77655,373,41.9,39083,18681,210,163
77656,17513,39.9,45851,23562,8384,9129
77657,20829,34.6,61609,28083,10383,10446
77659,4459,45.5,68901,31355,2212,2247
77660,1037,39,37857,19736,451,586
77661,916,29.8,80029,20625,554,362
77662,26765,38.8,43826,22719,13353,13412
77663,994,53.9,73421,30952,492,502
77664,2705,41.5,43425,25112,1389,1316
77665,5391,42.5,50149,25845,2550,2841
77701,15345,34.5,30316,14958,7753,7592
77702,2470,33,37783,27522,1231,1239
77703,16358,28.8,24829,12837,6944,9414
77705,40901,35.2,34356,14380,26674,14227
77706,28088,41.6,55900,38988,13223,14865
77707,16379,37.3,50051,27018,7472,8907
77708,11237,33.2,41205,21770,5412,5825
77713,12368,39.9,60800,32034,6243,6125
77801,14197,24.5,23162,14760,8096,6101
77802,24125,33.8,51801,30002,11245,12880
77803,30759,28.2,34420,13467,14934,15825
77807,10882,30.2,42154,19089,6297,4585
77808,10990,37.2,60981,29680,5282,5708
77830,2966,45.4,46979,29551,1557,1409
77831,3591,39.7,34228,19562,1830,1761
77833,27984,40.5,44612,22393,13660,14324
77835,2313,47,48750,27835,1230,1083
77836,11459,41.5,52348,21777,5842,5617
77837,1865,39.2,22904,13345,795,1070
77840,56154,21.7,19011,12130,29383,26771
77845,50799,29.7,70400,34155,24935,25864
77853,1094,45.4,53911,25623,580,514
77855,78,51.4,-666666666,44858,52,26
77856,4520,46.6,56667,27791,2277,2243
77857,1038,38.3,42434,23349,561,477
77859,6683,34.6,35625,19762,3476,3207
77861,2965,41.1,66397,27566,1503,1462
77864,6761,39.9,37880,17745,3161,3600
77865,1531,53.6,54338,39180,927,604
77867,111,41.9,65833,14988,54,57
77868,14262,37.1,41000,16610,8220,6042
77871,3146,47.6,43047,28948,1485,1661
77872,1437,52.2,44704,24556,631,806
77873,1481,42.1,47159,25435,687,794
77876,194,69.8,55083,21426,77,117
77878,597,36.3,34338,10919,292,305
77879,4842,48.3,41368,21503,2394,2448
77880,1637,48.8,38672,25386,810,827
77901,41648,32.4,40571,19288,20219,21429
77904,26187,39,61286,32182,12837,13350
77905,14453,41.6,61967,28522,7135,7318
77950,207,54.3,32083,25826,100,107
77951,2282,32.4,34811,16958,1228,1054
77954,11393,40.7,47448,21577,6356,5037
77957,8299,38.7,45798,21856,3941,4358
77960,17,-666666666,-666666666,,6,11
77961,92,37.8,-666666666,32988,20,72
77962,3597,35.5,61607,24012,1773,1824
77963,5817,44.7,48858,27774,2848,2969
77964,8038,46.3,42349,26048,3857,4181
77968,2528,40.7,72593,28700,1110,1418
77969,266,32.4,43971,14349,153,113
77970,336,43.7,48554,28369,189,147
77971,657,39.3,64896,28336,298,359
77973,78,25.6,-666666666,,52,26
77974,562,39.6,51667,22962,254,308
77975,1935,44.2,56696,24679,966,969
77976,156,54.8,71042,35227,76,80
77977,633,30.5,24821,13221,302,331
77978,746,37.5,53636,27271,398,348
77979,17238,36.9,46296,22864,8611,8627
77982,1244,51.9,52188,23780,695,549
77983,2259,38.7,51250,25604,1169,1090
77984,4127,46.1,46307,27382,2069,2058
77987,154,49.1,54643,25727,83,71
77988,408,34.7,46613,20675,218,190
77990,669,50.3,45000,19875,313,356
77991,218,52.3,44432,31083,103,115
77993,157,51.3,44779,38110,110,47
77994,297,56.2,44545,34976,173,124
77995,8777,42.5,44986,24049,4235,4542
78001,0,-666666666,-666666666,-666666666,0,0
78002,9199,38.6,48545,17704,4623,4576
78003,8053,51.2,43780,23694,3871,4182
78004,1397,44.7,124592,41737,702,695
78005,359,50.8,24088,19042,186,173
78006,27971,43.4,73417,38634,13754,14217
78007,4,-666666666,-666666666,,2,2
78008,303,32.8,63286,23147,138,165
78009,8347,36.6,63361,25399,3946,4401
78010,2930,48.5,45500,22788,1283,1647
78011,1944,39.3,27941,19237,920,1024
78012,360,29.3,36534,16060,194,166
78013,5665,44.1,49533,25625,2788,2877
78014,5413,32.9,26179,13701,2994,2419
78015,9965,45.4,118306,51116,5078,4887
78016,9672,38.5,47306,20525,4927,4745
78017,4560,30,38789,13709,3181,1379
78019,1374,40.1,26232,14108,705,669
78021,260,37.9,-666666666,8685,127,133
78022,4543,41.5,43924,20880,2188,2355
78023,26373,37.8,106014,39178,12932,13441
78024,1123,62.8,50288,38785,525,598
78025,4860,48.1,41547,23064,2494,2366
78026,6141,35,47820,23139,3084,3057
78027,506,44.4,98333,34010,269,237
78028,39160,47.4,43343,26653,19033,20127
78029,0,-666666666,-666666666,-666666666,0,0
78039,1499,43.8,50625,22767,697,802
78040,41851,30,23199,9229,19630,22221
78041,44823,31,42178,17642,21962,22861
78043,45547,25.6,32188,12015,22110,23437
78044,169,38.1,38636,10679,87,82
78045,57801,30,63938,22342,27903,29898
78046,63240,23.8,34399,10435,31598,31642
78050,691,54.1,26610,22595,376,315
78052,6710,36.9,58869,22272,2973,3737
78055,1943,52.8,47464,23180,903,1040
78056,1948,49.5,98102,48768,1023,925
78057,822,43.2,44189,19196,396,426
78058,836,46.7,42500,31106,393,443
78059,5301,41.2,51652,20328,2722,2579
78060,0,-666666666,-666666666,-666666666,0,0
78061,11909,31.3,33838,16304,6571,5338
78063,9524,46.8,55000,25767,4708,4816
78064,13705,35.7,55417,22124,6992,6713
78065,11764,31.8,43750,17133,5745,6019
78066,771,27.4,63583,22535,354,417
78067,454,29.5,26641,16208,260,194
78069,5485,36.1,37560,15238,2671,2814
78070,14615,45.5,75805,40868,7165,7450
78071,4408,37.5,51852,21603,2830,1578
78072,570,41.2,42083,21532,325,245
78073,7308,37.6,46191,15850,3489,3819
78075,117,56.3,27222,51838,69,48
78076,13637,28.1,32222,16718,6862,6775
78101,8970,37.8,64878,26363,4542,4428
78102,27701,35.5,42951,15998,17073,10628
78104,149,27.1,70500,17384,83,66
78107,171,51.4,34219,18216,86,85
78108,30204,33.2,83743,29728,15086,15118
78109,36384,32.4,63942,23826,17675,18709
78112,7557,31.8,46974,15853,3600,3957
78113,2569,47.2,60988,29360,1308,1261
78114,20039,41.1,58024,25563,9884,10155
78116,411,28.8,70357,29121,253,158
78117,745,44.5,84643,31304,363,382
78118,3972,36.3,40385,18742,2320,1652
78119,7377,35.4,38527,16134,4898,2479
78121,10709,43,83892,32163,5268,5441
78122,200,56.6,30610,20433,100,100
78123,2648,40.2,62417,32369,1266,1382
78124,5688,40.8,52337,24807,2810,2878
78125,86,51.4,46250,33209,56,30
78130,61293,34.3,54672,24256,29647,31646
78132,20370,45.3,82917,38491,10219,10151
78133,15895,49.2,59710,33909,8027,7868
78140,3341,34.6,31793,16007,1631,1710
78141,817,47.4,38304,24680,420,397
78142,146,39,50417,33751,75,71
78143,243,19,14957,7216,82,161
78144,8,-666666666,-666666666,,4,4
78145,90,28.6,27500,11394,33,57
78146,943,27.2,59205,24756,518,425
78147,1855,36.1,57931,23680,942,913
78148,20354,33.5,54691,26500,10245,10109
78150,29,19.8,-666666666,9710,29,0
78151,1524,43.8,34183,22655,690,834
78152,2514,38.6,74131,32948,1224,1290
78154,31779,36,71432,29892,15006,16773
78155,46816,38.7,49399,22858,23050,23766
78159,870,44.2,31630,18519,388,482
78160,5058,33.4,52059,24626,2435,2623
78161,788,43.3,56750,21637,466,322
78162,335,48.4,44583,29815,185,150
78163,10278,46.2,92560,38697,5024,5254
78164,4381,42.4,45737,24188,2157,2224
78201,42759,37,35282,17285,21423,21336
78202,13165,28.4,24369,12144,6308,6857
78203,5807,31.7,24846,11508,2969,2838
78204,11035,37.3,30800,19242,5586,5449
78205,1025,55.6,25903,32198,601,424
78207,53946,30.6,22605,10376,28500,25446
78208,3436,39.1,22866,12224,1871,1565
78209,40298,40.7,62525,47532,18740,21558
78210,37627,33.3,32676,15749,18330,19297
78211,34415,31.6,32985,12177,17105,17310
78212,28615,37.9,36613,27604,13874,14741
78213,42263,34.6,40727,21664,19615,22648
78214,23611,33.6,27222,13595,11821,11790
78215,1155,39.9,34836,34361,762,393
78216,38846,35.4,41792,27971,19318,19528
78217,32596,34.9,45224,25141,16172,16424
78218,32206,33.1,38812,21428,15496,16710
78219,15141,30.6,38512,16630,7114,8027
78220,16752,38.1,30605,14248,7396,9356
78221,37086,31.2,38036,14295,18217,18869
78222,21220,31.6,46000,18699,9819,11401
78223,50536,33.5,37019,16457,25180,25356
78224,18121,33.5,40028,14672,8575,9546
78225,14076,33.9,32234,13904,6352,7724
78226,6003,35.9,27936,13923,2977,3026
78227,46489,29.1,36980,14362,22563,23926
78228,58783,33.3,34992,15135,28874,29909
78229,29591,30.4,35344,22619,14165,15426
78230,40063,34.6,55936,35680,19624,20439
78231,8190,40.8,83696,43269,3877,4313
78232,37279,37.8,64741,38310,18120,19159
78233,45987,34.3,54399,21891,22280,23707
78234,7100,20.8,59665,16904,3949,3151
78235,799,21.7,48281,22062,410,389
78236,8562,20.7,60250,12835,6500,2062
78237,37719,32.8,26702,11391,18059,19660
78238,24711,34.7,44005,22079,12074,12637
78239,27787,38,53868,23680,13755,14032
78240,53145,31.4,48281,26764,25977,27168
78242,32786,26.2,35451,12132,15647,17139
78243,237,20.9,-666666666,12005,169,68
78244,30527,30.4,56946,19562,14373,16154
78245,60333,29.6,59785,20118,30054,30279
78247,49514,34.4,65921,28329,24127,25387
78248,14405,42.2,105987,53932,6954,7451
78249,50491,29.4,70689,28971,24349,26142
78250,55723,33.8,60726,24948,27009,28714
78251,51767,30.8,62482,25640,25782,25985
78252,7627,29,44143,14934,5253,2374
78253,31061,33.3,85508,31171,15602,15459
78254,47019,31.4,76649,27207,22713,24306
78255,12152,38,111307,47002,5736,6416
78256,7115,25.9,69649,43969,3903,3212
78257,4005,44.1,112202,76917,2011,1994
78258,41864,35.3,107479,47294,19525,22339
78259,22614,36.2,98669,37601,10988,11626
78260,25685,35.5,106182,39980,12601,13084
78261,13780,32.6,98729,44437,7274,6506
78263,4109,40.9,76118,28917,2023,2086
78264,12973,28.4,43200,13654,6799,6174
78266,5859,47.8,105536,48686,2872,2987
78330,774,46.6,53500,25945,403,371
78332,28128,34.3,39114,20372,14125,14003
78335,0,-666666666,-666666666,-666666666,0,0
78336,11546,45.4,39705,30949,5758,5788
78338,0,-666666666,-666666666,-666666666,0,0
78339,732,27.2,36553,10708,326,406
78340,457,50,45114,24110,250,207
78341,2568,37.3,41644,19933,1327,1241
78342,446,43.6,41210,20099,283,163
78343,4572,35.7,42875,19415,2365,2207
78344,449,43,81667,34039,232,217
78349,537,66.2,22944,15356,297,240
78351,564,37,36985,16011,263,301
78352,205,23,31369,13504,119,86
78353,627,30.5,16827,8076,380,247
78355,6832,33.1,23222,14634,3569,3263
78357,2950,34.1,51051,22753,1463,1487
78358,608,47.5,40750,19861,312,296
78359,1938,35.7,32083,15522,965,973
78361,5320,38,35928,19124,2818,2502
78362,9578,31.7,57458,22828,4842,4736
78363,30443,28.1,40413,18512,15636,14807
78368,9108,43.4,35191,19183,4331,4777
78369,440,27.9,43125,16204,223,217
78370,4170,35.2,54942,22647,2079,2091
78371,383,36.4,50179,13289,209,174
78372,5523,30.4,52208,20358,2487,3036
78373,3717,51.2,42500,33746,1905,1812
78374,16608,31.5,66236,27476,8264,8344
78375,3163,40.2,31864,15539,1724,1439
78376,758,27.9,19205,18767,422,336
78377,3647,42.7,44861,23253,1837,1810
78379,1489,45.5,40735,27686,705,784
78380,23303,38.8,39922,18284,11455,11848
78382,20500,49.1,45732,26452,10017,10483
78383,4024,52.3,51029,30363,2040,1984
78384,6329,32.1,26542,16917,3248,3081
78385,453,32.9,36736,13379,228,225
78387,10414,38.6,45855,18749,5387,5027
78389,1631,33.9,50577,19973,813,818
78390,5828,34.3,41149,19790,2821,3007
78391,322,46.7,18750,12450,138,184
78393,2431,42,44457,23821,1162,1269
78401,4728,39.3,22226,18883,2777,1951
78402,560,52.8,51958,48479,351,209
78404,15862,39.3,38862,23934,7793,8069
78405,14638,38.2,27247,12914,6946,7692
78406,1305,34.4,45781,13359,822,483
78407,2712,37.7,30179,15894,1410,1302
78408,12503,31.6,28137,13050,6067,6436
78409,3032,32.1,47105,19106,1540,1492
78410,25894,32.4,66739,28943,12874,13020
78411,27129,38.5,40349,24295,12685,14444
78412,38957,30.2,45708,23788,18883,20074
78413,36816,35.9,64159,31536,17892,18924
78414,33033,34,75971,33464,16837,16196
78415,40627,33,39915,16866,19606,21021
78416,15216,37.4,27854,14135,7041,8175
78417,4362,29.4,50069,16710,2193,2169
72022,15247,35.3,61000,28383,6825,8422
72023,35496,34.8,58802,25318,17274,18222
72024,3551,43.4,47039,22544,1727,1824
72025,857,28.7,34167,13980,537,320
72026,449,53.2,51806,27096,264,185
72027,1743,35.9,48325,23507,799,944
72029,1776,43.3,25848,17103,799,977
72030,676,50.9,53750,23474,350,326
72031,7336,39.7,32921,18566,3789,3547
72032,31710,32.9,46024,22640,15198,16512
72034,45971,29.4,52556,27225,23072,22899
72035,1713,19.5,-666666666,2509,637,1076
72036,757,47,22361,13850,294,463
72037,41,33.3,33750,18676,22,19
72038,44,77.1,9464,20357,32,12
72039,2402,40.8,33857,19838,1149,1253
72040,2949,44.2,29044,17020,1386,1563
72041,1424,42.6,33698,18775,656,768
72042,4987,41.8,35270,21739,2252,2735
72044,906,53.7,62750,29530,479,427
72045,1181,54,45966,22272,463,718
72046,4741,39.3,34375,18153,2325,2416
72047,880,35.4,49375,19874,453,427
72048,36,41.8,48958,18706,24,12
72051,482,41.9,14744,14333,309,173
72055,816,35.8,37500,19964,356,460
72057,1160,41.1,55313,22983,440,720
72058,15923,35.5,56964,22714,7979,7944
72059,26,68.6,-666666666,26496,21,5
72060,298,44,21107,14504,156,142
72061,149,42.6,82188,30028,69,80
72063,1597,40.2,40052,19248,815,782
72064,2556,45.2,40081,19851,1292,1264
72065,4550,40.5,52159,26723,2156,2394
72067,2974,54.2,38068,21482,1611,1363
72068,472,35.8,31250,17061,262,210
72069,2018,43.9,32778,18411,964,1054
72070,1802,40.9,40647,22764,863,939
72072,564,32.5,36842,17123,211,353
72073,966,40.8,35263,20946,473,493
72074,96,52.5,26250,15211,46,50
72076,38910,34.5,42377,20927,19357,19553
72079,766,44.2,34375,20873,414,352
72080,1048,31.5,42987,14291,522,526
72081,7852,42.1,40884,21421,3857,3995
72082,1922,38.5,30060,19209,902,1020
72083,260,44.8,47500,22514,132,128
72084,1582,32.8,38707,14099,699,883
72085,222,39.7,41875,15486,118,104
72086,11085,40.1,50847,22863,5698,5387
72087,1946,51.8,56042,23599,947,999
72088,2523,65.9,30697,21209,1165,1358
72099,488,21,-666666666,17434,454,34
72101,3413,42.7,31746,22029,1637,1776
72102,2299,45,47188,23336,1215,1084
72103,12925,36.2,45841,20765,6782,6143
72104,22915,39.5,39351,18952,11900,11015
72106,5630,37.5,41669,23331,2799,2831
72107,342,42.7,41875,18582,163,179
72108,26,67.4,53500,35838,15,11
72110,11924,39.1,32335,18919,5904,6020
72111,982,46.1,52250,26211,540,442
72112,11646,38.6,26983,13828,5706,5940
72113,21787,34,66266,34597,9879,11908
72114,12218,33.9,19123,12888,5636,6582
72116,21979,41.5,62717,35092,10356,11623
72117,12858,40,34813,18563,5915,6943
72118,23950,34.2,40330,19789,12329,11621
72119,79,19.3,-666666666,9254,79,0
72120,30523,38.2,58821,29455,14586,15937
72121,2428,43.8,39395,22220,1290,1138
72122,881,48.9,64583,26391,433,448
72123,373,44.3,30000,16862,192,181
72125,952,43.8,45125,18485,445,507
72126,3696,43.5,38835,24022,1775,1921
72127,2084,39,34397,21322,1005,1079
72128,802,42.4,36667,19234,431,371
72129,1286,45,32454,18487,676,610
72130,388,55.9,46211,24970,205,183
72131,5010,36.2,38317,23873,2188,2822
72132,2878,40.5,50517,24599,1270,1608
72134,442,41.5,58500,25308,209,233
72135,2528,46.1,53152,31010,1332,1196
72136,1727,38.7,47024,22948,1050,677
72137,2158,40.3,43625,19505,1121,1037
72139,281,38.2,26429,15294,114,167
72140,296,48.3,34821,20941,175,121
72141,566,35.9,29432,15728,230,336
72142,2733,45.2,54716,27539,1526,1207
72143,36293,31.6,44949,22315,18135,18158
72149,0,-666666666,-666666666,-666666666,0,0
72150,11717,39.6,53033,25008,5866,5851
72152,351,48.6,39750,23780,171,180
72153,2410,49,43033,18669,1213,1197
72156,587,48.1,24792,16551,283,304
72157,1191,51.1,32232,26935,541,650
72160,10774,41.1,39514,23613,5305,5469
72165,0,-666666666,-666666666,-666666666,0,0
72166,307,49.9,50481,21864,130,177
72167,1970,37.2,43574,18530,956,1014
72168,2283,37,36635,4209,2000,283
72169,161,54.9,36875,33434,70,91
72170,164,52.5,41250,17540,65,99
72173,9614,34.6,64144,27007,4726,4888
72175,276,44.4,20750,15537,107,169
72176,9013,32.5,47471,19421,4516,4497
72179,398,53.6,19904,12037,200,198
72181,45,58.8,52875,23316,29,16
72201,947,41.4,48947,58872,529,418
72202,10704,37.7,29509,27575,5263,5441
72204,31266,34,30451,16658,15146,16120
72205,22278,36.1,47179,30392,10952,11326
72206,24699,42.7,35104,18641,12668,12031
72207,10278,40.4,65052,51912,5036,5242
72209,31758,27.8,29601,14405,13710,18048
72210,14704,39.3,52269,27263,7064,7640
72211,22015,33.7,63415,33481,10193,11822
72212,13597,42.1,92546,46622,6394,7203
72223,20887,38.7,78378,47936,9880,11007
72227,12538,39,61021,39811,6204,6334
72301,25889,34.9,30131,17523,12229,13660
72311,172,36.5,30357,13341,102,70
72315,24120,34.4,37044,19837,11551,12569
72320,1369,40.3,6250,461,1343,26
72321,147,32.3,57500,23783,68,79
72322,282,31.6,33716,14438,186,96
72324,2048,44.6,36034,18396,984,1064
72325,26,56,45000,37558,16,10
72326,1925,49.6,26307,20813,815,1110
72327,1485,38.4,40000,17784,574,911
72328,13,60.9,-666666666,38400,10,3
72329,105,43.3,51429,15663,54,51
72330,762,29.6,30313,13903,395,367
72331,3393,31.5,28750,12617,1481,1912
72332,106,19.7,9732,5283,50,56
72333,850,31.3,28056,13034,460,390
72335,19580,35.9,31593,15098,11214,8366
72338,15,-666666666,-666666666,,7,8
72339,143,50.1,27321,13980,79,64
72340,58,56.7,-666666666,20552,30,28
72341,307,27.5,39018,18317,136,171
72342,5356,30.5,25014,16139,2700,2656
72346,685,42.6,36118,18634,416,269
72347,689,45.3,31471,19479,310,379
72348,2880,37.5,28292,15286,1508,1372
72350,1296,37.1,43000,18188,564,732
72351,655,35.7,37639,17540,330,325
72353,102,32.6,37500,13863,44,58
72354,2373,36.6,25066,14305,1191,1182
72355,2526,52.5,37635,23164,1222,1304
72358,1396,33.1,25139,13524,802,594
72359,495,36.1,14537,8809,209,286
72360,6261,37.5,21346,13094,2881,3380
72364,16185,31.7,58432,23947,7727,8458
72365,2902,45.2,31705,19673,1432,1470
72366,2424,41.8,29050,16993,993,1431
72367,116,47.7,26458,12191,35,81
72368,1346,41.8,41375,20806,737,609
72370,8505,34.4,35230,16337,4326,4179
72372,2285,37.6,41912,18530,1150,1135
72373,1585,45.6,23580,16164,835,750
72374,935,48.7,29083,17701,454,481
72376,1608,44,57786,24439,901,707
72377,18,-666666666,-666666666,,9,9
72379,61,48.1,19375,17911,47,14
72383,0,-666666666,-666666666,-666666666,0,0
72384,837,45.4,23679,21678,398,439
72386,1702,46.2,34286,20112,804,898
72389,249,31.9,20500,22275,88,161
72390,8575,34.1,23224,15022,3984,4591
72392,393,55.1,25694,18919,182,211
72394,774,29.5,29375,16513,415,359
72395,957,40.3,46625,19425,404,553
72396,13312,38.5,39963,18988,6272,7040
72401,55197,31.6,34819,20130,26610,28587
72404,23665,33.5,57950,33027,11804,11861
72410,544,41.3,14972,11878,283,261
72411,2297,38,36793,18873,1128,1169
72412,581,43.1,33409,24762,283,298
72413,658,44.5,24583,15834,339,319
72414,360,34.3,46250,17715,176,184
72415,1312,36.8,35321,16076,609,703
72416,7000,32.7,45417,18816,3501,3499
72417,3904,37.3,40603,21543,1968,1936
72419,1622,47.7,31971,17120,807,815
72421,322,51.3,32083,16869,152,170
72422,4974,47.2,26870,18323,2377,2597
72424,67,55.8,31875,20509,35,32
72425,373,33.4,23864,11984,167,206
72426,218,48.8,41250,20906,106,112
72427,193,37.5,33882,18002,130,63
72428,61,24.2,36667,15926,27,34
72429,370,52.5,38750,21058,192,178
72430,369,46.2,41042,17548,196,173
72431,464,41,27813,17504,259,205
72432,6560,38.3,30052,15388,3176,3384
72433,3168,40,32411,15386,1512,1656
72434,1857,37.2,30625,16411,907,950
72435,530,37.7,43636,20780,304,226
72436,893,38.7,36250,17473,449,444
72437,3007,40.2,34632,18703,1380,1627
72438,2587,34,38728,17110,1275,1312
72440,226,27.7,49531,16716,134,92
72441,85,57.1,40313,26175,51,34
72442,4652,39.5,36691,22457,2084,2568
72443,3325,33.6,51280,20390,1611,1714
72444,1426,45,32986,18015,646,780
72445,65,40.4,13750,11514,29,36
72447,1937,44.1,51159,22708,935,1002
72449,217,31.2,22019,14152,123,94
72450,36018,38.3,37884,19791,17730,18288
72453,122,55.3,26500,18407,64,58
72454,5242,38.7,29319,17576,2544,2698
72455,12920,40.5,37154,19724,6333,6587
72456,626,42.7,42455,23339,294,332
72457,135,55.8,26071,18859,61,74
72458,745,49.4,45469,22585,416,329
72459,1527,49.2,23696,12355,736,791
72460,573,51.6,30750,17942,264,309
72461,3566,42.8,36063,19034,1758,1808
72462,340,46.1,23125,19125,188,152
72464,64,47.8,13750,9183,27,37
72466,1677,38.9,42306,17252,840,837
72467,217,19.4,-666666666,1709,196,21
72469,1197,43.6,38879,17430,657,540
72470,150,46.4,25417,20918,79,71
72471,1049,45,35000,21105,505,544
72472,9476,37.2,31746,16261,4635,4841
72473,2604,45.9,29458,17487,1385,1219
72476,6901,38.4,29981,15608,3252,3649
72478,417,49.2,58138,19306,211,206
72479,1788,44,42684,22151,884,904
72482,1121,48.9,19969,10803,593,528
72501,24776,37.6,35022,21284,12142,12634
72512,2299,60.9,24403,17445,1056,1243
72513,2879,44.7,30917,14842,1445,1434
72515,18,-666666666,-666666666,,9,9
72517,615,37.9,32353,15042,334,281
72519,3038,46.8,30516,16245,1836,1202
72520,518,52.2,43099,12648,246,272
72521,4806,39.2,36090,16572,2305,2501
72522,545,40.6,52583,21220,249,296
72523,1083,41.7,28295,14341,516,567
72524,267,26,26750,12967,138,129
72526,157,30.1,25893,12373,73,84
72527,558,49.4,79375,29942,276,282
72528,99,28.2,-666666666,13909,45,54
72529,4552,51.2,36181,18796,2220,2332
72530,1886,44.8,32163,18757,877,1009
72531,648,61.5,33616,21482,368,280
72532,2172,42.7,32973,16382,1002,1170
72533,535,40.3,39531,14587,271,264
72534,1669,38.2,28971,20833,824,845
72536,316,42.5,33750,19428,180,136
72537,508,63.7,24839,15738,245,263
72538,456,35.1,35905,17320,250,206
72539,106,69.7,27891,17647,48,58
72540,219,37.1,40469,18951,127,92
72542,3628,46.7,31152,18922,1786,1842
72543,12643,44.4,37198,22396,6224,6419
72544,591,60.3,28542,18451,281,310
72546,246,53.9,65048,28194,120,126
72550,844,42.5,33239,18186,452,392
72553,69,39.9,37500,13219,30,39
72554,2854,50.6,35911,18991,1454,1400
72555,139,63.9,43365,19711,73,66
72556,2838,47.3,30824,20045,1335,1503
72560,8783,47.6,29731,17817,4259,4524
72561,919,51.1,37083,25197,481,438
72562,2592,39.4,38306,18926,1360,1232
72564,686,46.6,15473,11116,292,394
72565,930,51.3,31008,16415,490,440
72566,527,41.2,45417,17287,245,282
72567,399,52.9,31556,16317,245,154
72568,1362,44.1,33450,18420,671,691
72569,465,56.1,26833,18575,229,236
72571,356,42.3,17162,9738,224,132
72572,221,44.5,46563,17637,99,122
72573,257,35.3,42054,14973,118,139
72576,4331,38.4,33494,20067,2156,2175
72577,697,45.8,44583,21972,326,371
72578,342,56.5,22296,16194,173,169
72579,1043,35.3,19832,15711,532,511
72581,1091,45.2,63304,29157,555,536
72583,1645,56.6,35408,19215,830,815
72584,817,48.2,42955,20942,425,392
72585,196,24.6,46953,14764,125,71
72587,140,64.8,36618,22619,81,59
72601,30604,40.6,38345,22551,14990,15614
72611,1801,37.4,46290,22931,943,858
72616,10107,37.3,33906,18197,4806,5301
72617,199,73.3,14337,18365,89,110
72619,2042,61.4,35436,19172,975,1067
72623,795,33.6,55015,25618,369,426
72624,460,34.7,42652,21112,248,212
72626,1414,50.6,31736,20803,706,708
72628,943,43.5,21971,14285,454,489
72629,413,51.2,27833,16780,157,256
72630,181,48.8,31771,18185,82,99
72631,4586,59.6,43349,27456,2394,2192
72632,4176,54.7,36332,23852,2064,2112
72633,1893,43.5,45402,22909,1010,883
72634,4963,43.5,36127,16558,2526,2437
72635,3513,37.4,36319,16278,1643,1870
72636,19,59.5,86250,44337,10,9
72638,6784,37.2,33952,18890,3400,3384
72639,920,38.2,20139,10713,472,448
72640,363,32.6,40083,15687,141,222
72641,2636,48.6,29271,16128,1354,1282
72642,1839,67,38986,22450,978,861
72644,2419,46.5,28316,15714,1168,1251
72645,1506,50.7,23750,17044,801,705
72648,597,52.5,24615,18061,353,244
72650,4361,44.1,31045,16840,2147,2214
72651,1224,51.8,29183,17379,648,576
72653,28482,51.2,36430,22762,13357,15125
72655,396,60.5,27868,14690,206,190
72658,2128,43.2,32049,14423,1127,1001
72660,715,44.8,38654,15324,268,447
72661,307,58.6,40163,20042,186,121
72662,2674,49.8,43028,20256,1301,1373
72663,500,31,28343,13831,322,178
72666,172,52.8,25625,20784,76,96
72668,564,58.2,30500,16526,306,258
72669,188,51.4,30667,13398,88,100
72670,131,33,28482,11009,73,58
72672,247,54.9,22134,14711,101,146
72675,1197,57.3,36319,18196,534,663
72677,485,35.2,23269,12571,269,216
72679,16,-666666666,-666666666,,9,7
72680,769,46.6,28750,23495,300,469
72682,149,64.5,42708,24047,60,89
72683,248,43.9,38214,16581,98,150
72685,1413,37.4,50606,20536,705,708
72686,173,51.4,32206,12731,118,55
72687,6355,50.5,33629,18031,3042,3313
72701,40760,26.4,37006,22499,20098,20662
72703,30112,30.5,35759,31631,14981,15131
72704,21113,30.8,50953,27114,11307,9806
72712,42380,32.6,63384,34130,21696,20684
72714,12202,43.1,68348,30937,5882,6320
72715,14998,60.7,54806,32977,7093,7905
72717,780,49.4,39318,20183,491,289
72718,2069,34.4,74821,29170,985,1084
72719,9247,29.4,56719,25154,4323,4924
72721,378,42,28125,10048,251,127
72722,3171,37.7,37198,16971,1510,1661
72727,5996,37.6,45313,20171,2773,3223
72729,146,44.8,41359,22266,72,74
72730,7935,36.6,50436,24383,3860,4075
72732,4581,46.8,48162,22404,2361,2220
72734,7481,33,44878,20107,3279,4202
72736,5202,37.7,51494,20913,2629,2573
72738,2783,42.3,38548,22179,1415,1368
72739,532,26.3,36436,13719,225,307
72740,9034,36.4,36347,18218,4265,4769
72742,276,56.2,14545,14069,139,137
72744,4749,35.7,35906,17662,2480,2269
72745,11159,35.8,58192,24587,5448,5711
72747,181,23.7,60375,14639,107,74
72749,104,48.6,46806,21518,59,45
72751,5972,35,55533,22051,3244,2728
72752,372,56,28576,20767,216,156
72753,7924,40,55698,24781,3850,4074
72756,39202,36.7,44374,22847,19522,19680
72758,36055,30.8,61539,29848,17922,18133
72760,281,52.1,28750,18078,150,131
72761,22615,31.1,47779,19401,10932,11683
72762,35924,34.5,56195,25549,17325,18599
72764,52101,28.1,37637,16812,26338,25763
72768,1251,42.1,25625,15919,689,562
72769,1229,34.6,37708,16139,758,471
72773,1052,41.1,27399,16484,577,475
72774,6573,39.6,42995,21032,3337,3236
72776,720,48.1,48250,17014,377,343
72801,18252,27.5,29820,16460,8774,9478
72802,21872,40.1,48433,22851,10890,10982
72821,2109,42.7,30198,16291,1067,1042
72823,6424,37.2,40483,18097,3235,3189
72824,1817,29.7,44048,16111,872,945
72826,69,26.7,20417,10213,23,46
72827,151,60.1,21406,15999,88,63
72828,82,49.3,-666666666,30527,38,44
72830,15319,37.1,30797,18235,7585,7734
72832,1031,40.1,26429,16555,511,520
72833,4297,36.7,41512,17870,2039,2258
72834,11140,40.2,32361,17019,5610,5530
72835,759,48.2,20500,17221,409,350
72837,7752,39.8,38281,20413,3838,3914
72838,158,48.3,22292,14018,65,93
72839,205,57.1,31250,14493,81,124
72840,2062,36.6,29032,18284,1041,1021
72841,276,54.4,40882,19379,145,131
72842,1252,40.9,36667,17262,607,645
72843,2399,34.3,42365,19702,1241,1158
72845,1186,47.3,34831,30331,646,540
72846,4052,38.2,34321,21305,1801,2251
72847,2688,44.6,34871,21046,1548,1140
72851,549,51.7,48167,21061,265,284
72852,191,46.7,43382,21053,107,84
72853,2007,38.8,28262,17178,990,1017
72854,681,47.6,29318,20553,330,351
72855,5640,44.3,35741,18787,2821,2819
72856,528,52.1,31016,24773,281,247
72857,1544,41.1,31328,15065,829,715
72858,3296,34.3,49360,21465,1772,1524
72860,287,51.9,30709,18866,181,106
72863,1515,44.1,38750,19527,728,787
72865,2051,26.2,39550,14566,1230,821
72901,22822,32.1,30281,17159,11573,11249
72903,25475,41.2,45123,31565,12448,13027
72904,21217,30.8,27322,12165,9897,11320
72908,13556,38,45130,28417,6833,6723
72916,7521,40.5,66563,36670,3703,3818
72921,14208,34.6,45162,20017,6865,7343
72923,4834,34.3,44330,18370,2325,2509
72926,425,54.5,46250,25261,237,188
72927,8775,43.3,34621,19779,4248,4527
72928,526,47.4,35139,19609,268,258
72930,357,44.2,57708,24558,196,161
72932,2048,43.6,47802,18944,1137,911
72933,4551,38.4,46250,21430,2403,2148
72934,1446,41.2,43417,12177,781,665
72935,495,47.6,33125,17279,240,255
72936,14990,37.8,50926,25908,7112,7878
72937,3916,42.7,38290,18823,2034,1882
72938,1646,40.8,32426,20233,743,903
72940,1943,48,40865,20183,1001,942
72941,5906,39.5,55313,22857,2940,2966
72943,2471,45.8,37851,21567,1138,1333
72944,2934,44.3,46250,22681,1438,1496
72945,334,55.1,56429,22310,151,183
72946,3359,44.9,37151,19373,1714,1645
72947,5047,38.6,38381,16736,2671,2376
72948,384,47.6,16707,8512,225,159
72949,10084,42.2,34006,19855,4678,5406
72950,491,45.1,37656,22721,222,269
72951,1314,40.6,37478,21282,651,663
72952,2961,45,49818,19355,1494,1467
72955,226,58.5,20536,14685,139,87
72956,32685,37.1,38323,20051,15567,17118
72958,7531,37.7,35458,17369,3949,3582
72959,2920,38.9,40321,19945,1567,1353
73002,1082,34.4,38750,17647,517,565
73003,20721,33.5,61730,30693,9444,11277
73004,770,40.2,49750,27639,393,377
73005,9386,35.5,34755,15994,4485,4901
73006,3993,38.3,43578,19756,1990,2003
73007,2048,48.8,70833,38647,943,1105
73008,19867,35.4,41882,21360,9355,10512
73009,1243,40.7,46618,19445,592,651
73010,17738,37.1,57847,24734,9159,8579
73011,469,41.5,28676,21503,231,238
73012,27462,32.7,89927,37564,13297,14165
73013,46457,34.7,75741,38470,22085,24372
73014,1642,39.8,58264,26515,852,790
73015,2772,38.3,34779,18752,1388,1384
73016,1591,37.5,60250,25668,711,880
73017,1940,40.6,44236,19621,997,943
73018,20032,37.4,41475,22005,9662,10370
73019,77,19.5,-666666666,817,40,37
73020,21499,40.1,67088,29985,10256,11243
73021,271,53.6,49000,32810,140,131
73024,600,49.7,52969,25466,253,347
73025,12018,37.6,118654,49819,5842,6176
73026,11224,45,67099,35768,5757,5467
73027,1406,40.6,48000,20899,749,657
73028,3432,41,39883,22561,1687,1745
73029,1723,37.1,45045,18262,862,861
73030,4317,44.8,45660,22676,2105,2212
73032,311,45.6,29107,16291,183,128
73033,443,36.3,34500,14533,237,206
73034,41918,35.2,71516,38061,21175,20743
73036,18888,39,48938,22594,10110,8778
73038,2178,40.7,34472,20266,1136,1042
73040,1765,34.8,45769,23889,824,941
73041,332,51.8,48333,37272,161,171
73042,1002,40.8,44167,21646,510,492
73043,157,49.7,69375,25934,94,63
73044,20834,38.4,43646,20972,10448,10386
73045,10052,38.1,53583,23302,4895,5157
73047,5024,32.9,44167,15574,3144,1880
73048,1924,42,51667,24071,955,969
73049,6257,37.8,57297,26008,3074,3183
73050,824,20.7,45156,4956,432,392
73051,10072,39.8,48298,16207,6294,3778
73052,6332,36.2,47609,25279,3174,3158
73053,719,45.1,35469,20358,376,343
73054,3802,45.3,49955,24056,2000,1802
73055,9950,42.5,45216,23349,4905,5045
73056,654,42.8,54583,24191,313,341
73057,2581,39.7,39231,18709,1225,1356
73058,396,48.6,36118,29917,196,200
73059,2493,44,47981,23291,1273,1220
73061,1791,39,44547,23738,902,889
73062,1527,48.2,40391,27437,786,741
73063,663,46.5,52898,26745,329,334
73064,21415,35.2,66659,28522,10440,10975
73065,6686,38.9,72024,28499,3291,3395
73066,446,25.7,24079,12520,168,278
73067,2024,47.7,49500,26728,1071,953
73068,11175,34.7,46963,19858,5425,5750
73069,24706,30.5,41056,23957,12199,12507
73071,36983,29.5,44654,24559,18882,18101
73072,45246,27.1,56759,30193,22594,22652
73073,575,46.4,50625,27725,294,281
73074,1087,36,50903,20116,574,513
73075,9469,40.8,37308,19878,4611,4858
73077,7096,40.5,44970,21636,3434,3662
73078,8185,37.7,76090,32752,4014,4171
73079,624,32.8,56250,21073,301,323
73080,9658,38.9,49339,24352,4577,5081
73082,2442,45.2,26914,16865,1153,1289
73084,6967,40.2,30503,18088,3421,3546
73086,8385,40.2,42393,21589,4239,4146
73089,12535,37.8,62865,26157,6289,6246
73090,1697,36.5,61023,19108,1079,618
73092,954,36.7,35972,18905,485,469
73093,2754,35.1,60536,26320,1285,1469
73095,1991,35.6,46204,20899,976,1015
73096,13689,26.6,46288,23111,6830,6859
73097,238,57.4,85143,17063,97,141
73098,4446,42.4,37794,21484,2203,2243
73099,59634,34.1,65845,28238,28659,30975
73102,3418,31.8,36458,22178,2475,943
73103,4734,34.2,40343,37855,2456,2278
73104,1915,30.9,40956,30327,863,1052
73105,5647,40.1,36969,24606,2566,3081
73106,13179,31,37055,19050,7237,5942
73107,27412,32.8,35870,19212,13973,13439
73108,15221,26.8,29266,11344,8284,6937
73109,20599,32.5,27086,12464,10607,9992
73110,33142,32.4,38380,20712,15844,17298
73111,11516,40.9,22185,16016,5039,6477
73112,30958,36.1,38675,27802,14939,16019
73114,18551,29.1,30321,16629,8725,9826
73115,20783,35.3,40648,19100,9773,11010
73116,9674,38.8,67577,59478,4362,5312
73117,5621,34.9,21066,14267,2506,3115
73118,13748,35,44250,31177,6936,6812
73119,31135,29.2,30192,12628,15918,15217
73120,35891,37.6,43263,35860,16797,19094
73121,3328,50.5,49167,31465,1709,1619
73122,14330,34.6,46434,22754,7467,6863
73127,23997,32,33783,17823,12396,11601
73128,4165,34.5,59679,25666,2019,2146
73129,20304,27.1,27198,11450,10292,10012
73130,19494,41.7,59262,27269,9433,10061
73131,3037,45.8,68380,47653,1645,1392
73132,26708,35,45508,25750,12306,14402
73134,3998,30.6,56006,35010,1759,2239
73135,19692,33,48964,21976,9362,10330
73139,17600,33.1,39221,20709,8779,8821
73141,2764,34.1,37064,18657,1431,1333
73142,10477,34.4,66472,56043,4854,5623
73145,2517,22.5,41905,18624,1610,907
73149,4848,32.4,32758,14343,2453,2395
73150,4432,47.2,76830,34444,2279,2153
73151,1511,42.1,128333,54190,817,694
73159,30951,35.3,44229,20684,15461,15490
73160,54420,31.9,55697,24445,25969,28451
73162,28988,41,71131,34312,13672,15316
73165,5972,40.8,71042,31492,3131,2841
73169,1892,39.7,65117,28294,951,941
73170,36146,36.7,77740,33887,17518,18628
73173,1457,34.4,102063,37441,727,730
73179,3378,34.8,78272,32605,1629,1749
73401,35411,37.1,43066,22248,17296,18115
73425,99,38.7,28375,17353,77,22
73430,1279,49.8,55400,21530,630,649
73432,947,38.4,56429,22726,463,484
73433,2608,40,39495,23015,1247,1361
73434,524,42.5,65300,24053,254,270
73437,87,43.6,24625,13989,52,35
73438,3966,41.8,33750,18958,1717,2249
73439,7504,49.2,36124,20472,3726,3778
73440,237,64.1,75625,22584,131,106
73441,208,47,47734,15002,98,110
73442,651,45.5,46563,24926,337,314
73443,3222,39.8,52727,20539,1729,1493
73444,109,51.7,30926,29466,87,22
73446,8119,38.1,37515,18673,3994,4125
73447,1172,45.4,41689,19271,544,628
73448,6039,35.7,42138,18223,2997,3042
73449,3210,46.6,39643,21966,1538,1672
73450,1363,49.1,48523,23474,650,713
73453,477,45.9,56167,31584,201,276
73455,601,46.4,36458,20423,325,276
73456,2134,40.4,38487,19922,1083,1051
73458,1006,42.4,32885,17486,508,498
73459,980,43.8,39375,21441,502,478
73460,4630,36.5,29901,19852,2183,2447
73461,840,34.8,32857,18809,413,427
73463,3714,42.5,37500,18601,1695,2019
73481,906,44.9,46442,22429,473,433
73487,148,51.2,19063,12015,79,69
73491,862,28.5,62500,21693,445,417
73501,20086,35.7,37371,17411,11362,8724
73503,10398,21.3,35524,14932,6830,3568
73505,50737,31.8,47048,24717,24448,26289
73507,23623,32.9,47915,23543,11782,11841
73520,110,52.5,52500,24277,53,57
73521,21812,33.1,43279,22678,10806,11006
73526,2095,41.6,48406,26127,1070,1025
73527,5167,35.9,54475,24346,2503,2664
73528,557,36.1,52250,23322,275,282
73529,4968,44.5,45723,21854,2511,2457
73530,525,50.4,32250,21040,305,220
73531,392,39.8,52083,29018,209,183
73532,513,48,34671,19972,249,264
73533,28243,39.4,42602,23158,13605,14638
73537,638,53.1,36250,30064,317,321
73538,4807,35.8,61685,27534,2407,2400
73539,177,45.1,40556,33197,84,93
73540,447,44,43250,22266,253,194
73541,2879,40.6,60444,27349,1388,1491
73542,4443,38.5,34678,17362,2252,2191
73543,1928,35.2,44479,18711,943,985
73544,242,33.1,51875,25581,121,121
73546,1239,39,38507,16920,590,649
73547,2269,38.6,39750,14432,1584,685
73548,513,50.5,47292,30979,238,275
73549,406,47.3,64750,24589,211,195
73550,2504,40.7,25900,17124,1134,1370
73551,68,40.7,53125,25150,40,28
73552,1568,39.6,42788,19660,791,777
73553,23,56.5,88750,45917,14,9
73554,3466,40.7,38375,18594,1689,1777
73555,278,45,38125,13118,153,125
73556,173,39.9,44531,22052,73,100
73557,302,52.2,46786,31887,158,144
73559,604,46.6,25735,16458,314,290
73560,609,26.9,28942,17101,295,314
73562,782,49.5,37159,20870,427,355
73564,483,46.3,49688,30401,257,226
73565,1018,43.6,33696,17066,506,512
73566,1662,40.9,30586,18840,727,935
73567,672,35.8,40000,18850,350,322
73568,1155,44.9,29635,19750,515,640
73569,655,37.5,39231,17615,370,285
73570,1112,46,32381,19823,507,605
73571,126,54.8,73750,30944,64,62
73572,3752,35.4,50787,21159,1867,1885
73573,2472,44,31346,19760,1196,1276
73601,10194,33.5,44318,24060,5066,5128
73620,1140,37.9,52188,25224,610,530
73622,200,50,44783,26231,129,71
73624,2408,29.2,42112,18343,1234,1174
73625,619,48.4,44688,27565,300,319
73626,777,51.5,42500,24252,404,373
73627,461,47.2,58264,28235,247,214
73628,1849,39.7,61776,30385,952,897
73632,3432,37.9,48850,25130,1603,1829
73638,116,52,35714,37872,56,60
73639,536,47.7,42500,23981,237,299
73641,850,40.2,38571,23276,401,449
73642,140,53,46458,23531,67,73
73644,14247,34.8,52404,27132,7280,6967
73645,1320,37.7,31389,18070,562,758
73646,401,29.8,30333,16786,200,201
73647,634,40.7,48510,28649,307,327
73650,1015,30.2,55179,22561,509,506
73651,4345,37.2,38147,22456,2145,2200
73654,856,43,52596,23909,446,410
73655,735,51,39853,28335,390,345
73658,306,39,48125,31917,161,145
73659,206,49.7,58750,22718,114,92
73660,389,53.8,41250,22724,188,201
73661,441,39.1,58125,24257,224,217
73662,6964,35.1,43366,18097,4192,2772
73663,1177,44.4,45781,25015,582,595
73664,1167,42.6,38906,19647,574,593
73666,189,38.9,61429,23345,92,97
73667,576,47.9,56250,31686,280,296
73669,1768,36.7,43250,20441,830,938
73673,352,53.6,40234,26554,174,178
73701,25205,34.1,35081,17574,12428,12777
73703,27783,39,52545,30150,13444,14339
73705,276,22.1,-666666666,23546,225,51
73716,413,49.2,49479,28108,205,208
73717,6691,33.1,51233,25672,3633,3058
73718,539,41.4,58068,27129,286,253
73719,36,62,12250,36822,10,26
73720,261,44.4,60417,26543,144,117
73722,511,36.6,57500,28049,230,281
73724,1188,36.4,43594,24378,525,663
73726,599,37.2,46250,20037,313,286
73727,197,50.2,77411,39203,116,81
73728,1842,48,42813,26250,977,865
73729,567,49.9,44063,28264,293,274
73730,826,35.6,47738,23038,366,460
73731,123,63.4,46250,39616,69,54
73733,229,45.1,51944,21791,122,107
73734,993,33.2,54141,19921,490,503
73735,641,40.2,30341,23488,348,293
73736,400,44.1,65893,27157,204,196
73737,3307,45.4,48801,26221,1672,1635
73738,1218,39.9,41964,22511,650,568
73739,292,50.5,49688,29090,141,151
73741,1731,43.7,42426,15744,1386,345
73742,4167,33.9,53548,24224,2122,2045
73743,132,42.5,50000,24770,63,69
73744,226,50.1,35625,24995,91,135
73746,8,-666666666,-666666666,,4,4
73747,294,29.8,49650,29028,143,151
73749,443,52.1,40938,22645,230,213
73750,7081,42.5,56058,26467,3484,3597
73753,466,40.2,49821,30431,247,219
73754,1115,33.1,55909,23860,637,478
73755,719,45,36364,19288,357,362
73756,225,47.8,47708,28981,114,111
73757,209,39.1,80781,26555,85,124
73758,156,51,45625,35187,74,82
73759,1597,47.4,47417,27705,849,748
73760,501,40.7,61250,23754,251,250
73761,520,49,42083,22793,232,288
73762,2102,41.5,69250,33726,1091,1011
73763,1420,47,41307,23678,614,806
73764,157,50.3,71250,36040,92,65
73766,1109,36.1,48355,24398,527,582
73768,1675,36,59327,27592,827,848
73771,450,48.9,45536,27035,230,220
73772,4780,40.3,47606,17802,3064,1716
73773,1724,37.6,51125,21487,933,791
73801,15358,34.5,52661,26171,7900,7458
73832,912,50.3,48813,35409,489,423
73834,1819,42.4,45846,22543,845,974
73835,346,34.8,39583,18953,183,163
73838,488,46.6,45000,31523,237,251
73840,760,47.3,49583,24338,390,370
73841,1272,39.6,46500,11801,1008,264
73842,507,44.3,50179,24247,188,319
73843,909,47.3,48224,23514,415,494
73844,250,53.3,39464,30301,115,135
73848,1946,39.3,50197,24089,1035,911
73851,41,67.6,9375,8800,19,22
73852,2273,39.1,45357,21951,1126,1147
73853,393,52.6,48182,26452,163,230
73855,74,64.4,43750,31466,25,49
73857,693,45.7,60972,25579,372,321
73858,1626,39.6,45769,26826,782,844
73859,1621,39.2,43636,22293,829,792
73860,1519,43.7,56528,27700,778,741
73901,94,28.4,32308,26679,43,51
73931,682,37.9,67969,28544,325,357
73932,2030,42.6,48542,28801,1033,997
73933,1607,44.1,39095,24285,777,830
73937,163,40.1,38125,21292,88,75
73938,805,33.4,53917,20307,383,422
73939,1634,23.1,41875,20479,928,706
73942,13033,32.5,50902,22939,6617,6416
73944,377,38.6,42656,24644,183,194
73945,3485,31.5,54224,22134,1814,1671
73946,66,60.4,19861,15044,36,30
73947,522,47.3,36310,21910,281,241
73949,1571,37.4,47898,22134,796,775
73950,1745,39.3,52708,23163,917,828
73951,1085,28.7,43125,16762,580,505
74001,430,34.7,31667,17896,238,192
74002,2362,39.8,45182,22102,1180,1182
74003,14410,36.1,34954,21972,7016,7394
74006,25699,42.1,58680,31649,12263,13436
74008,23270,35.4,65550,32173,11522,11748
74010,10713,40.5,36236,19581,5370,5343
74011,25096,39.4,69986,34302,12277,12819
74012,58607,35.4,63005,27874,29144,29463
74014,35943,35.7,69298,28089,17949,17994
74015,8709,37.1,53995,25680,4553,4156
74016,5746,42.1,46837,21957,2833,2913
74017,26981,39.5,45611,24577,13039,13942
74019,18676,36.8,66995,27812,9594,9082
74020,7451,43.2,44955,22152,3684,3767
74021,17960,39.1,64921,26647,9015,8945
74022,1913,44.5,50060,21601,979,934
74023,11987,37.2,39597,20054,6383,5604
74026,1054,34.8,45000,19733,541,513
74027,782,44.8,34773,20330,369,413
74028,1653,41.1,40756,19519,764,889
74029,5243,36.9,38041,22865,2379,2864
74030,3637,34,34461,17962,1666,1971
74032,2253,40,54153,22318,1154,1099
74033,10515,31.3,58319,22176,4843,5672
74034,188,29.5,41302,17262,90,98
74035,4273,38,35703,15751,2636,1637
74036,6433,41,50972,25016,3097,3336
74037,15397,35,83650,32395,7527,7870
74038,2266,41.5,45920,21588,1174,1092
74039,3716,37.3,35820,18764,2005,1711
74041,2174,37.1,49167,21196,1085,1089
74042,705,29.4,37589,14611,376,329
74044,7382,39.9,48770,23621,3860,3522
74045,444,40.8,58068,29112,214,230
74046,120,47.5,26000,16632,65,55
74047,6543,39.3,50743,24018,3328,3215
74048,5991,45.4,37066,18881,2928,3063
74050,266,35.2,19712,12078,165,101
74051,1954,48,52917,27349,934,1020
74052,1378,35.6,32727,15108,639,739
74053,4441,35.7,63307,25708,2248,2193
74054,810,39.6,28869,17929,444,366
74055,39650,35.1,69181,30481,19822,19828
74056,5548,46.5,30876,19732,2712,2836
74058,4024,41.1,38031,20193,1968,2056
74059,5274,30.7,50325,20826,2689,2585
74060,709,37.6,45682,23550,374,335
74061,2108,50.5,51027,27948,994,1114
74062,890,46.4,43807,20319,454,436
74063,30376,38.4,54854,24942,14928,15448
74066,31116,38.9,44675,22844,15192,15924
74068,57,28.3,35625,10505,25,32
74070,14363,36.6,52796,23193,7170,7193
74071,122,41.2,42500,16782,67,55
74072,1971,37.8,47723,21896,1069,902
74073,5864,39.5,62582,28033,3027,2837
74074,29179,26,38578,23541,14734,14445
74075,24001,24.7,30728,19610,12032,11969
74078,2670,19.5,-666666666,2739,1306,1364
74079,4198,41.4,35975,23349,1967,2231
74080,2908,42,65625,28081,1451,1457
74081,1848,41,46583,20030,936,912
74082,92,28,33750,14047,31,61
74083,1054,45.4,41700,20570,504,550
74084,548,45.2,39625,20365,264,284
74085,2368,43,45500,23406,1157,1211
74103,1911,30,49938,12114,1610,301
74104,12572,30.8,36848,24826,6303,6269
74105,26582,40,46615,41644,12252,14330
74106,17046,32.1,20246,13642,7615,9431
74107,19635,35.7,36131,19587,9360,10275
74108,6695,35.2,43707,19443,3437,3258
74110,14291,29.8,28005,12252,7159,7132
74112,21170,36.7,40284,22007,10368,10802
74114,15795,43.4,67404,52310,7920,7875
74115,23572,30.6,31815,14290,11522,12050
74116,4359,28.7,35995,16779,2172,2187
74117,150,54.4,66188,34162,72,78
74119,3680,45.7,37977,39988,2028,1652
74120,5625,34.5,33984,30597,2961,2664
74126,10079,33.9,25191,12449,4523,5556
74127,16626,38.6,30161,17750,8156,8470
74128,12344,34.8,41721,18516,6255,6089
74129,18461,35.3,39163,19609,9271,9190
74130,2295,37.5,31489,14627,1133,1162
74131,3240,46.2,53008,30111,1716,1524
74132,8128,40.2,61917,32490,3812,4316
74133,44107,37.9,56199,34138,20233,23874
74134,16739,28.7,47775,22295,8528,8211
74135,21322,39,44859,28877,10092,11230
74136,30767,32.4,37873,30316,14232,16535
74137,26797,41,81322,53302,12957,13840
74145,18445,36.4,44367,22738,8937,9508
74146,13845,29,33764,17003,7061,6784
74301,12297,42.7,37083,19132,6161,6136
74330,2993,36,58865,22591,1501,1492
74331,6726,50.3,39422,27915,3475,3251
74332,1558,51,50278,21589,872,686
74333,1170,37,53309,21505,614,556
74337,5214,38.2,42220,20288,2669,2545
74338,5138,38.7,33285,15932,2651,2487
74339,2609,34.6,25956,13178,1230,1379
74340,182,49.5,28750,17891,100,82
74342,2471,53.9,40417,21874,1180,1291
74343,2859,46.7,41573,19463,1446,1413
74344,14327,52,36727,24288,7045,7282
74346,8376,36.2,32213,15796,4148,4228
74347,2870,35.3,42736,16880,1228,1642
74349,350,36.3,31250,19315,159,191
74350,793,41.3,29375,14463,315,478
74352,7016,37.1,42850,18249,3446,3570
74354,18409,38.2,38017,19474,8875,9534
74358,242,31.4,28750,12247,136,106
74359,664,39,35375,15805,360,304
74360,75,55.2,34583,17517,40,35
74361,16773,37.1,45741,22285,8441,8332
74363,2971,39.3,40370,17967,1472,1499
74364,1977,37.9,45256,15863,957,1020
74365,4345,42.7,31316,17004,2023,2322
74366,1430,46.4,28665,15125,652,778
74367,527,39,26250,14498,282,245
74368,40,57,22500,11798,14,26
74369,1936,44.3,47500,23366,910,1026
74370,3868,38.9,35326,17470,1947,1921
74401,18086,35.7,29330,17238,8492,9594
74403,30957,37.9,42488,21269,14868,16089
74421,4501,40.7,40500,22187,2167,2334
74422,580,55.3,50875,30432,334,246
74423,776,43,41875,22661,383,393
74425,1007,56,35000,20293,446,561
74426,9531,43.3,34475,18430,4458,5073
74427,907,53,49196,25484,502,405
74428,1217,43.1,53333,22260,678,539
74429,14257,36.8,56225,24284,7239,7018
74430,551,46.1,40662,19039,307,244
74431,970,32.3,37159,15561,497,473
74432,9966,50.3,35103,20713,5016,4950
74434,9844,37.4,49504,23665,4948,4896
74435,2932,46.2,30654,19058,1512,1420
74436,4714,39.7,40746,19788,2326,2388
74437,10321,40.6,40188,18596,5088,5233
74438,265,31.6,46875,14888,148,117
74441,5332,38.6,38482,17240,2692,2640
74442,965,41.2,51458,24887,528,437
74445,3024,38.2,50185,23720,1494,1530
74446,585,38.8,31406,17448,276,309
74447,17249,38.2,33686,18392,8748,8501
74450,1803,36,37143,19920,897,906
74451,4249,46.2,41594,25531,2007,2242
74452,457,37.1,40833,17000,218,239
74454,3088,41.1,37639,19758,1630,1458
74455,2477,50.3,24119,17748,1237,1240
74456,231,30.6,27750,16345,122,109
74457,466,45.8,21458,14594,199,267
74458,99,30.8,18542,13046,53,46
74459,75,48.9,14779,14473,36,39
74460,312,29.4,26389,13593,142,170
74462,7741,40.9,37109,20141,3892,3849
74463,2058,37.3,19167,4044,1217,841
74464,30274,31.1,33598,17431,14734,15540
74467,15564,41.7,38225,20586,7086,8478
74468,258,38.5,21932,12500,117,141
74469,2460,36.4,45286,25718,1294,1166
74470,1542,48.6,42375,22606,817,725
74471,1656,39.4,36507,16490,901,755
74472,579,40.3,27045,19475,306,273
74477,0,-666666666,-666666666,-666666666,0,0
74501,29180,39.5,44042,21958,14987,14193
74521,222,43,25000,17446,119,103
74522,253,31.4,26953,15752,135,118
74523,5702,42.9,27535,18083,2713,2989
74525,9823,38.5,34397,17456,5057,4766
74528,175,51.6,19458,26859,99,76
74530,240,40.3,43125,24235,117,123
74531,891,44.7,38693,18992,467,424
74533,818,41.5,39141,19122,424,394
74534,255,54.8,41667,21780,135,120
74535,221,37.4,43036,15323,101,120
74536,1850,41.8,31649,17575,903,947
74538,3967,42.8,31724,20201,1911,2056
74540,159,61.5,26750,30145,70,89
74543,513,33.1,30417,26291,273,240
74546,700,43.2,30357,17259,380,320
74547,3347,39.7,41643,26051,1675,1672
74549,94,50.1,31667,17594,44,50
74552,1052,43.3,32852,16654,532,520
74553,1057,46.9,35938,23234,519,538
74554,2261,39.2,41619,19267,1088,1173
74555,739,39.2,40469,19584,360,379
74556,470,33.9,33333,16802,248,222
74557,502,48.4,43571,19749,278,224
74558,513,50.6,28636,17145,259,254
74560,559,44,38816,17799,251,308
74561,2137,36.9,29255,15915,1050,1087
74562,741,47.8,35000,20563,350,391
74563,2274,41.6,47337,24513,1158,1116
74565,568,46.9,44821,25228,278,290
74567,135,67.6,28977,21859,72,63
74569,992,43.7,43036,13626,683,309
74570,1096,39.4,51667,23038,577,519
74571,3906,44.1,31080,16793,1915,1991
74572,745,39.1,37813,19285,366,379
74574,1124,56.4,33125,20371,546,578
74576,159,36.1,60313,27611,76,83
74577,259,36.1,35000,17370,125,134
74578,6400,36.4,40407,22905,3235,3165
74601,20015,34.3,36028,18249,9893,10122
74604,12108,49.8,58932,32116,5838,6270
74630,660,47.6,35583,17949,341,319
74631,7652,39.9,36380,20501,3827,3825
74632,530,51.8,41797,28839,279,251
74633,602,42.7,34412,16883,303,299
74636,247,49.9,58750,53517,122,125
74637,2181,38.3,33889,17650,991,1190
74640,307,49.7,53750,25551,156,151
74641,585,51.3,36719,24015,301,284
74643,453,39.5,43214,22991,219,234
74644,497,45.4,42188,18316,256,241
74646,276,45,29250,20773,141,135
74647,3712,43.1,42427,19458,1802,1910
74650,692,37.3,37219,19325,371,321
74651,690,34.3,48333,22910,377,313
74652,714,45,36375,20238,364,350
74653,3947,32.9,42819,19469,2006,1941
74701,22204,32.3,39912,20747,10614,11590
74720,655,37.4,36058,18338,331,324
74722,236,39.4,32222,20149,101,135
74723,1695,43.9,38641,22563,846,849
74724,504,31.1,35000,13734,262,242
74726,2073,47.8,33646,21781,1119,954
74727,2043,39.1,31103,17447,990,1053
74728,11262,40.9,33163,17861,5562,5700
74729,3115,40.8,37542,18718,1516,1599
74730,4350,39.9,40889,20985,2061,2289
74731,2172,35.6,29836,17495,1138,1034
74733,3091,38.4,38601,19169,1578,1513
74734,1182,38.8,30284,15220,570,612
74735,1630,48.6,35859,18752,766,864
74736,1134,34.9,44318,22868,518,616
74738,653,49.8,27083,15378,322,331
74740,2255,39.3,32128,18639,1177,1078
74741,940,49.6,40417,22979,536,404
74743,8351,38.9,28944,18038,4008,4343
74745,9691,35,27920,16988,4622,5069
74747,147,51.7,24250,19607,76,71
74748,572,43.3,30167,17141,309,263
74750,497,31.8,40644,13933,266,231
74753,19,-666666666,-666666666,,0,19
74754,242,44.7,26607,16027,153,89
74755,76,61.8,54239,22795,32,44
74756,968,34.9,32500,15814,470,498
74759,1307,49.2,29228,18931,667,640
74760,244,39.2,32969,12839,101,143
74761,74,48.8,22188,21445,38,36
74764,3911,41.4,33125,17357,2034,1877
74766,1388,41.9,38203,18218,645,743
74801,21920,35.8,35366,18632,10512,11408
74804,20308,34.1,44789,23293,9667,10641
74820,31149,34.9,41626,22785,15004,16145
74824,1603,30.1,43490,17705,911,692
74825,2211,38.6,46310,18764,1134,1077
74826,1100,49.2,38553,25603,555,545
74827,420,53.8,50000,29990,204,216
74829,1446,39.5,25905,6430,1116,330
74830,279,41.7,43750,15323,116,163
74831,815,49.3,35163,18963,422,393
74832,845,30,38478,17479,403,442
74833,684,39.9,42500,20499,355,329
74834,7148,41.1,43220,22623,3554,3594
74836,126,22.1,32000,11610,53,73
74837,424,38.4,34167,17311,228,196
74839,719,45,27500,14768,385,334
74840,1760,40.2,49243,22419,865,895
74842,90,51.6,48088,19480,50,40
74843,351,42.4,76125,30249,160,191
74844,271,30.4,38281,15256,127,144
74845,669,33.1,27500,15383,346,323
74848,8387,37.6,34610,16795,4760,3627
74849,3256,40.5,41232,17796,1668,1588
74850,383,36.7,45250,40118,201,182
74851,9712,40.5,50713,19258,4013,5699
74852,1265,48.5,44674,23047,701,564
74854,1609,40.1,34315,17508,721,888
74855,5258,41.8,52219,22807,2664,2594
74856,827,45.4,38869,17484,425,402
74857,7746,44.5,52428,25788,3893,3853
74859,6250,39.6,33764,17343,3126,3124
74860,1928,40.7,45368,17639,978,950
74864,5329,40.2,54361,23656,2533,2796
74865,2072,30.2,38864,20437,1072,1000
74867,1077,38.2,41250,18878,483,594
74868,13138,36.9,34466,18794,6421,6717
74869,979,45.7,43400,23498,529,450
74871,2198,39.5,42390,21063,1145,1053
74872,3664,41.3,34455,20113,1861,1803
74873,12363,38,45120,22317,6334,6029
74875,1405,31.2,33902,23221,628,777
74878,1537,40.1,38125,18820,816,721
74880,2211,45.5,36675,19494,1132,1079
74881,4053,39.6,39732,19593,2067,1986
74883,2279,45.8,28897,17282,1080,1199
74884,6092,41.5,29225,16527,2996,3096
74901,1927,41.2,23343,13587,922,1005
74902,4077,43.1,36552,17764,1921,2156
74930,1910,42.5,36111,18014,929,981
74931,1443,38.5,34886,15340,733,710
74932,2569,35.1,31250,16226,1323,1246
74935,153,40.5,23750,11088,80,73
74936,1276,39.9,38710,17410,645,631
74937,5975,32.2,34156,15675,2878,3097
74939,1433,40.2,23692,8701,1061,372
74940,2442,40,40046,18413,1146,1296
74941,2748,40.8,31383,17398,1255,1493
74942,208,43,22708,16188,116,92
74943,93,55.1,29167,16249,47,46
74944,1195,40.2,39917,17681,542,653
74945,538,34,35179,12562,256,282
74946,149,30.8,14554,8878,78,71
74948,12616,38.1,36061,18150,6239,6377
74949,315,40.9,23846,15029,146,169
74951,1530,40.8,29239,16504,696,834
74953,11747,39.7,43526,21611,6174,5573
74954,4631,33.1,40000,18480,2282,2349
74955,14782,39.3,33289,18139,7229,7553
74956,2269,36.4,40652,18796,1205,1064
74957,945,48.5,24919,17489,440,505
74959,6603,41,36976,18618,3214,3389
74960,13339,36,29786,14559,6748,6591
74962,5214,44.7,39007,18703,2602,2612
74963,734,40.1,39107,19721,375,359
74964,2721,40.9,32587,15353,1365,1356
74965,5511,36.9,37273,15949,2706,2805
74966,3653,38.6,37625,20219,1875,1778
75001,13214,32.2,57633,43919,6710,6504
75002,65900,34.8,91632,35585,30911,34989
75006,47590,34.8,56985,27010,23495,24095
75007,51405,38,78934,34664,25722,25683
75009,8975,35.4,87581,34844,4198,4777
75010,24035,34.9,75696,34545,11581,12454
75013,31388,37,131878,50803,15121,16267
75019,39551,37.9,110445,48040,19338,20213
75020,22343,41.3,40999,23846,11005,11338
75021,8306,42.7,40000,20513,3938,4368
75022,22884,38.2,145938,53645,11214,11670
75023,46733,38.7,74777,33699,23308,23425
75024,38889,34.5,88707,46453,19254,19635
75025,51924,37.5,104168,44665,25321,26603
75028,43753,37.8,111391,41480,21510,22243
75032,29965,37.1,93308,39244,15397,14568
75034,75490,34.9,111318,45004,37587,37903
75035,51444,33.8,102913,37363,25736,25708
75038,28161,30,48130,28391,14095,14066
75039,12197,32.2,73503,65135,6247,5950
75040,59792,32.4,54664,20387,29605,30187
75041,30684,30.9,40136,16646,15469,15215
75042,40185,30,39811,15085,20349,19836
75043,58120,34,55149,24046,28049,30071
75044,41578,38.9,64302,30021,19661,21917
75048,20930,37.3,87171,34473,10175,10755
75050,40652,31,44548,21322,20320,20332
75051,41345,29.4,40107,16077,20404,20941
75052,89743,32.3,66744,24938,43616,46127
75054,6256,33.3,105000,34934,3213,3043
75056,49514,33.6,79251,37078,24765,24749
75057,13749,30.2,50338,22453,7114,6635
75058,3238,37.4,79250,32815,1599,1639
75060,46409,32.6,45775,18383,22894,23515
75061,53233,30.6,40084,17739,26875,26358
75062,46200,32.3,45872,22822,22750,23450
75063,36425,32.9,69114,42679,17150,19275
75065,11033,37.3,72342,32706,5771,5262
75067,61816,30.6,56555,28271,30053,31763
75068,38950,31.5,85446,29950,19132,19818
75069,34471,35.4,45907,26614,17038,17433
75070,78837,33.8,98524,37278,38821,40016
75071,38811,34,80291,32731,19706,19105
75074,46606,32.6,54518,24303,23803,22803
75075,33884,41.5,72852,35774,16341,17543
75076,7541,50.1,52543,27862,3831,3710
75077,36560,39.1,99629,41135,17536,19024
75078,11683,34.1,119529,41067,5621,6062
75080,45616,33,60440,30713,23335,22281
75081,34286,38.1,63470,30789,16623,17663
75082,21670,40.7,111726,49169,11250,10420
75087,29630,36.2,86094,35357,14101,15529
75088,26237,39.2,81425,31831,12861,13376
75089,29640,36,86134,30587,15061,14579
75090,23833,32.3,38216,16611,11395,12438
75092,22382,38.9,50771,29044,10548,11834
75093,46990,41.6,99225,59893,23218,23772
75094,20536,35.3,116344,37905,9493,11043
75098,48611,33.8,81413,29594,23753,24858
75101,584,35.3,33438,12458,307,277
75102,1261,38.7,40455,19179,643,618
75103,13103,43.6,50286,23693,6754,6349
75104,45935,34.1,67691,29045,21648,24287
75105,205,40.3,29500,21462,135,70
75109,4191,44.7,58317,28059,2083,2108
75110,27901,34.3,40235,19246,13912,13989
75114,4548,34.7,68287,25358,2362,2186
75115,49839,39.6,61729,28055,22952,26887
75116,20135,31.3,53706,20590,9678,10457
75117,3307,45.6,41348,20941,1620,1687
75119,25867,35.2,44808,20513,12737,13130
75124,4052,40.5,47500,20706,2054,1998
75125,6959,33.1,45375,18012,3332,3627
75126,33914,32.5,85677,29754,16821,17093
75127,1459,39.6,45848,20045,734,725
75132,521,31.4,65563,31949,265,256
75134,19910,32.7,46971,18451,9295,10615
75135,5223,35.3,62800,26778,2527,2696
75137,18865,39.1,58895,27187,8721,10144
75140,6889,41.5,41111,19828,3378,3511
75141,5347,30.5,34786,14239,3231,2116
75142,18690,35.7,53809,23083,9154,9536
75143,15932,45,40135,20671,8168,7764
75144,3482,41,32289,21650,1668,1814
75146,18567,35.2,59244,22908,8714,9853
75147,8475,37.6,45227,18242,4193,4282
75148,6436,43.1,34252,19688,3059,3377
75149,58427,31.8,47739,19636,28031,30396
75150,58143,32.7,45999,22317,27282,30861
75152,5908,28.4,54659,21787,3010,2898
75153,701,47.1,38692,18784,349,352
75154,36411,35.4,66162,26109,18000,18411
75155,2670,36.6,37375,15997,1345,1325
75156,14633,48.1,37212,23702,7173,7460
75157,292,48,41042,18574,138,154
75158,4291,39,58466,23524,2258,2033
75159,18379,35.6,45479,19964,10079,8300
75160,23068,35.8,44594,22370,10862,12206
75161,6610,44.5,56148,22686,3281,3329
75163,1643,57.6,51800,46739,844,799
75164,423,35.1,56042,22511,235,188
75165,38526,34.9,59385,25047,18516,20010
75166,3723,32.7,75804,31300,1758,1965
75167,9891,36.3,76207,26885,5215,4676
75169,14334,42.3,43316,23634,6786,7548
75172,4015,33.1,39246,14773,2199,1816
75173,4601,38.7,67327,27210,2174,2427
75180,23360,27.2,37787,14716,10941,12419
75181,26200,32.1,73879,24504,12447,13753
75182,5292,42.6,90366,37243,2570,2722
75189,22192,33.7,73146,26050,10910,11282
75201,10213,31.2,67979,68037,5614,4599
75202,2133,31.5,79681,60778,1161,972
75203,15514,31.2,28602,13443,8141,7373
75204,26586,29.7,63551,51015,14261,12325
75205,23384,31,108913,84264,11165,12219
75206,37198,31,52192,42496,19551,17647
75207,9561,32.7,74792,14458,7018,2543
75208,31299,33.1,45170,24955,16401,14898
75209,15312,36.7,79408,61715,7430,7882
75210,6125,35.3,15258,9484,2942,3183
75211,73530,28,36704,13145,37192,36338
75212,25756,28,28802,10998,12638,13118
75214,33460,37.3,69168,54521,16491,16969
75215,14118,43.1,23433,16352,6912,7206
75216,49342,34.4,23294,11422,23692,25650
75217,82664,27.6,34480,12254,41341,41323
75218,22743,40.2,65567,38701,10913,11830
75219,21700,37.5,59650,56115,12062,9638
75220,43762,29.2,35827,23834,24050,19712
75223,12583,33,35949,19763,6498,6085
75224,34640,28.1,33830,14099,17287,17353
75225,20770,45.2,147153,91866,9632,11138
75226,3265,34.7,42768,29938,1803,1462
75227,56594,28.4,37720,14533,27985,28609
75228,70699,31,36274,17352,35309,35390
75229,33371,35.8,70625,41589,17288,16083
75230,27027,44.4,68863,66372,12450,14577
75231,34227,30.1,33546,25995,18042,16185
75232,27317,38.7,36265,17770,12989,14328
75233,14431,31,40151,17569,6537,7894
75234,29180,36.4,53305,25170,14380,14800
75235,18864,30.1,37530,18088,9881,8983
75236,15264,29.1,37645,18799,7382,7882
75237,17203,27.7,29787,15511,7315,9888
75238,30594,33.5,52779,32708,15145,15449
75240,27050,29.6,37095,22451,13896,13154
75241,29586,35.2,30870,14910,13774,15812
75243,56910,31.3,35944,23774,27380,29530
75244,13170,40.3,72735,44587,6751,6419
75246,2604,32.8,32254,26841,1474,1130
75247,546,56.5,23793,12170,425,121
75248,34902,41.2,72111,47620,16737,18165
75249,14172,31,57247,21416,6922,7250
75251,2945,30.2,56788,39589,1464,1481
75252,24898,36.4,54650,45903,12419,12479
75253,18370,28.2,33283,13067,9178,9192
75254,24138,30.7,44283,34646,11737,12401
75270,0,-666666666,-666666666,-666666666,0,0
75287,50416,31.6,46828,36744,24462,25954
75390,0,-666666666,-666666666,-666666666,0,0
75401,18566,32.6,31274,15338,8954,9612
75402,16029,39.1,57594,29625,7931,8098
75407,14871,35,52330,23616,7002,7869
75409,11488,35.5,61997,25509,5445,6043
75410,4259,47.6,40492,21499,2083,2176
75411,1257,35.7,61641,33613,681,576
75412,742,44.5,45508,22077,319,423
75413,235,49.3,44583,19921,119,116
75414,3424,44.4,51815,24641,1806,1618
75415,190,63.5,18529,18587,80,110
75416,2762,42.9,40685,20507,1320,1442
75417,2400,48.4,33056,18228,1194,1206
75418,13672,40,41466,18629,7584,6088
75420,924,50.2,50500,25133,536,388
75421,1112,42.1,54808,19959,566,546
75422,2659,47.1,52056,27421,1289,1370
75423,3135,39.8,47162,22978,1661,1474
75424,3548,40,48948,20837,1807,1741
75426,4802,44.9,24102,17093,2218,2584
75428,10233,26.3,27662,16280,5012,5221
75431,1761,37.3,42639,19685,902,859
75432,3503,41.6,39500,18749,1640,1863
75433,2908,38.9,47662,20916,1438,1470
75435,1526,39.3,44043,16947,791,735
75436,2076,43.3,42798,21094,969,1107
75437,1258,48.4,53977,25759,628,630
75438,932,44.3,51438,24720,496,436
75439,1017,33.5,46125,18502,508,509
75440,6721,47,44340,21968,3314,3407
75441,98,52.4,49375,30504,54,44
75442,9078,38.3,52080,24208,4361,4717
75446,3488,42.2,43542,21909,1859,1629
75447,1144,46,49527,19541,564,580
75448,493,56.5,56705,30362,265,228
75449,1315,43.3,35368,19096,637,678
75450,391,31.6,47604,20618,240,151
75451,804,53.6,43472,22924,456,348
75452,4671,37.5,56000,22293,2275,2396
75453,3040,43.9,41525,23144,1433,1607
75454,5800,31.7,87125,29919,3099,2701
75455,28492,32.8,43701,19575,14172,14320
75457,6116,40.7,39909,26517,3132,2984
75459,4541,37.1,64792,24967,2321,2220
75460,22753,37.4,29717,17603,10448,12305
75462,11650,42.2,60019,27830,5739,5911
75468,679,49.9,34405,28245,353,326
75469,418,35.5,28750,16332,192,226
75470,243,51.3,28611,17620,120,123
75471,1204,45.1,42321,19039,548,656
75472,3652,45.2,45179,21551,1981,1671
75473,4350,43.7,49651,21477,2203,2147
75474,14631,44.6,44976,22978,7408,7223
75475,228,48.2,24286,14545,126,102
75476,1067,46.2,57857,23556,552,515
75477,893,39.4,30563,16967,434,459
75478,1046,48.8,47083,26118,513,533
75479,1743,42.1,42695,21340,818,925
75480,2001,41.8,60658,30875,961,1040
75481,425,37.5,34409,22530,254,171
75482,25000,37.4,42494,21449,12289,12711
75486,2260,35.4,55089,21872,1187,1073
75487,1221,45.3,43750,21261,541,680
75488,1069,46.3,32042,17645,565,504
75489,1033,33.2,51518,22644,489,544
75490,2332,39.1,57375,22864,1109,1223
75491,5214,41.9,50158,24986,2491,2723
75492,486,49.5,50962,23953,278,208
75493,582,29.4,31607,12197,282,300
75494,10010,47.1,40427,22813,5016,4994
75495,6737,42.6,65158,29603,3418,3319
75496,3460,44.3,39175,22056,1724,1736
75497,3406,57.5,48722,30090,1796,1610
75501,36752,36.4,34355,18630,18753,17999
75503,24633,39.6,57752,32348,12023,12610
75550,993,44.9,36250,20723,562,431
75551,10547,44.3,38043,21587,4561,5986
75554,1727,46.3,45536,21696,821,906
75555,1560,46.8,48375,22538,828,732
75556,920,42.6,33092,22025,512,408
75558,1733,37.4,62929,20770,834,899
75559,5922,40.6,40640,20234,2943,2979
75560,1088,40.7,31970,20220,566,522
75561,5337,38,40650,20166,2611,2726
75562,77,86,-666666666,9203,39,38
75563,4511,42.3,32292,17483,2390,2121
75565,390,29.4,44375,15189,173,217
75566,882,54.2,22969,15585,466,416
75567,4321,40.7,50386,20839,2177,2144
75568,2634,45.6,29725,21613,1390,1244
75569,2987,27.8,37534,23474,1312,1675
75570,10583,39.9,47068,20018,5968,4615
75571,2869,49.1,38688,25183,1347,1522
75572,3980,41.3,36026,19609,1698,2282
75573,31,44.8,14519,18623,17,14
75574,2130,37,42061,19322,1056,1074
75601,16078,36.5,42284,24554,7764,8314
75602,22367,29.4,31977,16125,11904,10463
75603,5842,47.3,47646,26685,2990,2852
75604,31332,32.4,49043,24146,15397,15935
75605,28650,41.4,54707,31435,13876,14774
75630,2566,58.4,29233,20941,1248,1318
75631,2627,40.2,51023,28155,1200,1427
75633,15253,36,53715,26804,7244,8009
75638,6176,44.4,41013,20087,3129,3047
75639,2707,42.9,50086,24101,1438,1269
75640,4052,42.8,54423,22459,2250,1802
75641,227,42.7,30417,14759,98,129
75642,138,34.6,-666666666,19375,53,85
75643,2230,38.4,45000,22730,1163,1067
75644,11485,39,41090,22063,5479,6006
75645,10136,40.7,56098,24021,5081,5055
75647,13431,40.1,45826,22967,6560,6871
75650,7972,40.1,59274,28367,4098,3874
75651,2905,33.2,43364,17543,1439,1466
75652,16185,39.4,42778,19036,9656,6529
75654,12300,38.4,49798,23551,6045,6255
75656,4933,34.7,40054,17612,2458,2475
75657,7960,44.5,33108,21066,3878,4082
75661,2601,49.2,37357,21108,1475,1126
75662,24768,35.5,46462,23989,11368,13400
75667,989,48.3,42500,25991,485,504
75668,1974,31.1,26541,14185,904,1070
75669,651,51.7,63625,28405,331,320
75670,18448,31.4,30005,18037,8883,9565
75672,17080,38.9,49598,24171,8180,8900
75681,2539,46.7,37442,20615,1219,1320
75682,616,38.4,36216,16775,265,351
75683,3993,45.3,43816,18929,2133,1860
75684,8114,36.5,40988,17783,4113,4001
75686,12977,38.6,36278,19662,6321,6656
75691,3554,34.4,57664,27843,1811,1743
75692,4682,43.1,50285,27014,2239,2443
75693,6743,38.8,57618,24744,3349,3394
75701,35348,33.6,42627,25767,16140,19208
75702,26684,30.3,32457,14366,13175,13509
75703,36801,37.1,52011,34951,17425,19376
75704,8714,37.3,39527,18635,4239,4475
75705,2111,42.9,32083,18624,1181,930
75706,9500,30.7,39697,16036,4929,4571
75707,14906,38.6,56559,33755,7115,7791
75708,6463,36.2,35500,14540,3567,2896
75709,5392,40,53598,25320,2610,2782
75750,3594,39.9,57964,26300,1586,2008
75751,17235,35,40682,20335,8477,8758
75752,6647,43,44940,21647,3333,3314
75754,5784,44.7,42759,21552,2854,2930
75755,5896,37.3,42467,19170,2716,3180
75756,3752,39.3,44535,20184,1756,1996
75757,10662,41,54451,27711,5159,5503
75758,8613,43.9,45177,24073,4041,4572
75759,148,41,22250,10368,95,53
75760,2255,43.6,49559,28121,1178,1077
75762,12900,38.7,65819,33097,6410,6490
75763,6499,42.5,46813,22847,3244,3255
75764,111,39.8,35833,16746,49,62
75765,8101,48.1,50276,24287,3847,4254
75766,25952,35,33053,17632,13072,12880
75770,3327,44.5,46188,20834,1686,1641
75771,18912,38.5,55283,24156,9190,9722
75773,12343,46.5,42726,21820,6038,6305
75778,3534,50,41288,20412,1838,1696
75779,161,35.7,39911,25557,91,70
75780,187,28.6,19000,15126,116,71
75783,7486,45.1,40322,23210,3684,3802
75784,704,41.6,39038,16109,276,428
75785,11457,37.6,43043,16030,6516,4941
75788,172,23.8,51464,31391,64,108
75789,6998,43.4,59081,25856,3245,3753
75790,4109,34.7,39861,18230,1882,2227
75791,13459,33,68630,26967,6556,6903
75792,3346,36.2,38750,20503,1592,1754
75801,16186,37.9,39854,23100,7972,8214
75803,24714,37.3,41067,16188,15972,8742
75831,5920,39.9,50575,21269,2905,3015
75832,41,-666666666,-666666666,,20,21
75833,3392,49.3,45114,22489,1662,1730
75835,11514,43.2,29086,19273,5648,5866
75838,671,55.5,48359,21334,401,270
75839,5204,38.8,42569,23019,2662,2542
75840,7111,41.8,43723,25763,3471,3640
75844,6166,46.3,36631,25594,3190,2976
75845,4486,33.8,33841,14138,2049,2437
75846,2938,39.2,41622,20190,1459,1479
75847,1948,43.4,36968,18831,944,1004
75848,105,43.7,65417,25478,53,52
75849,200,57.4,21813,11600,130,70
75850,691,37.9,70132,23132,357,334
75851,4529,44,38309,11883,3115,1414
75852,4773,29.7,47303,7820,4059,714
75853,1236,37.1,32098,15004,606,630
75855,2308,53.6,38112,21593,1215,1093
75856,221,56.9,24658,30282,131,90
75858,51,64.1,56250,31073,23,28
75859,2140,43.2,58403,28599,1009,1131
75860,6142,39.6,46888,19336,3631,2511
75861,6119,39.5,57589,8267,5130,989
75862,8552,53.1,35011,20467,4065,4487
75901,29847,33.9,41809,21398,14682,15165
75904,33824,36.5,39265,22095,16042,17782
75925,4449,41.3,40971,21317,2064,2385
75926,1136,44,36100,22219,602,534
75928,1038,36.3,35292,15864,501,537
75929,1630,53.6,31366,21942,804,826
75930,1833,48.9,22902,17078,843,990
75931,2321,47.5,46528,28235,1108,1213
75932,1738,54.7,45231,24986,853,885
75933,1358,39.8,43056,15007,661,697
75934,27,79.1,11250,15593,12,15
75935,14124,35.8,38668,20995,6935,7189
75936,1154,42.4,49000,24549,600,554
75937,924,45.5,42067,23623,439,485
75938,2447,45.1,41011,20622,1137,1310
75939,4032,36,39123,17884,2060,1972
75941,10388,35.3,45979,16107,5580,4808
75942,289,38.1,43512,15008,120,169
75943,1305,44.2,56563,25739,699,606
75944,1288,45.4,42500,22042,615,673
75946,3474,45.3,43875,24891,1820,1654
75948,6188,49.1,34651,18684,2995,3193
75949,7130,37.9,38165,21038,3557,3573
75951,16139,40,33700,18248,8139,8000
75954,2977,39.1,40455,24931,1368,1609
75956,7281,40.2,42644,19968,3336,3945
75959,1080,50.1,28419,21588,518,562
75960,858,46.6,37417,24598,444,414
75961,15085,32.1,29413,18705,6774,8311
75962,3432,19.7,-666666666,2532,1390,2042
75964,19648,32.8,35827,17313,9559,10089
75965,18589,27.8,39651,25759,9240,9349
75966,4236,37.5,29595,17474,2244,1992
75968,1938,40.2,32672,15588,1039,899
75969,3401,39.4,57143,21671,1557,1844
75972,6410,47.8,28338,18964,3076,3334
75973,2565,47.8,42645,25517,1281,1284
75974,2898,36.4,30440,19315,1369,1529
75975,3678,36.9,35285,19172,1898,1780
75976,935,32.3,29464,15520,399,536
75977,1627,30.6,43056,15793,729,898
75978,87,42.6,98333,22676,31,56
75979,11576,39.9,37194,16125,6790,4786
75980,2717,53.6,39828,19602,1340,1377
76001,31653,32.4,74587,29166,15141,16512
76002,30925,31.9,79376,26199,15161,15764
76006,23472,31.7,44363,31994,12128,11344
76008,14320,40,102951,41407,7004,7316
76009,19560,37.7,51696,21022,10019,9541
76010,56512,26.1,31108,13006,29249,27263
76011,22540,29.1,34412,20630,11203,11337
76012,25891,39,56627,32335,12577,13314
76013,31149,35.4,50220,29567,15662,15487
76014,35175,28,42558,16040,16936,18239
76015,16358,34.9,47902,26762,7503,8855
76016,31599,42.3,81635,38558,15183,16416
76017,42792,36.4,68538,32209,20797,21995
76018,27765,30.1,64403,22441,13649,14116
76020,26909,42.6,57457,29642,13806,13103
76021,34655,41.2,65134,37508,16651,18004
76022,12938,38.9,53793,29401,6179,6759
76023,5781,42.6,49441,23944,2883,2898
76028,62637,36.3,69676,30118,30381,32256
76031,17360,36.1,46714,20226,9062,8298
76033,24258,36.1,53523,23230,11853,12405
76034,23528,45.6,152986,70450,11576,11952
76035,1477,41.1,84732,49115,775,702
76036,22396,35.3,64852,27217,11150,11246
76039,32626,34.4,58320,32482,16118,16508
76040,29699,32.3,45748,23394,15131,14568
76041,174,42.5,57750,29137,103,71
76043,7420,39.2,54925,27385,3636,3784
76044,3777,36.6,59833,29330,2004,1773
76048,22835,42.4,48668,25526,11369,11466
76049,24179,49.8,64254,34154,11927,12252
76050,5939,40.8,62723,30928,2925,3014
76051,47488,37.6,76216,38674,23071,24417
76052,16537,33.4,93031,33227,8260,8277
76053,28767,33.1,44977,22473,14538,14229
76054,11250,46.8,93763,41686,5338,5912
76055,2857,40.4,48142,23409,1446,1411
76058,18323,32.9,56151,23016,9039,9284
76059,5171,27,36579,14883,2261,2910
76060,6994,41,74375,31132,3750,3244
76061,182,66.9,-666666666,16432,139,43
76063,62321,35.6,92052,35475,31121,31200
76064,1550,37.4,77500,28058,841,709
76065,29127,35.2,81793,31340,14292,14835
76066,3628,41.1,80088,29608,2030,1598
76067,21997,35.2,40367,20362,12012,9985
76070,591,47.6,56382,27442,268,323
76071,3683,40.3,63750,27265,1807,1876
76073,5409,40.8,54109,26914,2810,2599
76077,477,58.5,91875,40935,271,206
76078,8959,33,64280,24413,4606,4353
76082,18598,38.4,58255,24820,8901,9697
76084,8223,35,54599,18277,4567,3656
76085,8061,41.1,60291,27043,4102,3959
76086,20863,33.9,48176,22315,9465,11398
76087,24842,41.5,74898,36363,12380,12462
76088,12097,40,64093,29878,6172,5925
76092,27236,41.6,173507,71064,13640,13596
76093,2036,38.2,59195,23652,1011,1025
76102,9122,32.7,50177,30124,5032,4090
76103,14330,35.4,39513,17641,7333,6997
76104,16020,33.3,22221,13473,7906,8114
76105,21626,26.8,24526,10065,10567,11059
76106,36761,27.6,31391,11712,18845,17916
76107,25810,36.2,51370,43192,12727,13083
76108,38783,35.1,58528,28562,18900,19883
76109,21764,35.2,58704,48672,10281,11483
76110,31023,30,39600,20412,15421,15602
76111,21029,31.7,40511,17578,10619,10410
76112,39447,35.5,36820,21818,18597,20850
76114,25051,32,37752,17439,12209,12842
76115,21695,26,27806,10309,10991,10704
76116,46488,34.1,41573,27701,23057,23431
76117,31010,34.4,39054,17749,15472,15538
76118,14699,38,62282,27524,7486,7213
76119,42440,31.2,28660,12790,21880,20560
76120,17578,30.6,39714,21351,7855,9723
76123,30398,32.3,81008,27115,14110,16288
76126,20261,42.1,76330,36997,9625,10636
76127,1964,38,173500,12238,269,1695
76129,2749,19.6,-666666666,3697,1161,1588
76131,31311,30.5,77413,27360,14990,16321
76132,24747,35.1,49437,41589,11171,13576
76133,50558,35.4,51123,23116,23810,26748
76134,24297,31.7,48534,19076,11677,12620
76135,20550,39.8,52945,27715,10022,10528
76137,54345,33,66306,29077,26907,27438
76140,27671,31.6,50739,19906,13356,14315
76148,23959,33.5,59394,22809,12009,11950
76155,3643,33.4,45675,32108,1730,1913
76164,17739,30.1,34574,12524,9346,8393
76177,5306,31.4,81755,35851,2547,2759
76179,49578,32.3,75472,31858,24426,25152
76180,33674,35.5,52086,27449,16304,17370
76182,29602,39,82038,35623,14109,15493
76201,26557,22.5,22342,15661,12209,14348
76205,18680,28.2,41371,24532,9463,9217
76207,11477,36.8,61377,29528,5409,6068
76208,19644,34.9,70890,29463,9595,10049
76209,25756,30.8,48237,22069,12844,12912
76210,41180,33.4,80407,31366,20232,20948
76225,3377,39.5,62554,25862,1822,1555
76226,19896,36.6,116101,47582,10027,9869
76227,23268,32.2,77386,29194,11486,11782
76228,1042,47.8,46620,26542,525,517
76230,9827,40.8,43390,23679,4641,5186
76233,3334,38.4,63697,26925,1698,1636
76234,15372,38.5,58848,29535,7578,7794
76238,397,40.9,57583,29099,222,175
76239,1050,47.6,56875,26374,586,464
76240,26332,38.1,47663,23778,12877,13455
76244,64081,31,93705,31702,30649,33432
76245,1508,55.4,32157,22112,797,711
76247,12283,36,77968,27492,6254,6029
76248,35660,39.4,111606,42602,17983,17677
76249,6777,35.9,75250,30066,3170,3607
76250,936,39.6,84545,31910,443,493
76251,733,47.8,57321,35601,451,282
76252,3092,38.1,62054,31287,1622,1470
76253,218,49.3,41250,24407,80,138
76255,5352,48.6,36082,23181,2679,2673
76258,6022,40.3,53438,25417,3312,2710
76259,4831,38.7,76021,26987,2305,2526
76261,367,45.4,58500,24397,162,205
76262,30940,36.9,88114,43647,15427,15513
76263,27,61.1,60833,23315,17,10
76264,1259,42.1,49650,31507,630,629
76265,1815,40.8,47500,25641,820,995
76266,14729,34,63416,25588,7345,7384
76268,201,25.4,48203,18107,108,93
76270,1770,45.8,55028,31113,1053,717
76271,1310,39.2,47981,22275,651,659
76272,4980,44.1,52763,24149,2431,2549
76273,8562,43.9,44190,22947,4110,4452
76301,17052,31.9,31565,16996,8131,8921
76302,13126,32.6,44066,23155,6186,6940
76305,4510,46.9,53525,25693,2314,2196
76306,15200,35.3,41765,20886,7155,8045
76308,19509,34.6,46546,31835,9155,10354
76309,13293,37.8,46038,25437,6552,6741
76310,18492,37.2,63646,27924,9288,9204
76311,5925,20.7,56767,15369,4583,1342
76351,1760,42.7,42961,23868,884,876
76354,11256,37.1,49031,23478,5622,5634
76357,626,47.1,36683,21105,278,348
76360,3457,46,43958,21966,1588,1869
76363,245,42.1,21488,21675,143,102
76364,168,51.6,36912,23747,94,74
76365,4813,44.5,54517,26648,2370,2443
76366,2298,43.4,59732,30445,1161,1137
76367,14596,37.6,50879,16001,9560,5036
76370,266,51.6,36771,19594,99,167
76371,1633,41.9,34250,18989,846,787
76372,916,47.6,39141,21732,447,469
76373,281,36.4,45948,15359,124,157
76374,3916,42.1,29965,17965,1952,1964
76377,787,41.3,48750,22710,386,401
76379,715,37.5,46667,20257,368,347
76380,3743,48.9,33689,28085,1802,1941
76384,12748,37.9,41050,20304,6406,6342
76388,303,44.5,34493,17635,190,113
76389,1332,41.1,58906,24096,675,657
76401,26435,29.6,37194,21142,12573,13862
76402,947,19.4,-666666666,4267,520,427
76424,8961,38,42194,19918,4787,4174
76426,10901,38.8,52328,23192,5513,5388
76427,1225,29,34014,15343,537,688
76429,131,51.5,96875,46194,71,60
76430,2721,40.9,51105,24037,1340,1381
76431,3525,43.1,51941,22797,1741,1784
76432,1172,47.7,41563,21767,599,573
76433,1808,38.2,61953,25898,815,993
76435,569,43.3,34226,18117,299,270
76436,102,60.6,61500,30362,50,52
76437,5736,38.1,41000,20991,2839,2897
76442,7898,42.7,35074,19040,3776,4122
76443,1813,39.9,38472,21039,883,930
76444,3327,41.7,35833,18942,1736,1591
76445,343,52.7,45050,21789,149,194
76446,8295,40.2,37589,22110,4367,3928
76448,5330,48.2,35949,27777,2686,2644
76449,2351,50.8,41797,29927,1089,1262
76450,13652,43.1,49066,30022,6731,6921
76452,76,17.5,70208,8596,42,34
76453,1082,51.4,45000,27341,549,533
76454,1406,48.6,26017,15704,608,798
76455,995,38.8,42500,20309,521,474
76457,4501,40.7,44595,21065,2364,2137
76458,5962,37.8,49306,23729,3590,2372
76459,182,47.1,31875,23074,82,100
76460,447,54.8,65536,35832,219,228
76462,3221,37.7,59375,31063,1659,1562
76463,624,52.3,34688,22932,318,306
76464,442,50.1,38984,29058,219,223
76466,161,58.6,69732,64074,77,84
76469,20,58.5,27000,15740,7,13
76470,3557,30.9,30918,14427,1769,1788
76471,2020,49.6,31317,17172,1020,1000
76472,1282,44,41935,21947,527,755
76474,288,49.3,73207,36293,137,151
76475,824,49.9,40774,30690,411,413
76476,2789,37.1,62974,26321,1353,1436
76481,184,18.8,-666666666,6205,105,79
76483,840,50.8,37596,27356,406,434
76484,1021,55.3,47847,29804,526,495
76486,1267,51.4,53906,30833,687,580
76487,1901,48.2,54872,27322,1030,871
76490,125,29.9,107344,35686,66,59
76491,584,35,35833,17306,307,277
76501,16869,39.3,40237,19990,7868,9001
76502,33305,37.4,62939,31593,16328,16977
76504,23039,35.4,37951,20123,11408,11631
76508,7,21.5,-666666666,7086,3,4
76511,2409,36.2,38194,17991,1376,1033
76513,35001,32.8,57545,25762,17162,17839
76518,1542,35.6,38098,18117,669,873
76519,853,39.6,29821,19358,444,409
76520,7813,41.9,36259,21182,3989,3824
76522,36207,32,54493,22988,17423,18784
76523,0,-666666666,-666666666,-666666666,0,0
76524,3494,34.1,54783,21970,1601,1893
76525,1113,44.9,42750,21032,543,570
76527,3965,35.5,44977,25734,1941,2024
76528,18519,38.3,46996,20764,7991,10528
76530,2410,46.3,50463,26875,1249,1161
76531,4685,51.1,40509,25216,2209,2476
76534,2185,38.5,49375,23717,1084,1101
76537,4075,31.3,54479,25003,2073,2002
76538,876,41.5,51250,23425,425,451
76539,8042,38.3,56696,25117,3787,4255
76541,18976,30.9,28946,15939,10030,8946
76542,40797,29.1,57884,23492,19725,21072
76543,29588,27.7,39704,19586,13684,15904
76544,33143,21.8,41700,15336,20032,13111
76548,26965,32.1,63792,25885,13455,13510
76549,48388,26.2,52400,19840,24086,24302
76550,11814,41.7,45526,21965,6000,5814
76554,1955,38.3,48241,20835,1052,903
76556,1392,50.7,39375,21201,672,720
76557,4877,37.2,47384,20756,2406,2471
76559,4898,29.4,53687,19558,2150,2748
76561,1040,39.3,53750,25003,444,596
76565,52,73.2,31364,19417,21,31
76566,212,38.4,50962,19445,82,130
76567,9097,37.8,36453,21274,4288,4809
76569,1943,38.2,57955,22548,1050,893
76570,2856,45.5,31691,18456,1514,1342
76571,5747,45.8,92222,43009,3131,2616
76573,16,-666666666,-666666666,,5,11
76574,18037,39.1,45011,21691,8922,9115
76577,3349,44.1,45855,23799,1668,1681
76578,1709,40.6,57857,23559,937,772
76579,4628,36.8,63942,24949,2314,2314
76596,999,35.7,-666666666,512,130,869
76597,1971,39.4,-666666666,5736,1858,113
76598,410,33.3,-666666666,1688,70,340
76599,1480,35,-666666666,8815,277,1203
76621,1021,45.4,57361,26652,507,514
76622,1161,43.3,42231,22105,496,665
76623,145,37.7,41250,15286,59,86
76624,2150,38.9,49863,22496,1104,1046
76626,1841,38.3,49364,21431,803,1038
76627,1616,38.2,42917,20300,742,874
76628,91,38.1,16406,7620,37,54
76629,1895,46.4,49583,25717,961,934
76630,1567,36.7,47857,23327,784,783
76631,516,43.7,66964,28599,266,250
76632,1407,39,33371,16612,659,748
76633,6072,38.7,68618,29908,3134,2938
76634,6488,51.3,47315,26659,3113,3375
76635,1425,29.7,29327,13999,840,585
76636,1535,41.6,48875,23365,785,750
76637,587,47.4,42292,33499,268,319
76638,3083,41.2,77679,36692,1661,1422
76639,1449,48.3,32778,18864,713,736
76640,3183,32.4,37651,17644,1731,1452
76641,1724,39.3,40238,18869,753,971
76642,7273,35.3,42778,18568,4115,3158
76643,13724,37.2,66898,27626,6489,7235
76645,11339,35.1,32234,18942,5710,5629
76648,2565,43.9,39833,19558,1183,1382
76649,770,49.7,41250,28168,411,359
76650,68,60.2,37500,21765,31,37
76651,3247,40.2,50457,23501,1597,1650
76652,958,50.3,37647,21797,500,458
76653,877,49.6,37303,22135,428,449
76654,115,39.5,58958,29654,66,49
76655,9000,40,75104,30492,4488,4512
76656,2595,34.2,38456,18033,1271,1324
76657,8970,37.6,62058,29185,4292,4678
76660,466,47.1,41818,19226,229,237
76661,7984,38.9,28346,12085,3414,4570
76664,3258,37.3,34983,17432,1717,1541
76665,2615,42.7,42616,20033,1305,1310
76666,154,66.4,45000,25306,69,85
76667,11407,36.8,36663,18731,5564,5843
76670,1268,43.5,49667,22787,630,638
76671,2063,50.6,46509,25665,1040,1023
76673,1233,46,48571,19939,652,581
76676,409,39,41333,20503,231,178
76678,218,62.4,19286,19471,103,115
76679,1356,40.6,35694,21388,733,623
76680,396,33,55956,18244,214,182
76681,574,50.1,40577,24937,323,251
76682,2675,39,40234,20203,1278,1397
76685,4,-666666666,-666666666,,4,0
76686,237,45.3,36964,23297,114,123
76687,1825,49.8,48032,22213,919,906
76689,3721,37.8,49722,23895,1882,1839
76690,1012,40.5,39022,18573,501,511
76691,6165,41.7,50000,24423,3009,3156
76692,9848,47.6,42965,22519,4714,5134
76693,1504,41.3,37661,21742,747,757
76701,1715,28.3,25372,13362,1093,622
76704,8097,27.6,17166,10383,3607,4490
76705,29007,33.1,37609,18427,14643,14364
76706,36055,22.6,26398,14613,17134,18921
76707,15501,28.2,32021,13107,8009,7492
76708,26028,32.7,40477,20000,12781,13247
76710,22659,37.6,37195,27028,10459,12200
76711,8042,34.4,31134,19054,4153,3889
76712,24080,40.7,68413,31886,11521,12559
76798,1835,19,-666666666,1331,327,1508
76801,24687,38.4,37180,21460,12188,12499
76802,5294,38.4,47196,20046,2777,2517
76820,124,49.7,45500,19730,64,60
76821,5017,41.3,34324,20320,2493,2524
76823,3544,41,40807,18193,1704,1840
76824,0,-666666666,-666666666,-666666666,0,0
76825,7187,39.9,38243,19724,3508,3679
76827,277,47.8,60625,23216,144,133
76828,163,32.7,26094,22985,97,66
76831,74,48.7,-666666666,38508,24,50
76832,568,46.8,44464,21171,344,224
76834,5796,45.6,30000,18199,2791,3005
76836,8,68.3,-666666666,13475,5,3
76837,3124,39.8,50685,16833,2255,869
76841,28,43.6,-666666666,,20,8
76842,78,56.9,39196,52277,55,23
76844,3685,46.1,43421,22488,1782,1903
76845,167,48.2,39167,32696,86,81
76848,91,55.3,44167,31442,42,49
76849,4005,50.5,43421,24672,1956,2049
76852,228,57.6,42155,28953,135,93
76853,1411,47,33056,19610,688,723
76854,228,51.8,20391,13982,101,127
76856,3747,50.1,46471,27035,1862,1885
76857,2156,48.2,53563,23248,987,1169
76858,333,46,37895,22668,164,169
76859,2035,43,30833,17965,1074,961
76861,2282,41.9,50938,23882,1177,1105
76862,364,53.2,64773,29550,204,160
76864,689,45.2,47917,21887,350,339
76865,153,60.1,43250,21318,72,81
76866,486,57.6,42222,30527,245,241
76869,22,-666666666,-666666666,,13,9
76870,222,34.9,31979,15491,111,111
76871,927,34.3,43750,16699,432,495
76872,608,59,55550,28368,262,346
76873,78,56.5,85625,54473,55,23
76874,61,26.8,-666666666,32197,61,0
76875,655,41.8,41146,22378,315,340
76877,4447,42.2,33599,17233,2451,1996
76878,1766,44.6,30950,17878,878,888
76882,261,58.9,60188,21757,158,103
76884,130,49.8,100735,38272,70,60
76885,113,38.1,-666666666,30043,53,60
76887,133,54.2,62045,34729,75,58
76888,67,62.9,26705,12157,37,30
76890,977,49.9,55673,28624,471,506
76901,27527,35,46111,24329,13675,13852
76903,32388,34.3,33533,17200,15545,16843
76904,32554,35.3,54537,31299,15891,16663
76905,12582,32.5,50674,19745,5713,6869
76908,2618,21.5,23875,19639,2005,613
76930,120,50.1,50694,23333,50,70
76932,3571,33.9,59792,28303,1906,1665
76933,1324,43.6,43295,21629,599,725
76934,1462,42.9,45217,18493,828,634
76935,1466,39.2,63636,27113,684,782
76936,3268,35.4,50602,24598,1608,1660
76937,18,-666666666,-666666666,,8,10
76939,94,33,47000,35132,59,35
76940,56,59.5,-666666666,32930,21,35
76941,1436,40.7,47159,28497,718,718
76943,3719,40,49643,22163,1889,1830
76945,1625,50.1,38839,21564,824,801
76949,20,76.4,-666666666,42580,15,5
76950,4069,35.5,53500,27732,2013,2056
76951,1358,39.8,50543,20157,725,633
76953,29,75.4,22625,25031,26,3
76955,0,-666666666,-666666666,-666666666,0,0
76957,0,-666666666,-666666666,-666666666,0,0
76958,279,42.1,104107,41472,156,123
77002,11602,32.5,64093,37292,9469,2133
77003,10617,30.8,36412,27263,5443,5174
77004,31593,30.3,41983,29776,15704,15889
77005,25752,38.5,159732,92258,12995,12757
77006,20573,35.1,67458,61809,11203,9370
77007,30868,34.6,98725,70544,16148,14720
77008,30807,35.9,70293,52350,15822,14985
77009,39725,34.1,44651,26540,20345,19380
77010,564,41.7,250001,200208,306,258
77011,19442,33.2,26838,11658,10190,9252
77012,21868,30.5,34975,13526,11757,10111
77013,19246,28.6,36829,14375,10791,8455
77014,30665,28.2,40659,17821,14616,16049
77015,57096,28.5,44167,16671,29051,28045
77016,27010,40.7,31327,14299,12831,14179
77017,33259,31.2,35586,15572,17530,15729
77018,26794,37.8,61980,35463,13612,13182
77019,19995,35.6,87394,83474,9920,10075
77020,26889,32.5,29401,13583,13757,13132
77021,25479,35,31103,20319,11725,13754
77022,28898,32.5,28810,13679,14223,14675
77023,29871,31.2,36033,16091,15294,14577
77024,35367,44.3,111139,81773,16918,18449
77025,26379,35.3,65828,48172,12720,13659
77026,22909,33.5,20024,11615,11219,11690
77027,15455,37.4,81661,81327,7319,8136
77028,15682,38.4,29389,14661,7753,7929
77029,18242,33.1,31715,12660,9039,9203
77030,11031,32.8,68980,56476,4965,6066
77031,18079,30.5,39278,17932,8770,9309
77032,13743,26.7,23389,10603,6518,7225
77033,27539,36,27272,12996,12623,14916
77034,35514,28.4,43905,17860,17586,17928
77035,35699,32.5,36345,21583,16685,19014
77036,68373,29,28266,14715,36312,32061
77037,20152,27,35518,12244,10286,9866
77038,28182,27.3,38160,13373,13647,14535
77039,28151,27.2,38167,12255,14780,13371
77040,44762,32.2,53194,26899,22092,22670
77041,36805,34.1,70608,32042,18951,17854
77042,36583,31.5,46159,35600,18033,18550
77043,23396,35,54359,27912,11763,11633
77044,33672,29.2,72761,26806,16805,16867
77045,32650,31.2,36952,15155,14750,17900
77046,1122,37.6,85493,91273,473,649
77047,22334,32.7,49246,23504,10370,11964
77048,16025,34.8,36818,17596,8097,7928
77049,29460,29.7,50348,18088,14911,14549
77050,4188,33,44327,20005,2248,1940
77051,14782,36,22920,13218,6723,8059
77053,31701,30.7,46568,15884,15789,15912
77054,21668,28.3,41694,28708,10895,10773
77055,44281,32.8,46987,27561,21889,22392
77056,17263,40.8,93069,84923,9056,8207
77057,39903,33.5,54594,46749,20437,19466
77058,16099,37.4,49589,34587,8610,7489
77059,18867,44.1,136355,56557,9392,9475
77060,44284,25.7,27750,11509,21819,22465
77061,24760,30.1,34566,16571,12898,11862
77062,25866,38.7,87960,38798,12355,13511
77063,35961,33,49873,36116,18420,17541
77064,45932,33.4,62610,27348,23118,22814
77065,37344,33.4,54091,29454,18391,18953
77066,31208,32.3,59855,22734,15354,15854
77067,30930,27.2,37309,14889,14680,16250
77068,10306,39.4,67945,35908,5136,5170
77069,16088,47.7,68495,50385,8091,7997
77070,46640,34.3,69139,34110,22977,23663
77071,26520,36.3,45941,23233,12414,14106
77072,56199,32.2,35462,14572,28798,27401
77073,38406,27.2,51206,18821,19372,19034
77074,36939,31.4,36207,16794,18437,18502
77075,40010,28.6,45581,17764,19713,20297
77076,34851,25.7,31212,11341,17262,17589
77077,53158,33.2,59958,40991,25837,27321
77078,16753,28.1,30368,12151,7704,9049
77079,30669,40.3,95589,52336,14616,16053
77080,48734,30.1,38159,17309,26191,22543
77081,42725,29.3,26741,15029,23489,19236
77082,49920,32.6,50294,30255,24142,25778
77083,71810,32,53879,19465,33474,38336
77084,99266,32.3,62785,25440,48936,50330
77085,16404,29.7,49466,17387,8293,8111
77086,27720,29.9,42030,14809,13457,14263
77087,38191,30.3,38707,14006,19647,18544
77088,52924,31.9,40896,16707,25931,26993
77089,51184,33.9,63141,24255,25535,25649
77090,34201,27.9,36138,20663,15641,18560
77091,23361,34.8,27903,17271,10546,12815
77092,35332,31.7,37314,18867,17639,17693
77093,42639,29,31725,11991,21679,20960
77094,8547,43.7,146518,70530,3958,4589
77095,68458,34.5,89393,36596,33328,35130
77096,34891,37.6,63346,39774,16989,17902
77098,12720,35.7,81907,70282,6851,5869
77099,45234,32.3,35252,16506,22004,23230
77201,0,-666666666,-666666666,-666666666,0,0
77301,31060,29.9,34097,14846,15682,15378
77302,17868,38.3,57758,26899,8969,8899
77303,16929,35.2,45599,19357,7890,9039
77304,23192,36.6,58774,30994,11473,11719
77306,11456,33.9,41596,17713,5589,5867
67340,324,44.7,35875,19673,175,149
67341,289,35.4,51250,19116,120,169
67342,923,39.4,41875,19733,526,397
67344,766,47.1,42266,18823,419,347
67345,187,61.9,32731,17721,101,86
67346,381,47.8,49038,22765,182,199
67347,459,57.2,45833,29613,232,227
67349,1043,55.7,34904,21755,536,507
67351,587,48.1,84250,30635,305,282
67352,717,32.4,32039,13886,345,372
67353,375,46.5,27500,21080,180,195
67354,771,38.3,35481,31313,346,425
67355,196,42.2,45417,24023,90,106
67356,2929,40.7,40455,31444,1573,1356
67357,12832,40.3,40610,20616,6416,6416
67360,465,49.3,39474,18623,208,257
67361,2044,48.1,40027,21852,1078,966
67363,32,-666666666,-666666666,,16,16
67364,343,34.7,34286,20377,195,148
67401,51196,37.3,45557,24599,25217,25979
67410,10393,40.7,51416,24209,5215,5178
67416,1325,42.8,59821,28946,629,696
67417,163,49.8,45208,23731,109,54
67418,194,43.3,38750,30457,84,110
67420,4739,39.7,48583,26796,2386,2353
67422,1299,41.8,57414,27541,709,590
67423,286,47.3,26917,20031,137,149
67425,804,40.3,57804,33130,427,377
67427,474,42.3,44722,23220,263,211
67428,1667,38.8,53500,28178,871,796
67430,681,51.3,45625,24939,362,319
67431,2580,41.9,54276,28000,1338,1242
67432,6044,44.6,40234,23748,2906,3138
67436,694,48,64044,30618,384,310
67437,1229,52.3,40547,31808,624,605
67438,378,42.6,53375,19867,180,198
67439,3731,38.5,48393,20538,2298,1433
67441,967,49.3,45625,22672,441,526
67442,209,52.9,63295,38816,93,116
67443,1768,44.5,60662,29405,900,868
67444,605,52.1,40882,22728,328,277
67445,613,52,32000,19633,302,311
67446,543,44.2,44063,25555,272,271
67447,353,56.9,67500,36195,192,161
67448,1038,48.7,53580,28933,513,525
67449,3156,46.4,40682,22600,1486,1670
67450,465,48.8,36563,39962,251,214
67451,921,42.3,47500,24170,473,448
67452,254,54.3,31923,23554,125,129
67454,501,54.8,34511,30018,243,258
67455,1942,44.8,41645,23618,962,980
67456,4810,40.4,53529,24679,2356,2454
67457,803,38.3,43250,23016,369,434
67458,421,34,85119,35431,282,139
67459,191,46.3,52250,28778,96,95
67460,15441,40.1,56663,28795,7731,7710
67464,1108,44.6,52037,23608,537,571
67466,809,44.1,38162,23498,424,385
67467,2803,41.2,55000,24748,1445,1358
67468,212,34.4,51875,43347,117,95
67470,539,44.1,58365,21599,271,268
67473,1670,49.1,36932,25152,802,868
67474,221,49.9,38083,22138,98,123
67475,249,40.7,30417,15853,143,106
67478,46,54.1,49063,28315,23,23
67480,1823,38.3,50054,23710,888,935
67481,583,48.5,41667,25663,303,280
67482,107,30.5,54423,16421,51,56
67483,367,34.8,56719,19501,195,172
67484,984,36.6,57656,25776,511,473
67485,368,51.2,50250,31055,187,181
67487,1390,39.9,61667,22373,663,727
67490,1007,51.9,41420,22867,464,543
67491,493,36.4,43750,21638,243,250
67492,125,42.2,48750,21953,61,64
67501,26799,34.1,33848,16175,14148,12651
67502,24160,46.7,57463,31880,11358,12802
67505,2281,46.1,40742,20682,1110,1171
67510,280,57.4,32232,28241,134,146
67511,363,50.1,47344,27846,182,181
67512,240,45,52500,25624,162,78
67513,53,51.5,86250,28425,22,31
67514,674,47.1,43889,25428,305,369
67515,54,63.2,40625,30107,26,28
67516,574,36.1,42083,19493,265,309
67518,25,25.8,53750,32824,19,6
67519,207,32.2,43542,26070,102,105
67520,373,41.1,51875,24817,191,182
67521,123,58.1,48438,44471,65,58
67522,2186,38.4,52991,21331,1142,1044
67523,440,30.9,42619,24082,241,199
67524,685,33.5,35577,17042,377,308
67525,1115,46.9,57024,30214,572,543
67526,2929,39.6,50417,26271,1448,1481
67529,302,50,32778,22309,159,143
67530,19576,39.1,43352,26179,9569,10007
67543,1875,43.7,48155,27590,977,898
67544,3175,38.4,42721,20861,1593,1582
67545,265,43.7,60208,24917,129,136
67546,2494,48.9,49063,26240,1181,1313
67547,1683,46.5,45881,24896,880,803
67548,1508,50.3,35833,23404,750,758
67550,5909,42.2,43732,22657,3475,2434
67552,674,47.6,54554,27649,356,318
67553,136,49.6,52917,26817,76,60
67554,4231,38,45131,22469,2000,2231
67556,353,47.9,39250,20555,182,171
67557,662,34.1,47143,23873,297,365
67559,52,79.3,95326,61988,35,17
67560,1693,51.5,51196,28695,830,863
67561,1630,32.1,42500,20192,835,795
67563,469,46.4,48571,23708,245,224
67564,237,44.4,51875,28105,131,106
67565,364,49,39375,21701,192,172
67566,900,29.6,58571,20128,424,476
67567,413,50.9,31696,19115,199,214
67568,301,54.6,38846,18628,138,163
67570,1647,37.4,53125,23437,826,821
67572,407,58,46250,37933,190,217
67573,152,32.8,53750,24305,83,69
67574,291,51.5,65417,26830,152,139
67575,405,39.9,44412,24307,199,206
67576,1857,40.3,45216,23067,975,882
67578,1453,53,37803,24301,735,718
67579,3160,34.9,50550,25023,1602,1558
67581,291,48.6,35417,18224,141,150
67583,652,52,32813,19290,310,342
67584,293,52.9,51250,43349,137,156
67601,24080,30.4,41994,23955,11878,12202
67621,460,39.6,39500,17367,219,241
67622,744,45.7,50000,29228,420,324
67623,248,38.9,40139,19323,138,110
67625,248,51.7,40114,30220,141,107
67626,137,52.8,30125,22731,68,69
67628,57,71.9,73750,134142,25,32
67629,146,54.3,32750,23288,81,65
67631,219,53.9,51563,22745,122,97
67632,309,43.6,42656,18790,158,151
67634,260,42,52841,22546,150,110
67635,118,58,36944,20911,62,56
67637,2437,42,48892,25398,1188,1249
67638,304,56,46750,21863,148,156
67639,161,50.3,49886,41295,70,91
67640,552,38,46429,51628,310,242
67642,1727,51.1,46806,27220,808,919
67643,185,56.3,43750,32991,90,95
67644,224,43.7,45000,22612,116,108
67645,526,48.3,53424,26322,304,222
67646,630,50.9,38125,24066,296,334
67647,312,35.4,45278,20719,173,139
67648,597,50.6,43125,25789,299,298
67649,381,45.1,36563,20470,206,175
67650,273,40.2,49028,19352,142,131
67651,474,45.9,42778,22212,250,224
67653,325,53.8,39338,22192,167,158
67654,4283,43,43520,21085,2451,1832
67656,40,61.1,72679,43683,27,13
67657,323,47.6,52750,26576,154,169
67658,96,58.7,52813,35098,47,49
67659,147,56.5,37232,47213,68,79
67660,78,59.8,67500,59672,40,38
67661,3352,45.4,40882,23569,1635,1717
67663,2553,47.7,45460,26088,1236,1317
67664,347,54.9,55625,28493,201,146
67665,5048,47.1,35972,22738,2480,2568
67667,222,38.3,48333,23935,120,102
67669,1773,40.4,40938,22566,892,881
67671,1606,41.3,47500,24989,783,823
67672,2661,45,46319,22912,1314,1347
67673,151,36.6,41429,16393,74,77
67674,135,24.6,40625,18210,90,45
67675,282,47.8,32396,15717,156,126
67701,6547,33.8,47292,26951,3142,3405
67730,1549,47.3,43542,27864,745,804
67731,707,46.3,33650,19904,354,353
67732,457,52.1,59583,38360,254,203
67733,202,48.5,42240,37705,109,93
67734,180,49.7,66250,27731,85,95
67735,5613,37.2,37957,20286,2768,2845
67736,291,47.2,51838,28198,152,139
67737,536,44.5,40833,21435,277,259
67738,568,53.5,51023,34754,309,259
67739,275,54.8,48542,27988,150,125
67740,1795,46.2,48421,26784,932,863
67741,187,52.9,40417,28145,115,72
67743,119,33.9,46806,17896,58,61
67744,248,52.7,86250,30348,122,126
67745,300,60.2,30000,21969,142,158
67747,160,50.3,46250,20827,69,91
67748,2378,46.5,44000,25848,1153,1225
67749,2330,49.9,39602,25774,1178,1152
67751,199,51.5,32500,23868,105,94
67752,1446,41.8,44688,25417,712,734
67753,580,28.3,51389,22428,323,257
67756,1974,51.8,39009,24888,1013,961
67757,463,49.4,49583,33474,215,248
67758,1019,43.7,45682,26404,535,484
67761,267,34.7,54583,23977,132,135
67762,370,44.6,58125,25328,168,202
67764,410,42.5,35750,25864,233,177
67801,30507,29.4,50663,19325,15832,14675
67831,1275,41.6,46875,26791,638,637
67834,1190,34.6,60976,23997,528,662
67835,3105,33.4,52188,22510,1430,1675
67836,109,37.5,44107,22481,66,43
67837,934,28.4,59688,29213,448,486
67838,938,41.4,48958,18776,485,453
67839,1251,46.8,49773,30282,601,650
67840,49,49.5,16563,12192,26,23
67841,410,40.5,61146,24738,197,213
67842,597,41.8,54500,27431,311,286
67843,189,73.2,15982,16788,112,77
67844,736,45.4,45500,22463,368,368
67846,33720,30.7,47011,21573,17271,16449
67849,486,43,63214,26015,246,240
67850,368,45.5,60000,36036,184,184
67851,2577,27.5,66472,22046,1264,1313
67853,1004,34.9,63750,29211,533,471
67854,1364,46.5,45714,31185,677,687
67855,1988,33.5,46645,20720,894,1094
67857,105,58.3,30583,16837,72,33
67859,652,30.2,45703,20558,345,307
67860,2848,35.9,53750,23981,1533,1315
67861,1884,41.1,49583,22499,1011,873
67862,264,48.8,52763,29495,122,142
67863,375,34.4,91375,35717,223,152
67864,2217,40.8,54650,23008,1111,1106
67865,949,46.8,36809,22830,457,492
67867,1596,36,56250,25798,782,814
67868,197,51,92981,30417,47,150
67869,1532,33.8,49297,20561,829,703
67870,1787,37.6,49046,23841,941,846
67871,5027,42.4,50685,25832,2342,2685
67876,1068,50.1,57625,28955,534,534
67877,2108,36.6,58250,25765,1069,1039
67878,2431,37.2,47000,24933,1251,1180
67879,1202,49.9,52847,32650,594,608
67880,8039,33.1,53169,26096,4042,3997
67882,382,43.5,54500,24858,182,200
67901,22353,29.1,50547,18960,11474,10879
67950,2629,39.1,45759,21487,1309,1320
67951,4827,34.5,54784,25425,2351,2476
67952,793,31.8,47500,18649,397,396
67953,160,54.5,41597,18523,71,89
67954,522,43.8,48393,29958,291,231
68001,94,33.4,84375,32141,51,43
68002,1859,42.1,65648,28519,966,893
68003,4368,40.8,61212,33785,2285,2083
68004,809,46.7,47596,25368,411,398
68005,24163,34.2,53794,25101,11963,12200
68007,7649,33.3,95098,40497,3756,3893
68008,12173,40,63067,28169,5869,6304
68010,906,17,24125,4304,395,511
68014,325,52.3,51250,22603,170,155
68015,1191,44.8,51528,25006,623,568
68016,393,50.4,52969,30093,202,191
68017,1351,48.4,76964,38102,670,681
68018,536,39.7,38295,20951,254,282
68019,511,44.2,54643,22738,258,253
68020,814,45.5,36193,22837,426,388
68022,16310,35.2,95338,44749,7966,8344
68023,2178,47.4,79508,37263,1142,1036
68025,30095,38.6,48568,25079,14675,15420
68028,11303,34.6,87034,31800,5274,6029
68029,936,45.7,73462,32444,511,425
68030,799,39.7,56563,24666,423,376
68031,1884,46.4,61489,28966,939,945
68033,465,47.2,63438,28306,273,192
68034,1167,40.1,65227,22861,551,616
68036,465,59.7,41766,24423,244,221
68037,2072,42.7,52292,30363,1084,988
68038,1242,53.7,42850,24298,631,611
68039,1220,22.3,28125,7758,600,620
68040,423,24,43750,14827,217,206
68041,1023,38.8,58864,28062,549,474
68042,100,43.7,56875,33687,49,51
68044,497,55.5,35625,27398,259,238
68045,1923,43.5,52827,25020,924,999
68046,27000,34.9,80600,32662,13482,13518
68047,1800,44.9,61827,29682,918,882
68048,12621,42.4,67022,30625,6315,6306
68050,784,35.4,54219,27690,464,320
68055,303,39.6,37750,16685,152,151
68057,1535,48,47500,24366,739,796
68058,322,54.4,65357,36007,147,175
68059,2933,41.4,66188,29041,1551,1382
68061,2330,45.8,47115,26064,1110,1220
68062,336,38.3,60250,22497,195,141
68063,313,47,53500,24264,169,144
68064,3257,42.7,55436,34729,1626,1631
68065,1484,44.8,57750,26860,728,756
68066,5205,39.4,51707,28218,2337,2868
68067,1193,28.4,34063,14672,596,597
68068,60,59.5,70625,36810,26,34
68069,2595,45.3,68125,51424,1422,1173
68070,1014,30.1,65972,20337,557,457
68071,2062,20.6,41400,12010,968,1094
68072,21,54.6,36875,23629,13,8
68073,2014,38,72543,31410,1040,974
68102,6102,28.4,38131,30821,3576,2526
68104,35146,34.2,41027,21776,16788,18358
68105,24803,31,33774,17854,12799,12004
68106,20615,35.1,52559,28432,9799,10816
68107,29657,30.1,40555,15070,15212,14445
68108,14286,30.1,34293,15830,7557,6729
68110,9245,31.4,24723,10648,4758,4487
68111,22922,30.3,24495,12236,11128,11794
68112,10930,35.2,43546,19888,5135,5795
68113,1096,21.4,32216,16502,605,491
68114,17262,38.8,50970,39494,8238,9024
68116,26561,32.3,88309,37309,13013,13548
68117,8357,36.2,45428,20757,4285,4072
68118,9207,41.1,118546,50235,4435,4772
68122,11452,32,69015,26111,5891,5561
68123,27583,31,67287,29795,13713,13870
68124,15532,40.6,61771,36797,7613,7919
68127,21496,35.4,46663,27718,10777,10719
68128,18449,31.7,60628,30430,9191,9258
68130,18339,37.2,97942,46872,9200,9139
68131,13317,29.8,31399,22157,6582,6735
68132,14457,30.6,45321,33786,6896,7561
68133,9995,38.3,92500,35140,4885,5110
68134,29807,34,47419,23669,13911,15896
68135,26403,31.4,102500,35383,13255,13148
68136,13852,32.4,88214,36559,7021,6831
68137,24538,37.3,60691,29479,11991,12547
68138,11292,31.8,71227,29989,5803,5489
68142,3212,31.7,62174,35931,1609,1603
68144,24347,39.3,58482,32966,11988,12359
68147,10339,33,53997,22024,5213,5126
68152,6010,45.9,58021,36405,2812,3198
68154,22540,38.5,67878,43006,10673,11867
68157,5204,40.8,65878,29952,2715,2489
68164,27399,34.1,66906,33868,13100,14299
68178,1334,19.4,-666666666,3278,510,824
68301,1390,42.3,56250,26702,667,723
68303,264,47,34375,21816,132,132
68304,261,54.6,57500,35703,139,122
68305,4209,43.9,43874,26781,2007,2202
68307,457,40.9,55833,26946,265,192
68309,90,54.3,29643,20267,47,43
68310,14322,43.2,44641,23665,6971,7351
68313,969,40.1,58750,27580,511,458
68314,449,44.4,63125,45127,226,223
68315,80,48.8,45441,21386,30,50
68316,384,41.5,54605,26397,207,177
68317,1531,40.4,79063,30851,752,779
68318,461,45.1,29875,15305,247,214
68319,612,40,60313,37760,292,320
68320,369,36.9,27292,16856,163,206
68321,304,42.9,62679,30042,174,130
68322,491,50.8,50114,29261,254,237
68323,244,54.2,29167,32042,127,117
68324,147,39.4,19875,21567,97,50
68325,160,59,57727,29014,73,87
68326,247,63.4,44583,29651,116,131
68327,295,51.5,40250,67048,146,149
68328,504,45.7,58542,29152,257,247
68329,583,44.9,44231,24100,296,287
68331,1016,42.9,65000,28454,535,481
68332,108,54.3,57917,20575,57,51
68333,8438,30.7,40272,18396,4289,4149
68335,454,54,49271,26279,229,225
68336,377,45,127682,45256,197,180
68337,261,45.3,47679,25812,131,130
68338,374,34.8,58558,24261,143,231
68339,1238,46.3,70769,36398,631,607
68340,1007,38.3,46406,22816,507,500
68341,1080,45,60455,25880,576,504
68342,464,43.1,47404,23844,247,217
68343,940,42.7,52153,27138,470,470
68344,462,45.8,51466,26026,220,242
68345,294,52.2,47969,39538,170,124
68346,551,43.2,58869,27520,324,227
68347,2341,37.3,68981,32749,1225,1116
68348,236,45.3,43553,39028,112,124
68349,1182,40.2,63618,24354,597,585
68350,247,43.3,42500,22116,118,129
68351,874,47.3,58929,30002,398,476
68352,5157,47.1,43095,24128,2599,2558
68354,750,54.2,43229,26415,362,388
68355,5125,46,42375,23753,2508,2617
68357,353,52.6,45250,27377,182,171
68358,1764,39,68333,30722,866,898
68359,1603,45.2,55333,27692,784,819
68360,477,45.5,75313,34976,257,220
68361,2507,43.6,44451,23207,1232,1275
68362,94,21.5,175536,30684,46,48
68364,78,55.5,52500,27628,39,39
68365,250,55.8,50625,30128,116,134
68366,1289,39.3,54107,23264,573,716
68367,451,44.6,51875,25735,248,203
68368,384,46.6,57578,27944,213,171
68370,2009,52.5,44097,25042,942,1067
68371,1499,49.9,60313,29506,672,827
68372,3214,32.7,64948,25652,1561,1653
68375,239,33.2,17969,7479,137,102
68376,1503,47.6,32399,22281,722,781
68377,525,47.2,51875,25517,255,270
68378,752,39.5,50288,26247,342,410
68379,71,49.8,34792,27659,40,31
68380,93,35.1,36875,17672,57,36
68381,232,54.1,76071,36846,103,129
68382,67,36.3,41250,18222,33,34
68401,637,32.4,48438,20109,325,312
68402,1201,44.3,82000,34394,610,591
68403,210,34.7,58571,23577,92,118
68404,1045,40.5,95000,35777,518,527
68405,3400,36,55964,26745,1818,1582
68406,573,44.1,50278,26606,261,312
68407,649,41.8,65417,29328,316,333
68409,764,47.7,69063,31530,352,412
68410,8817,39.4,47764,24114,4316,4501
68413,524,33.2,67396,29603,252,272
68414,237,54.9,29667,24407,124,113
68415,640,43.8,54000,27064,323,317
68416,214,53.9,58125,31326,111,103
68417,284,51.2,61875,26063,150,134
68418,1054,43.5,57083,25108,544,510
68419,264,41.6,61875,28865,145,119
68420,1333,47.2,32831,20331,675,658
68421,1119,21.8,40417,20153,594,525
68422,463,38.5,48125,35861,209,254
68423,910,43.5,62619,27665,462,448
68424,721,47.6,51136,31111,339,382
68428,1357,41.4,79240,44830,664,693
68430,1512,35.8,95133,36928,826,686
68431,294,59.1,26875,16770,164,130
68433,271,43.6,45781,22315,148,123
68434,8388,35.1,59412,27734,4214,4174
68436,543,50.6,53333,31748,264,279
68437,216,51.3,43571,30342,96,120
68438,126,55.8,43542,23088,64,62
68439,659,27.8,56042,21539,323,336
68440,113,49.9,30833,17547,61,52
68441,334,41.8,47159,22164,159,175
68442,358,56.7,50083,33627,182,176
68443,1167,42,50893,24798,519,648
68444,51,39.3,50625,25702,29,22
68445,99,49.5,34375,25295,44,55
68446,2619,42.2,47399,27716,1240,1379
68447,490,55.6,40000,30412,209,281
68448,430,54.1,42778,27210,218,212
68450,3126,44.6,38482,15481,2021,1105
68452,117,53.8,45625,24603,63,54
68453,379,42.9,57813,22164,194,185
68454,653,35.7,50938,28271,284,369
68455,570,47,59107,27298,309,261
68456,1058,42.5,62647,30966,535,523
68457,397,42.3,31750,16787,178,219
68458,160,42.5,51250,25412,78,82
68460,900,49.6,61806,39267,443,457
68461,521,48.4,87240,52136,281,240
68462,4002,36.6,82648,39024,2023,1979
68463,1593,35.9,55854,24253,822,771
68464,468,50.1,41875,21570,242,226
68465,2481,40.5,53529,23443,1232,1249
68466,1887,50.8,37404,21241,850,1037
68467,9334,39.6,47989,27159,4590,4744
68502,26156,33.7,40943,25603,13848,12308
68503,15410,26.6,31416,15609,8260,7150
68504,16336,28.8,35748,19052,7946,8390
68505,15634,33.1,49973,25064,7811,7823
68506,27995,40.7,53797,31508,13047,14948
68507,13456,39.8,48025,25633,6779,6677
68508,14340,21.1,17483,10674,7459,6881
68510,20381,37.1,40501,26974,9519,10862
68512,11875,34.7,72409,39312,5717,6158
68514,244,49.6,109464,41703,149,95
68516,39683,37.5,78238,36590,19598,20085
68517,550,38.8,72267,35242,331,219
68520,989,55.6,78819,65871,512,477
68521,33692,28,48430,21897,17364,16328
68522,12693,30,59790,21741,6458,6235
68523,1361,45.5,99141,42286,651,710
68524,6250,28.6,58839,19894,3202,3048
68526,5071,37.5,112350,45038,2373,2698
68527,964,40.1,107759,40165,507,457
68528,6460,27.7,52750,22996,3385,3075
68531,72,55.1,-666666666,16154,9,63
68532,896,37.2,82330,26175,504,392
68601,27824,39.1,50219,24575,13697,14127
68620,2836,44.8,45244,25164,1347,1489
68621,452,65.1,68032,41438,213,239
68622,296,45.7,45417,29309,147,149
68623,305,49.7,28750,23339,137,168
68624,1218,40.9,52167,24384,565,653
68626,663,45.7,53125,24009,380,283
68627,625,46,48542,21532,347,278
68628,941,50.9,57344,29930,502,439
68629,1492,44.9,49231,28083,752,740
68631,480,35.4,58462,26987,249,231
68632,3774,41,45797,28822,1814,1960
68633,1355,51.8,44013,24748,722,633
68634,349,45.2,61875,23676,181,168
68635,414,44.3,44519,22494,226,188
68636,1022,51.5,52000,28223,472,550
68637,285,44.7,34821,26431,121,164
79782,4001,35.9,39495,19241,2018,1983
79783,244,27.9,112917,27895,88,156
79785,227,25.8,14583,11662,94,133
79788,372,32.9,28750,20184,201,171
79789,1150,32.5,55536,27090,604,546
79821,6845,33.4,30810,11237,4318,2527
79830,7514,38.7,42062,28244,3711,3803
79831,21,75.1,-666666666,44614,11,10
79834,153,42.4,56397,33976,78,75
79835,12041,30.6,29799,12285,5894,6147
79836,5226,31.8,36394,14803,2580,2646
79837,443,54.9,26250,30123,230,213
79838,8290,26.9,26477,8652,4176,4114
79839,1880,30.8,19583,10601,888,992
79842,613,55.9,40500,28310,274,339
79843,2516,43.8,45245,23633,1367,1149
79845,5017,38.3,21512,12298,2302,2715
79846,30,64.1,18594,21043,14,16
79847,49,40.8,37734,31727,30,19
79848,795,47.6,38958,32629,392,403
79849,14097,23.2,25426,7592,7017,7080
79851,784,35.9,25000,12754,465,319
79852,895,51.1,26613,19876,436,459
79853,3159,24.1,27870,8612,1564,1595
79854,164,57.3,75417,26540,72,92
79855,2338,37,36779,16064,1126,1212
79901,10626,37.2,13524,8878,5092,5534
79902,21099,37.2,30315,26163,9502,11597
79903,17762,38.7,27420,14332,8345,9417
79904,34241,29.6,32668,15490,15971,18270
79905,25034,37.1,19455,11112,11679,13355
79906,4416,20.9,46180,15229,2291,2125
79907,54563,31.6,27166,12137,25561,29002
79908,2847,22.9,70640,24217,1706,1141
79911,2685,32.3,120815,37780,1365,1320
79912,78697,34.6,59174,30787,38687,40010
79915,38748,37.1,27134,12551,18446,20302
79916,2968,23.1,2499,26515,2421,547
79920,66,21.5,-666666666,24861,66,0
79922,8258,46.9,80893,46543,3737,4521
79924,59115,32.3,41009,17543,27825,31290
79925,40935,35.4,44217,20991,19374,21561
79927,39057,31.3,31962,12519,18821,20236
79928,51248,25.5,48251,15556,25739,25509
79930,29989,33.3,29942,14600,14543,15446
79932,26725,32.3,50952,22292,12609,14116
79934,21857,28.7,61951,23469,11227,10630
79935,18718,31.8,37866,19129,9056,9662
79936,114734,31.1,52024,20474,56170,58564
79938,59252,27.8,52119,17201,30546,28706
79942,0,-666666666,-666666666,-666666666,0,0
80002,18742,38.5,50425,30552,9113,9629
80003,35337,35.4,54688,25883,17438,17899
80004,36093,41.5,67830,32324,17440,18653
80005,26763,42.1,84501,37440,13295,13468
80007,6957,45,120202,53599,3433,3524
80010,43169,27.9,32527,13314,22464,20705
80011,47508,29.9,40748,16950,23770,23738
80012,46974,34.3,40989,20364,23341,23633
80013,71261,33.5,67857,27548,35544,35717
80014,35735,42.1,46073,29510,16727,19008
80015,64460,34.5,80599,32020,31717,32743
80016,42252,37.7,101280,45459,20625,21627
80017,34144,31.1,49519,22709,16753,17391
80018,10118,33.5,95843,33546,5198,4920
80019,2181,34,63519,33374,932,1249
80020,48889,35.8,77600,33817,24313,24576
80021,31004,34.1,71221,34414,15166,15838
80022,43605,31.6,56449,21316,21838,21767
80023,15193,40,110553,50128,7392,7801
80024,441,21.6,41531,11825,246,195
80025,253,54.6,121875,44772,85,168
80026,26885,38.9,71117,37409,13320,13565
80027,31580,37.2,95635,44776,15305,16275
80030,15216,34.4,39494,19374,7713,7503
80031,34196,37,70536,33389,17039,17157
80033,24712,43,47841,30062,11752,12960
80045,559,26.7,33500,18336,230,329
80101,270,44.4,46719,26491,143,127
80102,5142,40.4,62723,27961,2695,2447
80103,2420,41.9,62083,25080,1143,1277
80104,27359,36.4,81017,34179,13458,13901
80105,1170,40.3,56250,23498,595,575
80106,4417,42.9,97321,42374,2217,2200
80107,11881,41.7,85141,34423,5963,5918
80108,23619,39.7,120159,57002,11175,12444
80109,18331,35.8,108781,41237,9229,9102
80110,21154,34.6,41793,22057,10909,10245
80111,29815,39.8,93241,52352,14734,15081
80112,29896,36.2,81191,43309,14492,15404
80113,20946,40.7,53185,52786,9994,10952
80116,3685,52.9,99712,43055,1786,1899
80117,2759,47.3,64813,33369,1362,1397
80118,5360,48.4,107882,46685,2615,2745
80120,29360,42.9,54878,31509,13846,15514
80121,18458,44.4,86228,54576,8873,9585
80122,30457,44.8,78722,41517,14768,15689
80123,44102,40.5,72508,40962,21596,22506
80124,18550,36.4,98687,52697,9266,9284
80125,9821,38.1,105806,42236,4837,4984
80126,40965,36.8,112455,45917,20314,20651
80127,44416,41.5,97872,43363,22422,21994
80128,36353,40.4,79185,36208,17729,18624
80129,28175,36,102495,42557,14349,13826
80130,28973,35.1,105817,42357,14513,14460
80131,114,63,12366,21671,63,51
80132,20367,43.5,107475,42275,10187,10180
80133,2080,37.6,61165,31895,1087,993
80134,57110,34.9,100739,41462,28243,28867
80135,3571,51.2,110694,47053,1898,1673
80136,5527,33.6,74816,26517,2850,2677
80137,1117,46.7,83939,35109,555,562
80138,29962,39.6,99316,41093,15036,14926
80202,10977,32.4,68707,65582,6344,4633
80203,19668,31.1,41999,41758,11115,8553
80204,30307,29.9,31611,22000,15045,15262
80205,29856,32.4,49472,27227,15100,14756
80206,21364,38.3,61355,57947,10339,11025
80207,21235,35.9,53806,33650,10104,11131
80209,22104,39.4,75972,63730,10890,11214
80210,35464,32.6,66788,43653,17552,17912
80211,33007,34.1,51563,36287,16892,16115
80212,17832,38.4,56403,37080,8579,9253
80214,25517,33.5,37211,23302,13137,12380
80215,18343,42.7,56525,33949,8944,9399
80216,11389,27.5,31711,13566,6136,5253
80218,18830,33.4,45597,46481,9841,8989
80219,64506,29.6,39659,15717,32825,31681
80220,35486,36.1,62989,45892,17427,18059
80221,40010,33.5,49621,20286,20400,19610
80222,20313,38.1,44300,30248,10113,10200
80223,17261,33.6,38945,20853,8749,8512
80224,16635,43.2,45107,32460,8001,8634
80226,30789,36.7,53081,28062,15328,15461
80227,33473,37.6,59100,33018,17049,16424
80228,30596,39.7,68323,36428,15121,15475
80229,51123,29.9,47403,19408,25417,25706
80230,8336,34.5,71506,52041,3857,4479
80231,33647,35.6,42017,29071,17164,16483
80232,21441,41,61227,28774,10494,10947
80233,45830,33.5,58820,25087,23124,22706
80234,25933,33.4,62468,31188,12831,13102
80235,9088,38.5,54178,30785,5058,4030
80236,16838,35.1,47018,21718,8210,8628
80237,18046,38.7,61050,46178,8541,9505
80238,11296,34.3,126338,53019,5510,5786
80239,41066,28.6,46380,15801,20745,20321
80241,32605,33.7,81423,31554,16652,15953
80246,12248,31.6,39463,32448,6033,6215
80247,25314,36.4,36462,26214,11516,13798
80249,26383,31.5,68699,23331,12141,14242
80260,32327,31.6,41185,17304,16484,15843
80264,0,-666666666,-666666666,-666666666,0,0
80290,0,-666666666,-666666666,-666666666,0,0
80293,0,-666666666,-666666666,-666666666,0,0
80294,0,-666666666,-666666666,-666666666,0,0
80301,23977,39,65428,44694,11812,12165
80302,27352,24.9,45717,38699,14146,13206
80303,22740,30.6,44544,36825,11173,11567
80304,26251,38.3,77493,47113,12905,13346
80305,17689,33.5,80476,45382,9198,8491
80310,6381,18.9,14091,4630,3424,2957
80401,38541,39.8,69208,43298,20508,18033
80403,18408,43.1,94331,49573,9684,8724
80419,312,30.5,-666666666,15219,268,44
80420,687,40.5,44375,40615,403,284
80421,8459,45.2,66319,30460,4331,4128
80422,4382,44.5,64577,34502,2177,2205
80423,153,48.2,86750,74412,112,41
80424,9078,34.1,63895,32590,5007,4071
80425,203,59.6,41571,40149,83,120
80426,272,49.3,108542,40290,158,114
80427,733,43.5,39537,27048,435,298
80428,514,33.8,73611,20639,191,323
80432,65,59.8,2499,14717,16,49
80433,8271,47.8,97083,46023,4056,4215
80434,49,35.9,53750,24214,22,27
80435,8370,34.3,54756,28769,4639,3731
80436,537,51.2,61897,26009,274,263
80438,339,49.5,36786,25458,177,162
80439,24208,47.9,90600,51922,11610,12598
80440,2218,40.8,58226,30358,1302,916
80442,2451,39.4,74667,45950,1354,1097
80443,3228,38.3,69762,38523,1883,1345
80444,1152,40.9,58750,33875,603,549
80446,3775,42.2,63591,26851,2110,1665
80447,1605,51.5,46858,29570,912,693
80448,261,66.3,65875,35834,134,127
80449,685,61.8,41181,29409,349,336
80451,835,43.2,62500,27402,452,383
80452,2566,44.8,51020,29573,1312,1254
80453,194,47.6,81705,38257,112,82
80454,1198,48,80750,49329,636,562
80455,509,46.6,66750,36715,265,244
80456,689,59.1,33021,25621,398,291
80457,475,28.6,37672,19940,180,295
80459,2532,39.2,59208,24689,1202,1330
80461,7232,34.8,44073,24695,3711,3521
80463,90,53,48438,29286,55,35
80465,15304,44.9,85482,44533,7751,7553
80466,3237,40.6,67647,42365,1766,1471
80467,2117,39.9,61938,30815,1261,856
80468,520,49.8,54583,28214,319,201
80469,375,40,36827,21243,177,198
80470,3863,46.1,77868,37576,1966,1897
80471,0,-666666666,-666666666,-666666666,0,0
80473,60,68.1,89464,41763,31,29
80475,32,-666666666,-666666666,,0,32
80476,236,45.5,45208,26621,134,102
80477,594,22.1,66477,20770,390,204
80478,1651,36.2,86996,31309,844,807
80479,28,62.3,-666666666,43914,11,17
80480,1262,46.2,43005,25251,681,581
80481,799,56.7,103750,43211,471,328
80482,1151,46.5,61000,39984,669,482
80483,622,44,54545,25572,371,251
80487,16645,40.3,64975,38251,8578,8067
80488,44,55.3,-666666666,28830,17,27
80497,284,42,46676,37259,149,135
80498,7131,39.9,70469,39857,3746,3385
80501,40760,34.3,45799,23283,20856,19904
80503,31302,42.8,77631,43465,15568,15734
80504,48679,35.5,80000,31636,24538,24141
80510,462,44.2,45588,41384,255,207
80511,102,29.5,-666666666,17657,52,50
80512,1924,55.7,61599,35565,945,979
80513,10398,46.5,79889,36066,5138,5260
80514,4352,37.5,46065,25207,2278,2074
80515,872,51,41473,41565,479,393
80516,20958,38,103713,40086,10499,10459
80517,9046,56.9,58212,39366,4527,4519
80520,1291,39.8,51375,23102,633,658
80521,35023,22.7,37942,20375,17258,17765
80524,31738,36.2,56938,30323,16138,15600
80525,48207,35.7,63754,35059,23405,24802
80526,45413,31.4,57121,28710,23726,21687
80528,18617,35.5,86618,40237,9138,9479
80530,3515,38.1,59721,27549,1691,1824
80532,0,-666666666,-666666666,-666666666,0,0
80534,12282,34.1,72772,28315,6408,5874
80535,2814,52.4,50538,25700,1503,1311
80536,2067,57.3,70078,46251,1040,1027
80537,38762,39.8,52171,28420,19244,19518
80538,45513,40.1,61799,29952,21891,23622
80540,5347,45.8,80997,40826,2719,2628
80542,3626,40.9,93790,40798,1989,1637
80543,5832,31.5,64139,24104,2807,3025
80544,0,-666666666,-666666666,-666666666,0,0
80545,629,61.5,40583,30261,295,334
80546,47,67.3,-666666666,12679,9,38
80547,880,31.7,113106,40827,411,469
80549,9345,33.1,72481,27721,4641,4704
80550,21106,36.5,81563,34996,10710,10396
80601,35125,32.5,63449,22870,17288,17837
80602,28516,34.9,95350,34098,13862,14654
80603,11426,33.9,70232,27303,5562,5864
80610,2807,38.7,52554,24610,1560,1247
80611,698,43,56875,29314,367,331
80612,420,51.6,35789,22489,189,231
80615,7751,37,64094,31337,3811,3940
80620,17827,26.8,43817,17378,8996,8831
80621,11464,35.8,51767,24238,5913,5551
80622,248,26.4,47656,12615,101,147
80623,1063,31.5,48750,15494,556,507
80624,1158,32.5,71000,23151,538,620
80631,49501,25.1,30235,15224,24516,24985
80634,54656,36.6,58959,28051,26621,28035
80640,11235,31.3,73605,26437,5899,5336
80642,4318,41.6,77232,29743,2448,1870
80643,3224,38,56827,25562,1581,1643
80644,2815,41,69611,28360,1494,1321
80645,4488,39.5,52675,26424,2281,2207
80648,1030,41.4,64375,20659,496,534
80649,251,42.9,47750,20749,130,121
80650,1564,42.4,54891,27559,730,834
80651,4021,41.4,60082,26552,2234,1787
80652,405,35,68661,24731,184,221
80653,704,51.4,41094,24805,378,326
80654,2447,39.6,51651,22504,1261,1186
80701,16111,33.3,44729,20510,8040,8071
80705,850,33,27563,13676,437,413
80720,2831,43.8,45472,24991,1486,1345
80721,150,40.6,29453,16969,85,65
80722,279,48.6,62813,25841,176,103
80723,7221,37.9,38806,20693,3537,3684
80726,494,40.5,54561,34461,314,180
80727,339,30.9,33750,19200,137,202
80728,1017,42.3,45511,20264,510,507
80729,508,43.5,40313,30847,272,236
80731,1581,42.5,48259,23210,837,744
80733,573,43.1,53750,21014,331,242
80734,2931,37.5,38889,19640,1495,1436
80735,457,34.8,52500,29487,228,229
80736,596,41.2,41607,24368,353,243
80737,1553,47.2,41477,20615,737,816
80740,110,44.2,24091,21673,53,57
80741,862,40.3,46618,23705,508,354
80742,235,32.4,37422,18946,107,128
80743,1052,45.6,43977,25146,514,538
80744,532,42.7,41667,24213,276,256
80745,238,31.3,44063,17351,180,58
80746,36,45.7,51250,20897,28,8
80747,476,43.7,56875,27418,253,223
80749,285,49.5,37292,21210,150,135
80750,354,36.7,58750,24733,142,212
80751,18641,36.6,38946,22147,10177,8464
80754,196,44.4,77083,28538,104,92
80755,92,39.4,59583,51587,62,30
80757,284,34.5,37500,18525,164,120
80758,3817,33.8,46908,19131,1711,2106
80759,4588,37.8,40949,24102,2270,2318
80801,86,52.3,51250,26121,48,38
80802,249,30.5,46964,20979,125,124
80804,321,52.3,26591,19311,136,185
80805,521,31.5,44464,19676,296,225
80807,5234,37.3,45655,21341,3023,2211
80808,6133,42.5,51983,23273,2914,3219
80809,1636,51.2,63824,31751,766,870
80810,1233,44.8,43750,23804,629,604
80812,164,48.9,35714,34644,86,78
80813,2103,43.5,37604,18867,1129,974
80814,3881,49.3,65714,30620,2223,1658
80815,907,49.2,48203,28661,507,400
80816,5286,52,53495,32868,2926,2360
80817,27947,28.8,56926,22445,13733,14214
80818,309,44.2,41250,27803,132,177
80819,740,47.3,47614,30066,402,338
80820,636,62.6,33015,27352,300,336
80821,981,54.2,41000,23971,426,555
80822,337,32.8,53750,23101,173,164
80823,209,43.7,47500,27588,92,117
80824,245,46.2,49792,28100,125,120
80825,621,34.8,65441,22954,311,310
80827,578,59.6,51952,45754,274,304
80828,3702,36.8,43846,17855,2538,1164
80829,5624,47.6,50745,36763,2575,3049
80830,170,55.8,43906,46559,68,102
80831,22256,35,81000,31028,11350,10906
80832,548,51.8,46691,25537,272,276
80833,492,49.4,40104,23054,283,209
80834,275,47.1,30833,20357,159,116
80835,773,48,55455,23977,371,402
80836,1173,41.9,43750,21372,677,496
80840,6362,20.8,76652,13813,4662,1700
80860,582,45.5,34464,21482,292,290
80861,246,37.5,40500,20653,128,118
80862,47,62.4,100625,36549,23,24
80863,11811,47.2,64675,32690,5516,6295
80864,1149,41.5,48000,19368,559,590
80902,12540,21.8,42721,14180,7422,5118
80903,14956,32.8,33091,23370,7224,7732
80904,20436,44,44834,30730,10083,10353
80905,17992,34.1,37715,24010,8716,9276
80906,37643,38.3,60387,37159,18993,18650
80907,26508,41,42263,27515,13123,13385
80908,14060,45.3,101831,41819,6963,7097
80909,35158,37.8,38976,22850,17614,17544
80910,29768,30.3,34274,17043,14352,15416
80911,31579,34.2,56267,23587,15372,16207
80913,3144,22.3,52450,21762,2628,516
80914,321,21.7,-666666666,19953,258,63
80915,19593,34.2,51062,24114,10140,9453
80916,37028,27.2,41131,17956,18788,18240
80917,29708,36.2,49737,27180,14691,15017
80918,47189,33.6,61012,30162,23320,23869
80919,27391,42.2,89635,41929,13391,14000
80920,38409,36.3,90625,36258,18808,19601
80921,19280,40,101138,45816,9314,9966
80922,26468,32,75533,29442,12822,13646
80923,27211,31,76810,29558,13101,14110
80924,5046,30.7,110222,32084,2507,2539
80925,6662,30.4,69261,25219,3346,3316
80926,1273,42,54514,29573,688,585
80927,977,31.8,98007,46189,523,454
80928,1141,40.5,55368,21729,540,601
80929,275,57.3,42188,33597,164,111
80930,885,41.2,61435,30650,504,381
80938,34,-666666666,-666666666,,17,17
80939,0,-666666666,-666666666,-666666666,0,0
80951,4126,27,73214,28848,2161,1965
81001,29145,35.3,30918,18745,14568,14577
81003,15553,37.1,28273,16474,7552,8001
81004,26051,36.6,30581,17511,12536,13515
81005,30310,41.9,46120,24629,14949,15361
81006,11932,44.2,54292,24105,6047,5885
81007,29974,38.4,65384,25977,14684,15290
81008,10839,36.8,50518,25536,5136,5703
81019,1493,47.3,39677,22594,773,720
81020,882,57.7,35500,20675,458,424
81021,9,28.5,-666666666,18278,3,6
81022,1503,45.1,47500,19426,746,757
81023,1232,45,53424,34630,569,663
81024,110,51.4,87188,39746,59,51
81025,974,47.3,31635,22317,527,447
81027,155,48.6,32917,20024,90,65
81029,274,55.9,29750,19459,130,144
81030,130,28.5,33000,12879,66,64
81033,402,31.7,31944,11695,237,165
81036,1004,42.5,37857,22508,462,542
81038,361,37.8,-666666666,3781,361,0
81039,1659,46.7,37931,24097,856,803
81040,602,55.3,33790,32026,278,324
81041,760,35.4,27143,12173,386,374
81043,49,48.8,29250,18673,18,31
81044,392,43.2,50278,24555,189,203
81045,61,48.8,56250,29297,34,27
81047,1602,45.3,38704,19901,801,801
81049,336,49,40250,26888,181,155
81050,10071,39.9,37543,19952,5003,5068
81052,9398,35.1,33873,18805,4674,4724
81054,4745,40.6,35276,14175,3086,1659
81055,1366,60,44479,31747,652,714
81057,432,34.8,43750,16099,205,227
81058,983,42.8,33036,14032,562,421
81059,354,34.4,51250,10629,272,82
81062,1986,35.7,38375,18264,1379,607
81063,2341,41.1,27946,18787,1413,928
81064,280,49.2,46250,22352,161,119
81067,5910,41.6,28212,17125,2955,2955
81069,1478,55.7,57763,38796,829,649
81071,349,29.9,45938,21325,172,177
81073,1851,48.6,36429,22122,917,934
81076,657,31.7,36719,14516,366,291
81077,464,33.1,33977,19551,184,280
81081,48,61,24861,28821,20,28
81082,12281,43.3,41162,22270,6167,6114
81084,131,42.2,34375,20569,81,50
81087,192,26.8,34500,13210,82,110
81089,4326,46.8,29054,17413,2211,2115
81090,1110,42.9,44861,24036,528,582
81091,928,50.9,58795,24187,487,441
81092,852,41.4,53158,29214,446,406
81101,15048,30.7,33620,19302,7385,7663
81120,2029,45.4,28036,16640,1044,985
81121,217,58.4,37708,21825,110,107
81122,7366,45,64213,30837,3717,3649
81123,998,40.7,31786,21482,522,476
81124,78,28.5,18173,10573,35,43
81125,3175,38.8,33798,20004,1657,1518
81126,188,57.4,20990,36800,55,133
81128,111,29.8,62656,15919,59,52
81129,207,56.3,21726,19050,123,84
81130,756,61.5,55795,44545,375,381
81131,1215,49.2,38568,24626,623,592
81132,3136,44.2,34316,18322,1662,1474
81133,978,49.3,42321,25415,512,466
81136,207,50.5,25250,17188,91,116
81137,5434,41,54057,26207,2856,2578
81138,32,44.9,-666666666,38081,11,21
81140,2500,37.5,34176,18187,1188,1312
81141,1499,33.1,43854,16939,746,753
81143,523,52.1,34792,22668,294,229
81144,7296,39.6,40658,19928,3427,3869
81146,690,44.2,49688,19170,366,324
81147,11531,47.6,49176,30255,5871,5660
81148,451,27.7,21912,9761,255,196
81149,1028,50.1,31528,20118,495,533
81151,1452,38.2,38884,19030,698,754
81152,1269,53.6,24087,14289,712,557
81154,1399,44.6,36696,24569,745,654
81155,355,58.3,46406,34875,204,151
81201,8953,47.4,42485,29283,4421,4532
81210,337,52.5,33750,21244,223,114
81211,7144,47.2,49648,24338,4195,2949
81212,29956,42.7,40138,18542,17149,12807
81220,111,63,51875,35032,42,69
81221,279,50.9,38750,15875,144,135
81222,388,39.9,37011,20418,166,222
81223,1402,58.8,38039,24885,730,672
81224,3689,37.4,72409,35449,1957,1732
81225,783,45,51758,34663,387,396
81226,9132,40.1,40243,16099,6417,2715
81227,0,-666666666,-666666666,-666666666,0,0
81230,9106,31.3,45169,24820,5034,4072
81231,618,19.4,-666666666,4569,356,262
81232,44,13.8,-666666666,9882,32,12
81233,1153,58.7,50714,30431,564,589
81235,714,54.5,56029,35770,323,391
81236,923,61.8,61375,36943,416,507
81237,132,49,32198,22664,87,45
81239,9,-666666666,-666666666,,9,0
81240,3966,49.9,43935,22739,2059,1907
81241,40,66,36250,15410,24,16
81242,1052,30.6,41154,20001,536,516
81243,91,59.9,27679,16069,54,37
81244,327,37.6,35163,17120,165,162
81248,122,30.9,53750,20468,32,90
81251,100,48.6,73750,49185,58,42
81252,3715,54.6,31437,25519,1962,1753
81253,554,56.5,50511,23530,251,303
81301,29238,35.9,55399,31089,14857,14381
81303,8087,38.4,63684,29287,4083,4004
81320,220,62.7,27697,25758,84,136
81321,14155,40.8,41371,22125,6845,7310
81323,5207,43.1,48500,23951,2817,2390
81324,1180,45.8,39479,22513,647,533
81325,122,39.2,19688,17025,54,68
81326,2239,45.3,58125,27503,1118,1121
81327,765,49.6,50781,28521,405,360
81328,3885,51.4,49250,27163,1801,2084
81330,8,-666666666,-666666666,,0,8
81331,238,58.6,29844,35629,157,81
81332,244,40.3,46607,22464,124,120
81334,1298,30.8,29593,12862,637,661
81335,97,60.4,250001,133895,62,35
81401,22518,42.2,45148,22410,11008,11510
81403,11459,45,54864,25492,5491,5968
81410,1577,56.5,38977,33726,812,765
81411,6,-666666666,-666666666,,0,6
81413,5374,52.9,38778,24671,2651,2723
81415,1288,52.3,37917,27621,701,587
81416,13617,39.1,41718,21708,6860,6757
81418,1801,45.6,43472,21356,847,954
81419,3816,49,43369,24996,1932,1884
81422,520,48.2,41518,23059,256,264
81423,1660,45.6,53667,28815,742,918
81424,1101,49.7,43750,23337,491,610
81425,4967,40,37446,20097,2556,2411
81426,164,34,54750,24373,86,78
81427,852,50.8,64000,32253,470,382
81428,3875,46.6,52782,31656,2017,1858
81429,103,63.7,35250,27402,51,52
81430,505,51.8,70325,40767,271,234
81431,437,41.2,46875,27013,218,219
81432,2780,49.3,66638,33865,1410,1370
81433,618,43.1,39306,24388,366,252
81434,155,46.6,58333,45344,74,81
81435,5101,36.7,69432,45810,2854,2247
81501,24568,30,36717,18754,12484,12084
81503,14507,37.9,44405,23310,7020,7487
81504,29955,33.9,52238,23575,14879,15076
81505,8874,42.1,63314,43753,4376,4498
81506,10695,50.1,60913,37349,4967,5728
81507,15466,47.6,70466,36576,7680,7786
81520,14346,31.4,36558,17281,7006,7340
81521,14700,38.6,53537,26559,7545,7155
81522,0,-666666666,-666666666,-666666666,0,0
81523,949,50.6,51280,41012,390,559
81524,2193,42,75536,36895,1134,1059
81525,854,34.1,68250,31876,490,364
81526,5363,49.4,58768,29577,2846,2517
81527,1918,46.1,56204,27885,972,946
81601,16177,35.1,58954,28546,8102,8075
81610,461,30.6,38250,20930,239,222
81611,9869,43.5,73426,57384,5063,4806
81612,0,-666666666,-666666666,-666666666,0,0
81615,2823,39.8,80823,53453,1621,1202
81620,10895,30.4,54772,36636,6241,4654
81621,6606,36.6,71523,36149,3291,3315
81623,15002,37.2,62955,29479,7842,7160
81624,1446,44.8,49554,26683,677,769
81625,12611,36.1,53561,24771,6558,6053
81630,801,42.4,52955,27024,441,360
81631,8079,37,82566,34504,4459,3620
81632,9511,33,82047,42684,4615,4896
81633,0,-666666666,-666666666,-666666666,0,0
81635,6578,35.1,64262,26824,3236,3342
81637,7707,33.8,83657,32168,3829,3878
81638,143,56.8,58894,32048,87,56
81639,2365,40.1,54668,26804,1243,1122
81640,217,53.1,27083,14106,131,86
81641,3584,40.9,59028,30373,1931,1653
81642,95,55.9,45526,23226,53,42
81643,715,50.6,43000,24590,387,328
81645,1046,40.5,64519,34391,551,495
81646,152,57.6,31304,22368,80,72
81647,6802,33.5,61853,27511,3489,3313
81648,2570,33.5,63636,28140,1280,1290
81649,272,40.6,64375,30982,167,105
81650,13476,33.6,52272,22027,7263,6213
81652,4478,36.8,51937,25048,2207,2271
81653,36,29.7,-666666666,19100,20,16
81654,939,48.3,54844,44729,465,474
81655,102,11.7,-666666666,,58,44
81656,413,40.6,66250,47492,177,236
81657,5668,43.5,73170,68148,3427,2241
82001,36161,33.4,48750,25943,17648,18513
82005,470,21,-666666666,19971,400,70
82007,19689,32.9,43424,21417,9767,9922
82009,32018,42.2,77268,35915,16310,15708
82050,371,48.3,31413,26254,158,213
82051,7,-666666666,-666666666,,7,0
82052,0,-666666666,-666666666,-666666666,0,0
82053,1723,41.4,92163,29785,931,792
82054,694,42.3,38387,25036,314,380
82055,268,58.7,28854,44953,182,86
82058,34,78,-666666666,57115,25,9
82059,69,67.4,-666666666,42899,35,34
82060,413,31.6,60855,29184,318,95
82061,13,-666666666,-666666666,,0,13
82063,76,44.1,250001,53036,45,31
82070,21022,27.5,49121,25299,10699,10323
82072,14886,25.9,35446,23307,7980,6906
82073,37,16.5,-666666666,830,24,13
82081,0,-666666666,-666666666,-666666666,0,0
82082,1473,40.8,54097,27651,762,711
82083,380,37.6,55216,22252,217,163
82084,0,-666666666,-666666666,-666666666,0,0
82190,781,48.4,83778,37902,493,288
82201,6196,46.4,44265,26478,3170,3026
82210,601,45.2,49531,22379,279,322
82212,256,53.5,45313,27131,132,124
82213,635,46.6,47708,28899,355,280
82214,1356,51.1,50433,25722,670,686
82215,129,55.1,61250,39805,69,60
82217,157,43.1,21875,10974,102,55
82219,15,-666666666,-666666666,,8,7
82221,584,28.4,29306,11212,249,335
82222,216,49.9,41250,21361,123,93
82223,1283,44.3,54911,23799,570,713
82224,22,-666666666,-666666666,,11,11
82225,1994,43.2,38813,26390,948,1046
82227,176,46.9,29583,32602,87,89
82229,170,9.4,16466,5953,81,89
82240,10174,41.4,42947,24080,5489,4685
82242,36,53.4,76563,47911,17,19
82243,98,53.8,50982,24019,59,39
82244,720,52.5,47823,25750,365,355
82301,9465,36.3,56353,26090,5300,4165
82321,790,35,51667,21445,411,379
82322,140,39.7,56635,26344,64,76
82323,175,46.3,77708,28886,98,77
82324,197,38.3,64554,27615,102,95
82325,877,40.6,50625,23788,491,386
82327,792,39.8,34531,22759,378,414
82329,275,59.8,44844,27024,132,143
82331,2569,46.2,55949,26716,1354,1215
82332,50,45.4,-666666666,12618,32,18
82334,449,36.5,83125,33576,264,185
82335,17,-666666666,-666666666,,9,8
82336,475,42.1,57115,25722,255,220
82401,7774,41.2,47474,28704,3886,3888
82410,1655,46.2,58578,28673,768,887
82411,521,34.2,54583,22022,283,238
82412,743,38.5,51250,19485,400,343
82414,14826,46.6,52815,28228,7278,7548
82420,764,36.6,64028,20766,345,419
82421,410,37,39271,20960,218,192
82422,154,71.5,31136,21438,87,67
82423,205,39.8,37031,17906,126,79
82426,2969,43.4,50594,23983,1559,1410
82428,42,66,52125,38131,19,23
82430,100,48.9,62500,23992,53,47
82431,3641,38.7,52134,26787,1733,1908
82432,166,48.8,53750,43960,94,72
82433,957,45.5,44833,23469,509,448
82434,214,41.2,70982,24538,93,121
82435,11912,35.2,57601,26689,5924,5988
82440,146,39.2,25815,12079,110,36
82441,240,32.8,74219,31873,147,93
82442,742,52.8,40938,23451,384,358
82443,4710,49.1,41659,26575,2280,2430
82450,214,33.5,24722,48587,130,84
82501,19777,35,48161,23668,9816,9961
82510,441,30.8,44583,13944,258,183
82512,197,56.4,29737,22244,110,87
82513,1805,54.3,43894,27279,916,889
82514,1390,35.3,35208,16076,652,738
82515,449,35.2,41406,22174,214,235
82516,414,50.4,33750,18539,215,199
82520,13778,39.3,56554,24971,6844,6934
82523,1026,49.4,46905,25357,518,508
82601,27486,35.9,55298,28726,14015,13471
82604,26325,37.5,62212,30812,12983,13342
82609,16772,37.3,60912,32619,8550,8222
82620,309,31.7,151528,31710,182,127
82630,78,29.3,-666666666,32146,57,21
82633,9513,40.6,65417,33305,4793,4720
82635,397,30.8,41500,19981,217,180
82636,3850,35,50781,26742,1861,1989
82637,4251,38.4,62404,26644,2210,2041
82638,0,-666666666,-666666666,-666666666,0,0
82639,798,39.6,50318,21464,384,414
82640,35,57.2,-666666666,24829,20,15
82642,51,55.8,41944,37871,23,28
82643,619,30.1,56176,22149,330,289
82644,1478,33,36111,16949,818,660
82646,0,-666666666,-666666666,-666666666,0,0
82648,19,-666666666,-666666666,,19,0
82649,1189,46.2,51250,28683,622,567
82701,5433,40.5,52207,26823,2806,2627
82710,218,66.6,23750,24930,99,119
82711,120,56.4,47386,27053,75,45
82712,401,38,49728,27536,265,136
82714,188,27.6,79875,22048,59,129
82715,0,-666666666,-666666666,-666666666,0,0
82716,18468,33.4,71715,31697,9667,8801
82718,23189,31.2,85643,36339,12133,11056
82720,1285,41.5,59615,27549,702,583
82721,2697,41.4,68125,30336,1414,1283
82723,323,46.8,58347,25781,198,125
82725,212,51.9,56063,27527,118,94
82727,2511,36.5,74866,31860,1220,1291
82729,2093,50.5,44784,27224,1002,1091
82730,1528,42.4,65848,37302,820,708
82731,74,48.5,-666666666,40976,23,51
82732,2401,31,82083,29055,1312,1089
82801,24412,41.5,51627,27524,11858,12554
82831,155,36.1,58594,24849,78,77
82832,940,34.8,71250,27664,555,385
82833,95,57,-666666666,118049,46,49
82834,7497,47.2,57627,29188,3842,3655
82835,324,43.4,50833,26437,176,148
82836,1157,38.9,67083,29002,574,583
82837,19,61.3,43750,44421,7,12
82838,373,21.9,56786,20260,175,198
82839,1127,50.3,43300,25854,586,541
82842,1121,53.8,41674,30160,664,457
82844,65,34.7,-666666666,25754,36,29
82845,0,-666666666,-666666666,-666666666,0,0
82901,28785,32.1,69276,29947,15098,13687
82922,162,60.3,71729,57266,59,103
82923,409,41.6,98194,32117,249,160
82925,113,53.1,75400,39133,70,43
82929,0,-666666666,-666666666,-666666666,0,0
82930,14795,33.5,55833,24471,7419,7376
82932,1032,35.9,91115,40005,538,494
82933,684,41.7,45563,31945,376,308
82934,239,33.1,32450,13016,156,83
82935,13204,34.7,74714,31445,6808,6396
82936,5,-666666666,-666666666,,5,0
82937,3364,36.3,75341,27862,1792,1572
82938,185,55,103571,45073,96,89
82939,1970,34.8,72813,25475,1012,958
82941,5392,34,85130,35162,2954,2438
82942,25,53.4,105833,65984,16,9
82943,84,48.5,-666666666,14165,52,32
82944,325,47.7,44167,32508,188,137
82945,268,37.7,86667,27567,156,112
83001,16031,36.9,68641,44851,8255,7776
83011,153,23.3,-666666666,18600,78,75
83012,99,38.6,-666666666,33864,41,58
83013,383,40.9,47195,30264,141,242
83014,4052,37.4,73317,41271,2325,1727
83025,128,30.7,21887,71466,76,52
83101,3017,40.4,64750,30818,1532,1485
83110,4808,32.2,67401,22387,2411,2397
83111,527,31.2,52411,24550,280,247
83112,437,52.6,58625,20816,230,207
83113,2918,37.1,85125,38306,1498,1420
83114,1023,25.9,54107,16464,506,517
83115,1076,41.8,47235,26900,611,465
83116,615,53.4,53167,31151,317,298
83118,1343,35.5,81875,29604,784,559
83119,51,71.6,-666666666,28341,22,29
83120,818,33.4,70885,23528,391,427
83121,5,-666666666,-666666666,,5,0
83122,469,36.1,83333,28556,290,179
83123,607,50.2,52218,28146,294,313
83124,75,53.3,100417,37565,28,47
83126,469,32.8,100759,26993,230,239
83127,2625,48.3,48036,24309,1315,1310
83128,1380,38.5,57426,32117,755,625
83201,37877,30.4,41420,21066,19293,18584
83202,21979,32.8,45719,20151,11141,10838
83203,350,43.1,22250,14530,125,225
83204,18597,33.7,43188,22364,8771,9826
83209,835,20.2,8906,6571,440,395
83210,3429,29.5,40878,15910,1780,1649
83211,5680,32.6,43676,17635,2880,2800
83212,155,55.8,54667,35400,90,65
83213,1667,45.2,41198,22317,850,817
83214,548,41.7,40966,18929,283,265
83215,26,54,19583,12492,13,13
83217,814,34.6,55250,20074,413,401
83218,365,37.1,36389,14580,180,185
83220,142,47.4,77115,24482,50,92
83221,27130,32,47127,19220,13595,13535
83223,99,51.1,48125,19183,55,44
83226,2522,44.2,37875,22948,1354,1168
83227,288,49.1,95964,33228,233,55
83228,580,25.6,32946,14099,284,296
83232,510,28.7,47292,15126,245,265
83233,12,-666666666,-666666666,,12,0
83234,1265,37.3,46250,17566,567,698
83235,38,70.4,-666666666,41097,20,18
83236,2028,33.3,54970,22603,1084,944
83237,1497,30.5,45556,17167,739,758
83238,118,30.9,64667,25314,67,51
83239,517,42.4,44583,20620,236,281
83241,1998,36.9,45341,19351,948,1050
83243,121,32,38750,16498,43,78
83244,244,37.9,48125,20241,135,109
83245,2182,38.4,67659,26003,1130,1052
83246,881,48.3,66875,29728,370,511
83250,1290,49.4,52109,20347,631,659
83251,1080,51.8,47273,25236,530,550
83252,4127,38.8,40598,18834,2221,1906
83253,126,39.5,41250,27872,57,69
83254,3760,39.2,37377,20671,1819,1941
83255,1138,39.7,41422,19590,573,565
83261,480,40.7,46071,27656,255,225
83262,1126,35,64185,21251,610,516
83263,8482,34.3,44684,18645,4389,4093
83271,675,36.4,39313,17008,358,317
83272,432,23.5,45404,17781,264,168
83274,9345,31.4,51176,18661,4579,4766
83276,3864,40.6,60373,26550,2004,1860
83277,285,59.2,48750,17576,138,147
83278,116,56,22059,16247,28,88
83281,166,64.1,14857,20625,66,100
83283,148,14.7,33438,7656,85,63
83285,192,26.8,36563,15395,97,95
83286,1584,24,54500,15580,747,837
83287,302,60.5,70417,27877,162,140
83301,52396,33.4,43726,20752,25885,26511
83302,83,34.7,30000,18700,51,32
83311,445,39.5,58750,22396,222,223
83312,159,29,19931,15398,101,58
83313,3609,35.4,45168,23296,1840,1769
83314,934,42.1,35417,16975,466,468
83316,9917,40.3,39916,20838,4888,5029
83318,16951,32.1,39482,17762,8548,8403
83320,869,29.9,55556,20577,468,401
83321,655,34.7,45257,17713,361,294
83322,59,35.9,24722,15912,35,24
83323,1970,31,46573,18263,1121,849
83324,810,31.1,44524,15442,438,372
83325,765,49.6,40069,23383,374,391
83327,1137,38.7,38750,19587,618,519
83328,5239,38.6,42098,18591,2481,2758
83330,6422,36,33904,18113,3360,3062
83332,2595,49.4,36935,23168,1203,1392
83333,11062,39.9,76481,35089,5656,5406
83334,2113,36.2,39598,18330,1102,1011
83335,1918,35.5,43083,21626,1022,896
83336,4644,35.7,40960,18832,2350,2294
83337,27,63.1,-666666666,141063,22,5
83338,19709,30.9,40131,16581,9938,9771
83340,4231,51.1,60840,48819,2115,2116
83341,6796,34.2,50412,21193,3371,3425
83342,1657,26.6,45065,15352,827,830
83344,994,32.8,42614,19909,496,498
83346,1508,37,42708,19924,700,808
83347,3528,33.5,46820,19320,1780,1748
83348,96,62.4,56458,35269,55,41
83349,1091,31.5,42083,16006,558,533
83350,12338,35.1,42711,19725,6347,5991
83352,3381,35.6,41161,17264,1725,1656
83353,1280,52.4,61053,42221,691,589
83354,13,-666666666,-666666666,,7,6
83355,5379,29.8,42953,16598,2843,2536
83401,40160,29.6,47822,20351,20060,20100
83402,25335,35.3,46414,22552,12687,12648
83404,21716,37,56230,28146,10526,11190
83406,15828,29.5,58100,22534,7897,7931
83414,410,43.5,42316,40151,213,197
83420,2485,46,44569,23007,1300,1185
83421,333,45.5,38942,21817,213,120
83422,3782,33.2,52292,22034,1872,1910
83423,691,33.6,34500,20516,368,323
83424,102,49.6,-666666666,,59,43
83425,814,35.4,51125,19559,461,353
83427,1441,27,54519,16295,758,683
83428,307,55.3,43864,24373,179,128
83429,908,60.6,52500,36008,481,427
83431,772,34.6,45938,17811,398,374
83433,6,-666666666,-666666666,,2,4
83434,2020,29.9,53750,19605,1087,933
83435,451,39.2,42917,18710,243,208
83436,334,37.2,36250,16887,185,149
83440,35636,22.9,31441,15143,17455,18181
83442,19258,30.3,54145,20100,9467,9791
83443,1047,38.1,39663,16458,487,560
83444,1311,28.8,37232,12845,716,595
83445,6698,31.1,43354,17239,3510,3188
83446,33,67.7,18824,18245,19,14
83448,2339,26.4,54342,17729,1241,1098
83449,211,43.3,51250,23593,135,76
83450,1043,30.1,42583,19198,551,492
83451,885,31.9,36750,17882,433,452
83452,857,46.7,64133,25618,505,352
83454,528,29.9,53125,17095,246,282
83455,5400,34.4,49277,22109,2903,2497
83460,826,18.9,-666666666,4035,239,587
83462,498,54.1,28810,19320,252,246
83463,81,60.1,17250,13325,60,21
83464,386,32.3,34688,17670,183,203
83465,132,48.4,55469,21713,71,61
83466,308,39.5,82986,40792,211,97
83467,6161,50.1,34936,23939,3002,3159
83468,145,62.3,27266,21526,61,84
83469,43,64.9,31172,26249,29,14
83501,34185,41.2,46046,24596,16944,17241
83520,150,64.5,31071,22369,87,63
83522,2522,38.1,47026,19147,1433,1089
83523,711,47.9,47679,24790,364,347
83524,1064,45.7,51310,21177,526,538
83525,483,55.5,25625,15984,345,138
83526,358,46.3,41591,18171,191,167
83530,5557,48.3,39116,18503,2653,2904
83533,87,58.7,41932,29653,45,42
83535,1158,41.5,59722,27414,616,542
83536,4017,47.5,35546,18808,1985,2032
83537,1065,52,48917,24666,566,499
83539,2112,49.2,32778,18857,1100,1012
83540,2437,32,38558,17060,1254,1183
83541,973,51.3,44250,26588,455,518
83542,196,34.3,48452,16904,113,83
83543,682,46.2,40000,22229,387,295
83544,5944,47.9,41364,19821,3245,2699
83545,543,50,53068,23863,297,246
83546,788,49.4,50357,20896,459,329
83547,218,55.1,27813,13514,112,106
83548,148,31,36250,14764,64,84
83549,844,57.3,32298,21014,450,394
83552,1013,46.5,36579,19285,581,432
83553,1021,57.3,38068,21014,569,452
83554,518,55.7,32667,23307,249,269
83555,504,54.4,36528,20830,239,265
83601,47,74.3,22750,16538,30,17
83602,16,58.7,-666666666,30113,6,10
83604,809,37,32159,16468,444,365
83605,39427,30.1,37729,15660,19370,20057
83607,23157,34.8,47753,19157,11631,11526
83610,921,50.5,33750,21549,477,444
83611,2794,51.2,43164,27481,1551,1243
83612,1995,54.3,37321,22118,1020,975
83615,951,53.8,40662,18276,456,495
83616,23181,41,82159,39399,11410,11771
83617,15295,42.6,42416,20536,7705,7590
83619,7127,40.2,50298,21647,3400,3727
83622,1360,57.9,32917,24236,665,695
83623,1511,46.9,31453,19544,733,778
83624,1479,27.1,39583,16313,743,736
83626,1068,42.8,41875,18618,472,596
83627,617,49.9,54297,26104,326,291
83628,4475,35.6,32375,14672,2294,2181
83629,1800,40.9,39792,21797,941,859
83631,1210,47.4,28224,17806,654,556
83632,266,51.9,25625,16908,138,128
83633,294,56.9,31813,35836,163,131
83634,25875,31,59221,16711,14885,10990
83636,71,20.3,-666666666,6018,29,42
83637,284,54.9,36016,21188,180,104
83638,5876,43.3,53850,26119,2925,2951
83639,3036,35.5,32878,16106,1478,1558
83641,3653,37.6,39844,17437,2023,1630
83642,36685,35.2,57089,27983,17755,18930
83643,122,57.1,45833,22399,67,55
83644,9921,33.9,51792,22109,4950,4971
83645,521,60.1,33906,22143,261,260
83646,50342,33.4,65941,25497,24424,25918
83647,20487,32.6,44940,21426,10454,10033
83648,3273,21.3,34375,13869,1908,1365
83650,552,53.1,39706,29261,275,277
83651,29059,32.5,36598,17194,14808,14251
83654,1616,47,36667,21954,874,742
83655,4483,34.2,42535,18525,2354,2129
83656,564,33.9,38194,15337,258,306
83657,193,64.5,47216,24080,94,99
83660,6103,39.2,37756,17201,3160,2943
83661,9357,35.8,36572,16658,4581,4776
83666,24,60.4,58750,29796,12,12
83669,8492,31.4,63843,23913,4426,4066
83670,515,51.7,46111,18047,265,250
83671,10,-666666666,-666666666,,10,0
83672,8643,40.9,38605,20139,4324,4319
83676,4242,37.6,42625,17847,2266,1976
83677,115,52.4,50625,23823,50,65
83686,47091,33.2,46709,19314,23009,24082
83687,29367,29,42899,16588,14396,14971
83702,23346,35.5,43775,35112,12001,11345
83703,15709,39.9,49388,30606,7529,8180
83704,39795,35.8,44558,22532,19789,20006
83705,27539,34.3,37332,22686,14310,13229
83706,31660,31.3,44295,28264,15517,16143
83709,52110,35.3,64376,26117,26539,25571
83712,8126,42.4,65083,42689,4155,3971
83713,27024,37,57465,27045,12880,14144
83714,20014,41,44193,27979,9493,10521
83716,15826,37.4,83738,34664,7911,7915
83801,6057,40.9,49442,22979,3013,3044
83802,211,35.9,67917,20289,102,109
83803,509,62.2,46976,45494,203,306
83804,1180,50.6,38160,21432,636,544
83805,8252,43,38533,19910,4148,4104
83806,207,48.3,39688,14928,124,83
83808,163,34.9,29688,13147,72,91
93206,2240,30.1,43355,15325,1177,1063
93207,304,56.2,34500,21743,151,153
93208,142,56.7,81071,43782,81,61
93210,21846,34.5,47088,15701,13653,8193
93212,25618,36.1,33756,8700,18522,7096
93215,56141,29,35195,10595,32500,23641
93218,845,26.3,29375,12442,438,407
93219,9570,22.2,25000,8257,4671,4899
93220,255,19.4,-666666666,7331,167,88
93221,15488,33.5,44463,22625,7711,7777
93222,1555,50.6,44179,28479,745,810
93223,10695,26,32197,11114,5069,5626
93224,459,38.9,60114,27536,246,213
93225,5373,44.3,55313,26798,2647,2726
93226,382,47.7,44107,29310,183,199
93230,65927,31.9,52611,22670,33688,32239
93234,6936,23,23238,8987,3400,3536
93235,3924,25.8,29688,10348,2161,1763
93238,1653,56.4,58480,34400,883,770
93239,1720,27.6,41912,14960,881,839
93240,5100,51.1,22706,20258,2575,2525
93241,18541,24.6,32490,10512,9728,8813
93242,3267,33.4,41325,20465,1674,1593
93243,1419,25.5,64611,20174,696,723
93244,293,48.7,34500,21319,162,131
93245,36708,27.2,51850,22875,18890,17818
93247,18417,27.7,35799,13604,9403,9014
93249,2459,22.3,32768,8892,1411,1048
93250,13493,24.4,35616,9198,7750,5743
93251,233,33.7,38750,16661,130,103
93252,3830,38.3,31550,9659,3012,818
93254,611,35.2,37679,16720,318,293
93255,627,61.5,31250,24502,257,370
93256,5591,21.7,27305,10829,2986,2605
93257,76470,29.3,40851,16371,38481,37989
93258,1854,24,20417,7061,986,868
93260,162,63.2,25089,24664,100,62
93261,3317,22.8,29528,8477,1693,1624
93262,45,46.5,-666666666,,16,29
93263,19613,27.5,41448,15256,9763,9850
93265,2879,56.6,47058,29555,1462,1417
93266,1378,25.2,28700,9707,640,738
93267,7010,28.4,31865,12178,3575,3435
93268,17143,32,45024,19797,8622,8521
93270,5615,28.3,30142,13213,2722,2893
93271,2155,54,39345,31445,1139,1016
93272,3396,24.3,37448,12151,1853,1543
93274,70820,29.9,44775,18292,34793,36027
93276,148,23.9,46250,17563,81,67
93277,51604,33.6,50066,23703,24943,26661
93280,27162,28.4,39038,10749,16731,10431
93283,2319,57.1,24821,18616,1247,1072
93285,2005,56.8,31761,23866,1033,972
93286,9950,27.5,39783,14479,5016,4934
93287,112,55.2,58125,30029,67,45
93291,53742,29.9,52546,21780,27203,26539
93292,38107,31.9,53507,22443,19158,18949
93301,11396,31.6,31721,20536,5434,5962
93304,52421,28.8,35059,14398,26402,26019
93305,37194,26.1,31179,13616,19289,17905
93306,67322,30.1,54126,21827,32689,34633
93307,82472,26.3,33711,11853,40705,41767
93308,53639,33.7,42543,22646,26840,26799
93309,59489,32.1,47593,23265,29171,30318
93311,42591,31.7,86026,34121,20435,22156
93312,55539,32.7,90495,34249,27887,27652
93313,44571,29.9,61226,20066,22926,21645
93314,22535,37.9,95830,38474,11440,11095
93401,28571,31,52730,31608,14534,14037
93402,14260,47.9,57926,32306,6978,7282
93405,33567,22.7,40697,16090,20960,12607
93410,0,-666666666,-666666666,-666666666,0,0
93420,30401,46.7,67035,34583,14936,15465
93422,31349,43,65657,31633,16042,15307
93424,853,63.3,75043,52343,371,482
93426,1372,41.1,63594,30590,832,540
93427,5370,43.7,66628,33373,2890,2480
93428,6393,58.4,59813,40682,3068,3325
93429,94,59.1,68281,22561,40,54
93430,2733,58.8,55956,41122,1383,1350
93432,1041,46.2,60759,34510,523,518
93433,13269,38.1,47271,25898,6313,6956
93434,7123,30.1,47518,14851,3503,3620
93436,54433,34,52032,22926,28007,26426
93437,3693,23.2,65142,20830,2009,1684
93440,1680,42.1,63177,31803,820,860
93441,1212,52.1,84773,50987,618,594
93442,10896,50.7,51010,33140,5308,5588
93444,19712,39.2,61751,28085,9590,10122
93445,7248,36.4,43367,19220,3498,3750
93446,43356,39.4,62529,32632,21381,21975
93449,7746,51.9,65859,39375,3684,4062
93450,791,25.7,40469,12703,373,418
93451,4212,34.1,55670,25361,2054,2158
93452,609,39.4,38333,19782,352,257
93453,3575,42.5,58190,29267,1825,1750
93454,36509,33.3,50912,22739,18379,18130
93455,42919,40.6,69602,30745,20583,22336
93458,55651,26,44209,14083,28978,26673
93460,5348,50.3,96071,56054,2685,2663
93461,1589,31.4,63750,26442,911,678
93463,7822,50.4,66146,44414,3991,3831
93465,9738,42.4,80884,35409,4748,4990
93501,5411,36,30250,16260,2822,2589
93505,13324,37.2,51238,22300,6795,6529
93510,7216,44.9,85096,32998,3765,3451
93512,143,63.3,16625,18722,36,107
93513,1541,48.3,44583,25978,811,730
93514,14250,46.7,51218,29460,7142,7108
93516,2347,44.1,35872,16612,1041,1306
93517,591,54.8,61940,34192,325,266
93518,1131,53.9,45382,32729,580,551
93519,89,74,22083,19882,45,44
93522,15,-666666666,-666666666,,7,8
93523,2926,26,52569,21337,1430,1496
93524,454,22,-666666666,21790,445,9
93526,713,50.1,58958,28995,352,361
93527,2125,47.1,52170,38910,1079,1046
93528,49,71.6,-666666666,15180,19,30
93529,419,34.5,39760,26051,364,55
93530,56,60.3,28333,14946,24,32
93531,409,53.5,82622,47454,208,201
93532,2476,41.5,62688,28375,1141,1335
93534,39563,32.9,35892,17811,19181,20382
93535,73606,30.1,44399,16269,35229,38377
93536,69988,35.8,70577,26042,37475,32513
93541,766,30.6,54643,18728,367,399
93543,13251,35.1,56279,18061,6732,6519
93544,944,60.2,51750,45260,514,430
93545,2214,40.6,32473,18444,1155,1059
93546,9681,35.1,70607,28253,5091,4590
93549,364,46.4,44261,32279,175,189
93550,74561,26.8,38316,14144,36660,37901
93551,50306,37.9,80663,30370,24595,25711
93552,39943,27.7,56163,15921,19368,20575
93553,2242,47.8,50132,24091,1241,1001
93554,116,69.6,26280,16139,64,52
93555,32376,36.4,61221,28697,16047,16329
93558,249,53.7,24306,18851,78,171
93560,19371,33.2,59142,22855,9779,9592
93561,34851,39.3,57433,24708,20137,14714
93562,1877,39.8,31645,22791,966,911
93563,344,55.7,85250,29762,213,131
93591,6483,30.9,41972,18910,3463,3020
93592,16,-666666666,-666666666,,9,7
93601,2050,42.3,53594,30718,1026,1024
93602,4074,48,58168,28193,1985,2089
93603,271,63.5,36875,33137,132,139
93604,967,45.5,60652,31976,427,540
93605,243,49.2,84375,34293,130,113
93606,424,25,23750,10792,200,224
93608,804,30.9,30523,9270,429,375
93609,6282,26,47361,15298,3073,3209
93610,24206,35.7,40327,13566,8923,15283
93611,47559,36.3,78482,29960,22931,24628
93612,34415,31.1,39801,18678,16350,18065
93614,11245,46.7,46551,26736,5683,5562
93615,6135,23.8,27525,9566,3134,3001
93616,2455,32.8,31108,15342,1323,1132
93618,29022,28.8,38110,13752,15552,13470
93619,29476,38.5,106235,42445,14480,14996
93620,9825,32.4,34579,13805,5141,4684
93621,316,62.3,32014,32774,155,161
93622,9558,25.6,32865,13528,5154,4404
93623,51,46.7,23269,16722,18,33
93624,1377,28.5,34676,10128,774,603
93625,7049,32.8,45230,21272,3647,3402
93626,773,57.2,32560,40340,419,354
93627,51,18.5,-666666666,6167,30,21
93628,240,48.4,58977,21629,119,121
93630,18407,30.3,48115,17243,9413,8994
93631,16576,33.7,55266,23565,8246,8330
93633,0,-666666666,-666666666,-666666666,0,0
93634,24,56.2,-666666666,22521,10,14
93635,38929,30.5,46933,17620,19290,19639
93636,11341,43.4,74538,30534,5524,5817
93637,40515,29.5,48974,17449,19960,20555
93638,48805,26.6,37280,12745,25526,23279
93640,11902,27.4,25019,8974,6457,5445
93641,598,31.8,33622,17783,421,177
93643,2674,48.2,41875,23082,1369,1305
93644,7308,56.1,43376,26487,3640,3668
93645,606,45.6,61589,16305,222,384
93646,10785,24.8,27906,10118,5192,5593
93647,12320,24.4,33205,9742,6021,6299
93648,15648,25.7,35499,11259,8067,7581
93650,3428,32.8,30205,14429,1582,1846
93651,1830,49.3,88080,31445,891,939
93652,415,30.1,28750,10183,231,184
93653,1115,49.5,60750,31116,585,530
93654,30665,30.7,48817,16928,15695,14970
93656,6883,26.8,43864,14138,3512,3371
93657,35768,32.6,47781,18992,17321,18447
93660,4582,23.7,26978,9275,2308,2274
93662,30340,31.6,43790,16791,15513,14827
93664,701,44.6,78750,38483,416,285
93665,449,47.4,29607,16328,303,146
93666,524,22.7,23313,8912,234,290
93667,1985,48,54459,26976,1108,877
93668,1285,34,28571,11144,649,636
93669,230,59.1,2499,15866,81,149
93673,959,27.6,37333,11546,533,426
93675,2566,52,60743,26115,1318,1248
93701,10602,25.9,20201,7763,5602,5000
93702,48181,25.5,27372,9399,24334,23847
93703,35127,26.9,28663,11123,18133,16994
93704,26369,38.2,45866,27808,12299,14070
93705,38600,29.7,32485,13843,18670,19930
93706,38963,27.1,29275,11979,19464,19499
93710,32701,26.8,42286,20243,15912,16789
93711,37651,43.6,65678,39697,17805,19846
93720,46300,36.5,75200,35391,21755,24545
93721,6445,33.4,16597,10914,3864,2581
93722,79727,29.3,55500,20444,39446,40281
93723,8809,37.2,65045,25516,4542,4267
93725,25884,26.7,35974,12576,12591,13293
93726,41140,28.7,32796,15576,20184,20956
93727,70774,29.8,45760,18828,35939,34835
93728,14791,33.1,32215,17446,7432,7359
93730,10896,39.1,118396,50065,5522,5374
93901,26642,35,48514,23631,13378,13264
93905,60905,26,41607,11983,32061,28844
93906,62073,29.7,56358,19643,30474,31599
93907,21152,39.7,68497,27797,10796,10356
93908,12675,46.9,108093,50630,6178,6497
93920,765,46.6,81125,56100,454,311
93921,3169,53.4,66231,44253,1479,1690
93923,13141,58.3,105714,63976,6108,7033
93924,5882,51.8,88926,54331,2792,3090
93925,1708,32.5,70909,23642,905,803
93926,8735,27,50933,16152,4394,4341
93927,17270,25.8,52642,13895,8475,8795
93928,308,22.8,80707,27793,177,131
93930,16234,26.3,47262,16754,9027,7207
93932,466,48,94643,50682,287,179
93933,22634,35.5,52736,24855,10929,11705
93940,33685,37.8,67513,38374,17128,16557
93943,7,-666666666,-666666666,,0,7
93950,15241,49.3,71969,44343,7306,7935
93953,4766,57.7,100268,59833,2191,2575
93954,222,31.8,39167,12520,103,119
93955,33709,31.1,55678,22582,16617,17092
93960,27334,35.2,50504,10976,18628,8706
93962,878,35.6,81500,32891,455,423
94002,26483,41,102090,53517,13079,13404
94005,4330,42.9,78542,46843,2090,2240
94010,41480,41.9,109775,74474,20682,20798
94014,47818,37.6,71739,26459,23626,24192
94015,61591,39.6,76978,30658,29861,31730
94019,18199,44.4,100394,51792,8897,9302
94020,1435,53.5,99716,56165,692,743
94021,115,58.6,92375,53057,42,73
94022,19358,47.9,165534,97152,9406,9952
94024,22349,46.1,167384,85227,11001,11348
94025,40372,39.2,115444,69074,19466,20906
94027,7110,47.5,220583,129577,3581,3529
94028,6788,50.9,161205,123145,3278,3510
94030,21867,45.4,88451,42042,10489,11378
94037,3080,45.3,150071,47892,1508,1572
94038,3000,46.9,106429,50898,1560,1440
94040,33852,35.7,99375,54558,17131,16721
94041,13219,36.2,92125,59394,6615,6604
94043,28189,35.7,97552,53373,14304,13885
94044,37943,41.7,94453,43956,18357,19586
94060,1764,38.2,80417,36137,871,893
94061,37176,37.1,79833,39610,18087,19089
94062,27142,43.8,125060,70247,13403,13739
94063,31497,31,52818,22108,16808,14689
94065,11109,40.4,132337,65446,5379,5730
94066,41636,38.5,78911,35342,20383,21253
94070,29531,42,117679,59527,14530,15001
94074,253,45.2,84500,43311,177,76
94080,65200,37.8,77058,31603,32499,32701
94085,23476,31.1,91808,36586,12156,11320
94086,45775,33.7,96919,47097,24190,21585
94087,54362,39.4,114771,52479,27319,27043
94089,20505,34.9,85769,35701,10190,10315
94102,25881,43.3,22517,30693,15030,10851
94103,23907,40.2,43364,40126,13760,10147
94104,211,55.1,48750,84811,87,124
94105,5553,35.6,163949,144416,3013,2540
94107,27856,36.4,114439,71298,14484,13372
94108,13709,44.4,35427,47563,6893,6816
94109,55519,37,60722,58033,27853,27666
94110,72128,36,82111,46951,37502,34626
94111,3496,48.3,89722,86071,1788,1708
94112,82726,41.1,71625,25842,41115,41611
94114,31397,41,114689,79583,18885,12512
94115,33782,37.7,76952,67897,15733,18049
94116,45157,43.5,83407,41533,21093,24064
94117,41568,32.9,94479,58310,22501,19067
94118,40292,38.1,82857,56817,19166,21126
94121,42104,42,72756,44128,20625,21479
94122,57369,39.9,81768,41196,28174,29195
94123,24500,35.4,112650,94338,11507,12993
94124,35309,34.5,50146,21890,17721,17588
94127,19576,45.4,131351,63176,10126,9450
94128,66,30.5,-666666666,,0,66
94129,2787,31.4,143320,71987,1451,1336
94130,2654,27,37500,15959,1480,1174
94131,26908,42.6,96889,62735,14222,12686
94132,31080,34.8,69223,31418,14982,16098
94133,27970,40.4,50485,45147,14035,13935
94134,38815,40.6,56716,24712,18886,19929
94158,5219,31.7,82195,62385,3171,2048
94301,16420,42.3,122473,97144,8105,8315
94303,46357,32.6,80127,37272,22760,23597
94304,3797,37.6,103971,81131,1856,1941
94305,13515,21.5,64697,33871,7373,6142
94306,27236,40.3,110580,61704,13514,13722
94401,36691,35.8,69832,32902,18624,18067
94402,23289,42.8,107124,61937,11369,11920
94403,39720,40.3,90764,46432,19385,20335
94404,34431,39.8,114511,53920,16584,17847
94501,61639,39.4,69076,38185,30085,31554
94502,13179,46.6,105616,56096,6165,7014
94503,19902,35.8,82746,28550,9503,10399
94505,13083,41,111290,46490,6828,6255
94506,21096,43.8,171214,72328,9888,11208
94507,15977,46.2,160279,73148,8118,7859
94508,3740,26.1,60855,23276,1951,1789
94509,62651,34,53953,22690,29536,33115
94510,27294,44.2,88930,42899,13162,14132
94511,2172,59,35288,30423,1148,1024
94512,231,41,142885,45991,42,189
94513,55488,36.3,91343,33521,27810,27678
94514,1069,25.9,50199,16896,556,513
94515,7241,44.7,60754,36995,3816,3425
94516,129,51.9,100938,46795,68,61
94517,12644,45.9,116677,49330,6487,6157
94518,26965,40.3,70546,33738,13170,13795
94519,19400,38.9,70476,31524,9566,9834
94520,37489,31.5,47313,21096,19891,17598
94521,41354,40.3,81144,38939,20127,21227
94523,33923,42.3,77485,43827,16315,17608
94525,3121,45.5,83716,43017,1411,1710
94526,32755,45.9,124511,60954,15829,16926
94528,1124,46.4,223893,166822,501,623
94530,24101,44.6,84466,44209,11844,12257
94531,41700,33.5,87927,27713,20494,21206
94533,69067,32.9,55413,22616,33189,35878
94534,36560,39.7,92676,38542,17656,18904
94535,4728,21.3,50970,18170,2988,1740
94536,69921,37,87001,37039,35007,34914
94538,61784,34.9,85945,34237,30832,30952
94539,51494,41.2,143949,50701,25695,25799
94541,61311,34.7,56656,24755,29268,32043
94542,12385,32.9,84817,39329,5713,6672
94544,76542,32.8,60448,22479,37966,38576
94545,30083,37.5,69488,27979,14750,15333
94546,42650,40.9,73099,35705,20205,22445
94547,24454,37.4,97269,36802,11766,12688
94548,338,39.1,77750,29988,169,169
94549,27784,45.7,135980,69032,13475,14309
94550,47648,40.8,102413,46154,23510,24138
94551,37705,36.3,95716,39465,19550,18155
94552,14719,43.6,138447,52462,7389,7330
94553,48018,42.5,75672,36343,23882,24136
94555,34973,37,111268,41533,17747,17226
94556,15064,47.4,120960,62600,7125,7939
94558,66824,40.6,72286,35746,33336,33488
94559,27167,35.9,56895,29904,13931,13236
94560,43139,37.3,85847,31056,21636,21503
94561,37679,33.7,76693,27855,19008,18671
94563,18024,46.3,164173,77499,9014,9010
94564,18612,42.8,76960,34647,9115,9497
94565,86204,32.4,55255,22373,41968,44236
94566,41638,42.2,117475,51910,20312,21326
94567,800,39.7,56821,27947,387,413
94568,47384,36.1,114812,42534,24102,23282
94569,325,57.5,86719,39505,218,107
94571,8025,56.9,54223,33911,3876,4149
94572,8689,40.5,64756,27112,4397,4292
94573,117,25.1,61103,26207,71,46
94574,9538,47.3,83551,53798,4681,4857
94575,1420,19.2,-666666666,4448,617,803
94576,88,53.1,40104,25535,10,78
94577,44344,41.3,63388,30705,21569,22775
94578,39225,34,51518,23200,18871,20354
94579,21652,41.6,72369,27704,11157,10495
94580,28701,36.3,71098,25334,13622,15079
94582,38928,36,137395,53277,18756,20172
94583,34937,39.6,119623,49034,17338,17599
94585,28823,32.8,70374,25406,14740,14083
94586,866,51.4,93036,63853,405,461
94587,70687,36.5,82083,29685,34393,36294
94588,30949,38.5,119849,49641,15901,15048
94589,30364,36.8,56068,21206,13928,16436
94590,35263,37.4,41819,22499,17330,17933
94591,53548,40.1,73509,30470,26048,27500
94592,562,38,105352,53802,254,308
94595,16448,66,57744,49256,6517,9931
94596,20307,39.1,77173,46745,9294,11013
94597,20070,40.6,86227,52402,10055,10015
94598,26672,46.1,121067,56977,12363,14309
94599,3166,59.6,70250,50285,1452,1714
94601,49279,31.9,38305,16215,25806,23473
94602,28553,41.9,71510,42325,13085,15468
94603,32977,30.1,40927,16285,15846,17131
94605,42639,38.1,56944,27024,20313,22326
94606,36214,35.5,38363,21747,17667,18547
94607,25107,34.9,32856,24142,12036,13071
94608,26288,36.4,52787,36714,13145,13143
94609,21210,35.4,52400,34084,9590,11620
94610,29978,38.8,72848,57078,14177,15801
94611,36676,42.9,104967,71760,17838,18838
94612,13816,40.4,26054,28528,7152,6664
94613,861,19.7,-666666666,10090,152,709
94618,17226,42.3,116604,71892,8060,9166
94619,22809,40.6,75963,38901,10973,11836
94621,31833,27.6,31082,12405,15848,15985
94702,16324,39.6,57457,36181,7830,8494
94703,21281,34.9,55554,35844,10602,10679
94704,24906,21.7,31116,20430,11356,13550
94705,12979,44.1,94750,69025,6297,6682
94706,19918,35.7,81206,40880,9569,10349
94707,12324,50.4,138144,70264,5820,6504
94708,11073,52,140611,78020,5291,5782
94709,12360,29.8,57433,36941,6610,5750
94710,6478,35.7,63125,34770,3153,3325
94720,3026,19.3,23304,11820,1502,1524
94801,29825,30.3,40030,18957,14970,14855
94803,26124,41.1,75052,36846,12758,13366
94804,39995,35.4,49261,23996,18962,21033
94805,14232,40.4,65747,27802,6673,7559
94806,59720,33.7,52976,22112,29373,30347
94850,0,-666666666,-666666666,-666666666,0,0
94901,41056,38.9,72311,44797,20978,20078
94903,30411,46.4,88646,48387,14882,15529
94904,12087,49,102538,82093,5502,6585
94920,12528,49.6,138884,102524,5744,6784
94922,323,40.5,28864,17491,129,194
94923,668,59.9,76583,53361,302,366
94924,1164,53,63750,42994,573,591
94925,9326,45.1,107193,64729,4239,5087
94928,42361,32.5,56543,26254,19785,22576
94929,70,66.9,45139,47346,21,49
94930,8606,44.3,89306,53117,4119,4487
94931,8646,35.4,66111,33336,4227,4419
94933,1078,37.4,69271,36665,505,573
94937,1099,53.2,50045,47529,581,518
94938,907,44.8,100509,36383,373,534
94939,6887,46.5,97723,78588,3250,3637
94940,228,62.4,29813,46877,110,118
94941,30650,45.5,110221,71971,14758,15892
94945,18107,44.4,83026,44454,8706,9401
94946,669,52.4,131250,72782,344,325
94947,24540,43.6,80719,44374,11466,13074
94949,16895,43.6,77308,48567,8455,8440
94950,47,70.2,87708,33581,30,17
94951,4253,43.9,90027,49635,2113,2140
94952,34039,42.3,76813,38223,16751,17288
94954,36785,40.7,80645,33411,17778,19007
94956,1779,48,57105,49913,822,957
94957,969,48.2,130208,94124,457,512
94960,15986,45.3,108629,62243,7441,8545
94963,448,56.6,83009,38665,207,241
94964,4827,41.4,-666666666,4654,4656,171
94965,10926,49.8,91410,68695,5202,5724
94970,595,59.5,81743,49910,281,314
94971,357,57.4,62500,39547,162,195
94972,38,-666666666,-666666666,,19,19
94973,1745,50.8,72368,46016,844,901
95002,1728,36.4,70114,28676,808,920
95003,24430,44.9,83507,43093,11639,12791
95004,3689,46.8,73107,37516,1871,1818
95005,6168,44,73877,39279,3020,3148
95006,9597,46.4,75944,40055,4862,4735
95007,517,51.4,146842,95453,336,181
95008,45187,37.3,87204,44023,22696,22491
95010,9241,41.5,53275,36751,4738,4503
95012,10456,27.5,55127,15214,5270,5186
95013,22,-666666666,-666666666,,11,11
95014,61521,39.6,127870,53549,29769,31752
95017,741,45.9,73125,37931,399,342
95018,7993,43.1,71964,38350,3926,4067
95019,7692,25.8,36791,14257,3972,3720
95020,58246,33.4,81037,29889,29280,28966
95023,50067,33.8,67481,25653,24882,25185
95030,13791,47.4,151538,86419,6552,7239
95032,25664,43.8,122163,63721,12541,13123
95033,9309,47.9,116382,62648,4764,4545
95035,68178,36.8,95437,33711,34066,34112
95037,46100,39,95047,41627,22296,23804
95039,1308,40.3,55724,23292,527,781
95041,215,27.6,58958,22238,120,95
95043,616,51.6,65341,35269,300,316
95045,4010,40.3,58005,25679,2198,1812
95046,6547,43.9,92778,40262,3235,3312
95050,37057,34.2,67630,34522,18932,18125
95051,53152,36.1,100504,43487,26443,26709
95053,2513,19.4,250001,7205,1317,1196
95054,24408,33.3,110099,43543,12554,11854
95060,46688,34.6,62879,34949,23590,23098
95062,36201,38.9,60035,32033,17908,18293
83809,349,43.3,52167,15795,142,207
83810,1486,50,44808,25150,752,734
83811,1254,49.3,27750,20084,695,559
83812,103,45.6,25000,11216,73,30
83813,840,34.5,72818,24103,486,354
83814,24600,40.8,44518,28717,11966,12634
83815,31064,37.7,44774,23185,15465,15599
83821,346,62.4,61923,29202,187,159
83822,2513,40.9,44833,20818,1408,1105
83823,1455,43.6,47083,22331,756,699
83824,290,44.7,29792,15801,145,145
83825,341,35.2,71719,31779,190,151
83826,0,-666666666,-666666666,-666666666,0,0
83827,119,50.3,34583,23411,75,44
83830,929,42.7,37244,16450,509,420
83832,1528,39.9,63000,26786,800,728
83833,1006,57.6,46447,27575,521,485
83834,278,43.4,51500,23125,148,130
83835,20052,43.6,56769,25440,10036,10016
83836,921,54.5,47895,35313,439,482
83837,3081,38.5,38833,19088,1450,1631
83839,1060,60.4,40000,25978,564,496
83840,192,39.7,45000,23420,117,75
83841,171,60.8,26618,23912,47,124
83842,200,31.4,34583,15198,68,132
83843,25562,26,35089,22054,13183,12379
83844,1520,19.5,-666666666,4631,726,794
83845,1588,47.5,34145,17907,785,803
83846,652,48.3,39350,24214,353,299
83847,1026,41.2,25144,22658,667,359
83848,202,49.8,32614,19477,143,59
83849,1780,49,37946,22393,894,886
83850,2119,44.1,32891,18748,997,1122
83851,1440,45.3,34625,17178,654,786
83852,983,30.9,24583,19070,469,514
83854,38032,34.7,50283,23920,18108,19924
83855,2223,43.9,52529,21644,1163,1060
83856,5846,49.2,39863,20476,3017,2829
83857,599,52.2,48510,31207,320,279
83858,14001,40.9,50332,21421,7322,6679
83860,5448,50.4,44320,24283,2645,2803
83861,6765,46.5,40761,21976,3475,3290
83864,17942,45.1,43041,24969,8560,9382
83866,70,53,-666666666,31084,49,21
83867,567,59.9,45878,20227,322,245
83868,835,38.2,22931,18913,305,530
83869,3960,39.8,37155,19506,2047,1913
83870,260,53.3,40833,20453,123,137
83871,2001,41.8,67644,28062,1008,993
83872,776,43.6,75208,39115,388,388
83873,1899,50.5,41511,21376,1123,776
83874,93,68,-666666666,8597,47,46
83876,1627,49.7,53750,25524,862,765
84001,1143,24.4,68571,22547,662,481
84002,254,26.4,48438,22994,157,97
84003,43441,24.9,76345,24434,22303,21138
84004,10097,27.7,98966,34955,5097,5000
84005,22358,21.6,68408,18594,11304,11054
84006,702,29.7,44844,15914,363,339
84007,582,31.8,85455,35175,308,274
84010,45381,34.1,63159,28391,22151,23230
84013,817,27.5,79833,25055,428,389
84014,15853,34.5,75806,30649,8081,7772
84015,62387,28.6,58745,20735,32043,30344
84017,3899,31.8,59946,22357,2011,1888
84018,60,32.8,38333,23122,32,28
84020,42751,30.4,89922,33164,22538,20213
84021,3780,33.3,45625,20831,1930,1850
84022,1046,22.5,64063,23898,510,536
84023,225,38.7,57917,23421,115,110
84024,57,46.4,39821,59514,34,23
84025,19607,29,85691,31581,9618,9989
84026,1423,30,36429,18481,717,706
84027,475,69,36705,20570,250,225
84028,604,34.5,36944,17076,272,332
84029,9470,31.1,63419,21743,4505,4965
84031,259,39.2,49375,22597,127,132
84032,18404,30,60121,23395,9265,9139
84033,948,35.3,55577,24074,468,480
84034,200,40.6,42083,20850,121,79
84035,520,26.6,111250,42506,323,197
84036,5966,33.5,60335,24438,2988,2978
84037,33965,29,90288,27939,16833,17132
84038,389,37.7,89000,48857,201,188
84039,985,31.6,58750,18844,465,520
84040,23524,32.6,87541,32612,11689,11835
84041,45489,28.6,56395,21702,22900,22589
84042,10282,25.5,89286,22983,5237,5045
84043,51511,24.4,73409,22156,26206,25305
84044,27877,28.4,55713,18192,14003,13874
84045,18421,18.6,73424,21254,9569,8852
84046,597,49.6,45667,22849,353,244
84047,30942,30.4,48593,23042,15471,15471
84049,4552,37.7,80431,33941,2350,2202
84050,9632,31.6,80529,26293,4880,4752
84051,485,28.8,65000,27146,283,202
84052,1246,32.3,50192,23109,681,565
84053,1033,33.2,88000,30559,507,526
84054,16169,28.6,71354,29916,8156,8013
84055,1276,32.1,73646,29107,698,578
84056,3549,22.3,46553,14821,1735,1814
84057,37726,26.4,49465,18445,19103,18623
84058,31633,25,49899,20128,15771,15862
84060,7824,39,83202,51787,3913,3911
84061,492,28.9,37200,15487,256,236
84062,43615,25,67132,22257,21183,22432
84063,376,43.8,64000,21286,188,188
84064,921,27.5,49773,19361,478,443
84065,38369,29.3,85437,25611,19892,18477
84066,11221,27.8,61384,23557,5496,5725
84067,37821,30.7,60170,22456,18962,18859
84069,540,48.9,65000,27820,264,276
84070,25137,31.2,58389,24644,12240,12897
84071,1445,38.2,67200,22877,735,710
84072,529,30.3,48654,18735,277,252
84073,161,42.5,76563,22111,86,75
84074,45118,29.6,61447,22466,22934,22184
84075,24803,27.5,85590,25594,12827,11976
84076,464,19.8,77083,19274,250,214
84078,27369,29.6,62500,24102,13948,13421
84080,233,29.5,44792,19541,128,105
84081,43978,25.9,72987,21135,22062,21916
84082,817,41.5,66532,21588,400,417
84083,1226,29.8,29674,13637,608,618
84084,36006,31.9,63403,24698,18239,17767
84085,487,31.3,35855,17033,216,271
84086,365,43.2,62500,22284,203,162
84087,14249,29.2,78962,24615,7108,7141
84088,36360,30,67292,22516,18761,17599
84092,29693,37.3,99530,37349,15330,14363
84093,23237,41,94938,40837,11825,11412
84094,27670,31.6,68133,26159,13461,14209
84095,53995,29.9,89591,29349,27366,26629
84096,34527,23.5,75661,23602,17312,17215
84097,20591,29.6,67782,24739,9622,10969
84098,17367,39.9,109771,51778,9050,8317
84101,5124,34.3,36111,27139,2939,2185
84102,16760,29.3,35826,27373,9228,7532
84103,21311,36.2,53775,48860,11025,10286
84104,24889,27.8,38264,14086,13065,11824
84105,22899,33.6,62645,33961,11060,11839
84106,34432,34.1,54159,28195,17018,17414
84107,31350,33.4,45089,25442,14627,16723
84108,21502,34.1,85690,44773,10625,10877
84109,24259,35.3,76636,35036,11754,12505
84111,10846,34.4,26736,23512,5795,5051
84112,1997,19.5,6067,6442,1023,974
84113,102,19,-666666666,2196,32,70
84115,24695,31.1,31463,17466,12805,11890
84116,33574,29.2,42235,15888,17153,16421
84117,24355,37.5,54290,35772,11581,12774
84118,67019,30.4,61203,19777,33544,33475
84119,54882,29.9,42514,16656,28167,26715
84120,49107,30.6,55087,18001,24661,24446
84121,41646,38.9,72453,36215,20140,21506
84123,38437,31.5,49950,23382,18882,19555
84124,21454,36.5,74621,38899,10344,11110
84128,28475,28.3,64356,19099,13831,14644
84144,66,26.4,82609,61111,38,28
84180,0,-666666666,-666666666,-666666666,0,0
84301,874,38.1,64531,24165,465,409
84302,24205,31.9,58026,21909,12082,12123
84304,0,-666666666,-666666666,-666666666,0,0
84305,781,31.1,70536,20013,421,360
84306,246,46.3,86389,37896,126,120
84307,1259,35.6,63162,29809,685,574
84308,395,32,43125,16765,202,193
84309,449,38.1,55188,24873,234,215
84310,4676,40.8,76429,29278,2265,2411
84311,824,43.1,60341,22528,417,407
84312,3823,29,56429,18594,2006,1817
84313,185,34.4,24637,8363,105,80
84314,825,43.4,45208,20924,409,416
84315,8019,31.5,80766,25058,4101,3918
84316,213,36.3,48125,19501,117,96
84317,2101,50.4,89958,38007,1161,940
84318,4001,29.4,72760,23945,2025,1976
84319,7877,27.3,57328,19611,3846,4031
84320,2258,32.4,48665,21719,1149,1109
84321,44637,23.7,39593,17118,21645,22992
84324,748,44.4,79338,28459,402,346
84325,2038,30.7,76583,27340,1027,1011
84326,1707,32.5,72885,23001,921,786
84327,921,28.5,53333,19195,471,450
84328,1691,35.2,67622,24992,832,859
84329,180,31.3,26172,15904,100,80
84330,443,43.9,59700,29707,226,217
84331,308,34.4,51319,18435,148,160
84332,7364,30.4,63284,22991,3664,3700
84333,2855,31,54157,20151,1455,1400
84334,284,26.3,52813,17941,98,186
84335,11713,30.2,57019,20275,5804,5909
84336,321,32.6,44464,18971,174,147
84337,11290,27.8,57009,21336,5619,5671
84338,506,33,49028,18885,263,243
84339,4700,30,59222,25115,2478,2222
84340,3593,30,56094,20046,1822,1771
84341,20737,24.8,47931,22164,10664,10073
84401,35836,30,42520,19120,18295,17541
84403,37158,31.1,51070,25097,18924,18234
84404,56743,30.4,50739,20680,28417,28326
84405,31452,31.9,55289,25306,15337,16115
84414,26975,32.4,75951,28077,13543,13432
84501,13456,32.7,47965,19877,6754,6702
84511,4722,27.4,48715,17539,2291,2431
84512,1116,38.9,36964,18623,654,462
84513,1853,31.3,49439,20008,987,866
84515,0,-666666666,-666666666,-666666666,0,0
84516,168,34.3,43571,13353,97,71
84518,777,31.9,70515,22900,392,385
84520,1272,46.7,28688,17055,600,672
84521,697,30.8,52222,20271,378,319
84522,393,35.1,53333,19321,200,193
84523,1780,33.3,55192,18806,857,923
84525,1314,30.8,38594,15064,531,783
84526,4091,35.9,45765,21269,1919,2172
84528,2575,34.8,53000,21542,1275,1300
84529,87,74.1,14224,13320,43,44
84530,358,43.6,57757,25589,146,212
84531,648,35.2,18750,7740,308,340
84532,9525,39.3,45975,24059,4931,4594
84533,259,24.5,30000,16958,185,74
84534,2301,24.8,30458,9855,1155,1146
84535,2822,33.2,47468,19014,1466,1356
84536,1856,27.9,18750,8582,846,1010
84537,1367,36.9,58750,23382,763,604
84539,511,32.4,42841,15160,264,247
84540,105,51.2,-666666666,13764,36,69
84542,1907,35,48929,23114,960,947
84601,33667,24.8,40704,15468,16926,16741
84604,47491,22.7,48508,20559,22847,24644
84606,33499,23.5,31675,13887,16685,16814
84620,1130,34.5,56484,24725,513,617
84621,253,39.1,86331,34325,152,101
84622,1495,30.5,45188,14423,734,761
84623,446,26.5,140433,34489,272,174
84624,5600,34.5,47394,20091,2836,2764
84626,296,37.4,50823,13780,125,171
84627,6458,21.2,43506,15436,3018,3440
84628,655,43.8,45833,22017,372,283
84629,3125,33.8,58110,24836,1776,1349
84630,326,24,50625,14952,172,154
84631,3176,32.4,50903,18370,1630,1546
84632,1000,35,48828,21560,465,535
84633,1021,32.1,49250,20845,534,487
84634,3409,33.6,47153,10897,2510,899
84635,725,36.6,50329,25634,377,348
84636,404,43.3,58750,21745,182,222
84637,542,42.3,45417,17103,302,240
84638,300,32.8,96250,27682,140,160
84639,989,34.7,63024,25287,509,480
84640,193,44.3,54318,20348,85,108
84642,3435,32.8,51596,19036,1769,1666
84643,508,45.3,55000,25230,249,259
84645,2827,21.7,56776,15167,1456,1371
84646,1669,33.8,40865,18377,720,949
84647,3966,34.7,43324,18011,1928,2038
84648,5724,30.7,55157,17793,2920,2804
84649,878,23.6,60694,19660,533,345
84651,23840,26.1,63088,19484,12033,11807
84652,838,35.9,45694,17284,439,399
84653,8050,29.4,75560,23875,4219,3831
84654,2633,35.5,46645,22339,1281,1352
84655,10745,24,59466,17584,5387,5358
84656,380,36.5,58750,24588,189,191
84657,614,29.9,58750,17720,310,304
84660,38532,25.6,63684,19405,19834,18698
84662,1238,33.4,42669,16603,625,613
84663,30811,26.5,58745,22194,15580,15231
84664,8296,28.5,86196,26000,4376,3920
84665,456,32.8,49250,16991,261,195
84667,432,35,54118,23538,210,222
84701,8519,30.3,44973,18388,4258,4261
84710,174,27.5,34167,11306,82,92
84711,695,30.7,65781,20318,338,357
84712,235,42,58000,35674,141,94
84713,3708,33.8,44969,17598,1958,1750
84714,829,28.9,22500,12217,469,360
84715,472,42.7,45000,18600,238,234
84716,209,55.3,34333,24599,109,100
84718,199,40.6,56875,22256,111,88
84719,38,39.2,63750,35853,27,11
84720,19719,25.7,43427,17625,9757,9962
84721,21556,26.4,42334,17594,10893,10663
84722,615,42.2,42353,20021,310,305
84723,956,37.9,38750,15919,437,519
84724,1234,30.5,40284,15219,605,629
84725,1711,27.9,50655,16398,911,800
84726,786,50.2,38313,24038,403,383
84728,264,33.9,37857,10071,108,156
84729,305,40.4,38438,20779,147,158
84730,271,42.6,39674,22177,151,120
84731,27,-666666666,-666666666,,14,13
84732,7,-666666666,-666666666,,4,3
84733,182,39.4,76250,26692,109,73
84734,155,39.3,22188,15314,74,81
84735,227,57.3,43750,20748,117,110
84736,280,38.8,50833,17939,152,128
84737,15062,33.8,46292,19697,7121,7941
84738,7057,42.3,54259,26529,3677,3380
84739,488,37.2,40865,16801,264,224
84740,246,42.6,37500,16487,138,108
84741,5812,44.6,49858,24957,2858,2954
84742,216,55,58375,25878,96,120
84743,50,18,19167,7396,35,15
84744,294,34.5,60804,19181,143,151
84745,4134,30,42649,15330,1998,2136
84746,1504,31.7,68194,24260,755,749
84747,1093,28.7,49076,17762,564,529
84749,280,29.4,40833,22044,159,121
84750,405,56.6,29583,18593,203,202
84751,1883,30.7,45982,21467,988,895
84752,992,32.6,56397,22180,498,494
84753,53,69.1,18333,13411,21,32
84754,3845,39.7,45850,17724,2094,1751
84755,92,45.6,30833,23414,41,51
84756,286,47.3,32439,20386,154,132
84757,888,56,56534,30875,435,453
84758,549,34.8,50625,22207,233,316
84759,2319,34.1,47208,20767,1214,1105
84760,567,50.9,38125,20078,294,273
84761,2995,38.4,42829,21003,1554,1441
84762,174,68.1,45114,24083,98,76
84763,292,52.6,50625,28163,143,149
84764,163,27,38750,19698,66,97
84765,6283,28.5,62143,21707,3113,3170
84766,272,37.7,85375,30813,150,122
84767,670,51.7,61471,33419,279,391
84770,40547,32,42383,19839,20145,20402
84772,103,77.7,35917,21619,56,47
84773,116,59.4,26875,18125,44,72
84774,1754,35,48854,19273,841,913
84775,644,52.9,38750,24790,347,297
84776,582,37.3,52500,21694,302,280
84779,429,38.1,41750,20593,247,182
84780,20121,30.4,47686,20500,10309,9812
84781,101,61.1,90433,50475,59,42
84782,949,40.5,50362,19932,459,490
84783,568,46.1,63750,30941,263,305
84784,2839,16.2,33333,6199,1341,1498
84790,36269,38.1,55418,24987,17613,18656
85003,9197,36.6,36390,26795,5631,3566
85004,4533,32.9,26008,27353,2634,1899
85006,25097,28.4,22957,11979,13253,11844
85007,13737,36.2,28125,19321,7019,6718
85008,52966,29.2,32109,16205,27589,25377
85009,49710,27.1,22725,9607,27424,22286
85012,6374,43,49226,42212,3301,3073
85013,20996,37.4,43576,31603,10946,10050
85014,24669,35.7,41903,28195,12668,12001
85015,40452,29.1,30753,15435,20404,20048
85016,33646,37.8,46233,31461,16986,16660
85017,41317,26.3,27782,10911,21489,19828
85018,37461,39.7,52389,40948,18286,19175
85019,25032,27.8,32043,11477,12800,12232
85020,32540,42.1,46037,29128,16069,16471
85021,38182,33.5,38130,25941,18394,19788
85022,47433,38.4,45606,28802,23034,24399
85023,31177,35.6,47200,27745,15763,15414
85024,23687,34.9,64776,32299,11614,12073
85027,36854,33.3,51919,25343,19178,17676
85028,19276,48.5,85058,45584,9252,10024
85029,42567,35.3,42937,21197,20381,22186
85031,29755,26.8,26187,9575,14762,14993
85032,70008,34.8,48461,24597,34961,35047
85033,56009,26.2,33821,11210,28289,27720
85034,4187,29,19509,11312,2265,1922
85035,51329,23.4,31645,10338,24453,26876
85037,46208,26.7,47695,16791,24004,22204
85040,28718,28.2,30841,13788,14695,14023
85041,57329,28.4,42204,15683,27582,29747
85042,40615,31.1,46962,19804,20544,20071
85043,28553,27.2,40584,15748,14544,14009
85044,38954,38.2,66416,37918,19409,19545
85045,7902,39,115756,46274,3798,4104
85048,35362,39.1,93878,42020,17498,17864
85050,27793,36.6,78087,38849,13521,14272
85051,42860,33.5,38415,17411,21356,21504
85053,28716,36.1,48280,23336,14387,14329
85054,5867,37.1,67488,47411,2478,3389
85083,18376,34.9,105101,35722,9176,9200
85085,18501,32,83377,34738,9024,9477
85086,41194,37,76856,32487,20266,20928
85087,7131,45.4,74805,36570,3809,3322
85118,11924,61.7,62965,40172,5705,6219
85119,22081,51.6,46589,25535,11212,10869
85120,26146,48.9,34077,19680,12592,13554
85121,3249,23.9,38670,11559,1757,1492
85122,52136,37.7,44910,21102,25241,26895
85123,8310,36.2,43996,21970,4045,4265
85128,15744,35.6,42035,16735,7807,7937
85131,18430,32.3,28893,9188,12434,5996
85132,34981,37.9,48135,13755,24439,10542
85135,646,36.8,39792,14448,315,331
85137,2644,49.2,47569,22791,1383,1261
85138,33637,32.4,66333,25532,17242,16395
85139,17768,34,52870,21505,8613,9155
85140,37063,27.9,54616,19038,18005,19058
85141,371,45.7,29063,10449,233,138
85142,51190,30.5,73367,26686,25293,25897
85143,36917,29.6,57969,20792,18656,18261
85145,1658,26.8,57109,20379,841,817
85147,4824,25.9,27163,10119,2555,2269
85172,774,29.8,32963,15470,550,224
85173,2867,42.5,38203,19825,1419,1448
85192,1269,55.9,31645,20491,621,648
85193,3972,38.7,47888,17541,1985,1987
85194,6448,49.9,46250,24778,3194,3254
85201,47737,31.8,34589,19082,24299,23438
85202,36672,31.7,42649,22844,18133,18539
85203,33514,32.7,46588,22169,16392,17122
85204,60819,31.4,42768,18603,30199,30620
85205,43251,49,44469,26033,20576,22675
85206,32602,48.5,45680,26814,15054,17548
85207,46201,40.6,62059,31693,22342,23859
85208,36389,45.1,46168,21926,17587,18802
85209,40423,43.8,55136,26490,19371,21052
85210,37143,29.2,36586,17209,18996,18147
85212,24433,29.3,77704,24972,12562,11871
85213,33659,41.5,57786,29661,16749,16910
85215,15433,54.1,57845,33656,7242,8191
85224,45361,33.7,62263,29336,22782,22579
85225,71828,29.9,56414,24513,35259,36569
85226,37394,35,74005,37134,18524,18870
85233,39027,34.7,75365,32900,19040,19987
85234,51459,32.5,76632,30792,24890,26569
85248,30773,56.9,68291,41029,14578,16195
85249,39081,37.3,96558,36075,18543,20538
85250,16653,48.6,59358,39968,7494,9159
85251,35541,37.8,49111,38440,17213,18328
85253,17003,51,109185,85760,8252,8751
85254,45554,43,90718,44650,21849,23705
85255,38309,45.8,111042,65074,18771,19538
85256,5241,27.2,31411,14077,2520,2721
85257,28114,40.3,47194,28348,13811,14303
85258,22744,54,72089,56492,10442,12302
85259,22499,45.4,95515,59675,11132,11367
85260,36226,42.5,76522,50303,17392,18834
85262,11034,54.4,125884,80227,5753,5281
85263,2090,67.9,101375,71268,1080,1010
85264,1190,29,56842,31201,575,615
85266,10717,58.5,100338,56246,5151,5566
85268,22927,53.2,73608,44893,11155,11772
85281,55548,23.6,30582,17035,30006,25542
85282,51080,30.5,50455,25906,26186,24894
85283,46373,31.3,53022,26439,22610,23763
85284,17517,45.2,117052,50819,8608,8909
85286,36774,34.3,84616,35408,18349,18425
85295,37949,31.5,87508,33201,18763,19186
85296,40694,32.1,81710,30992,20481,20213
85297,27180,28.8,84097,30525,13439,13741
85298,22106,36.5,86426,33306,10700,11406
85301,61387,28.3,27267,12570,30901,30486
85302,37149,35,43477,20835,17490,19659
85303,31599,27.8,48256,16688,16209,15390
85304,27426,37.7,61078,25458,13833,13593
85305,11542,31.5,64926,26422,6064,5478
85306,24351,37.7,56321,25818,12243,12108
85307,8560,29.2,44169,19134,4195,4365
85308,64515,39.5,68796,31703,31855,32660
85309,799,21.6,-666666666,17899,700,99
85310,19074,39,86660,35030,9689,9385
85320,916,35.6,31250,11540,509,407
85321,4727,45.2,28053,17453,2336,2391
85322,731,38.2,35500,20646,377,354
85323,39263,28.1,44658,16118,19694,19569
85324,1948,60.6,36442,22485,1042,906
85325,797,65.4,28925,20598,395,402
85326,52101,30.6,54867,17765,27815,24286
85328,291,54.1,56154,26722,193,98
85331,27327,45.1,88938,43052,13067,14260
85332,1428,63.2,36810,17875,656,772
85333,437,48.1,29688,17609,229,208
85334,871,49.4,29063,23202,461,410
85335,31814,28.4,47237,16784,15600,16214
85336,560,26.7,29083,10814,285,275
85337,2662,32,30242,15450,1338,1324
85338,44319,32,67132,25348,22008,22311
85339,37621,29.5,64054,22338,18706,18915
85340,28696,35.5,76437,30332,13909,14787
85341,29,-666666666,-666666666,,15,14
85342,1534,51.5,42375,21923,754,780
85343,93,49.5,68839,26743,42,51
85344,9791,46.1,35495,22503,4829,4962
85345,58170,34.4,45886,20295,28638,29532
85346,4353,69.9,39364,25139,2031,2322
85347,851,33.9,35977,21360,360,491
85348,3089,58.7,36434,18339,1766,1323
85349,27086,26.8,31601,10416,13143,13943
85350,22592,28,30720,10255,12629,9963
85351,28501,72.8,34613,26992,11927,16574
85352,234,48.5,21397,9991,93,141
85353,32308,26.7,50066,16046,15440,16868
85354,5649,35.4,52442,21855,2955,2694
85355,9566,34.4,75625,25851,4830,4736
85356,4698,50.8,42261,20921,2422,2276
85357,683,41.3,30089,14690,347,336
85360,221,50.3,39063,26337,135,86
85361,5091,40.4,47738,18741,2310,2781
85362,649,64.3,30161,25003,300,349
85363,6312,36.3,33884,17803,2887,3425
85364,73129,31,39102,18022,36319,36810
85365,47933,33.2,51947,24635,24687,23246
85367,21537,63,50538,28125,10775,10762
85371,533,35.3,23317,22913,281,252
85373,17979,66.3,49612,28869,8035,9944
85374,47274,49.4,49093,24725,21846,25428
85375,28255,73.5,47408,34697,12553,15702
85377,3029,61.7,70625,61961,1518,1511
85379,41096,30.2,70302,23608,20238,20858
85381,25611,41.9,64862,29979,12077,13534
85382,40656,41.4,64428,31452,18901,21755
85383,38400,36.7,101526,37735,19717,18683
85387,10080,59.3,58416,29743,5037,5043
85388,22367,31.3,67461,23111,11161,11206
85390,9213,53.5,41622,29297,4564,4649
85392,36187,31.9,64383,25683,17548,18639
85395,24587,42.4,75271,32884,10929,13658
85396,12736,38.3,70700,29782,6552,6184
85501,13344,44.5,38776,20504,6515,6829
85530,1688,29.3,23214,8645,756,932
85531,389,31,53523,30239,179,210
85533,2792,37.5,44250,20037,1487,1305
85534,2635,38.2,29699,16623,1352,1283
85535,7,-666666666,-666666666,,3,4
85536,501,38.2,32500,10507,245,256
85539,5500,39,45433,19734,2756,2744
85540,3215,28.2,60402,23667,1702,1513
85541,21559,52.8,41222,23543,10536,11023
85542,3740,23.3,30673,8747,1834,1906
85543,3951,29.7,41250,17243,1973,1978
85544,1989,61,47667,29211,1037,952
85545,658,62.9,39063,34809,344,314
85546,19437,35.4,45662,18167,10565,8872
85550,5297,26.7,27774,9677,2751,2546
85551,437,26.2,52431,15966,225,212
85552,6200,27,55714,21370,3233,2967
85553,1441,64.6,36442,28245,797,644
85554,289,61.6,47845,26715,168,121
85601,618,63.8,32607,23507,323,295
85602,9291,52.6,39984,21665,4796,4495
85603,6959,47.8,33658,25042,3425,3534
85605,469,58.8,40357,18142,240,229
85606,1426,53.4,27406,17731,773,653
85607,17866,31,28125,13518,9101,8765
85608,4717,34.2,-666666666,13005,4681,36
85609,319,58.6,58750,25327,147,172
85610,1072,52,44327,20954,670,402
85611,963,53.1,50441,23419,476,487
85613,5789,21.7,52250,17365,3669,2120
85614,21998,68.4,47329,32052,10234,11764
85615,9152,48.7,53875,30529,4154,4998
85616,5584,47.8,42734,21905,2831,2753
85617,1369,49.6,36111,19978,605,764
85618,1642,41.5,39696,17912,811,831
85619,60,32.9,-666666666,41842,46,14
85620,1067,19.4,37917,8914,490,577
85621,22928,34.2,26525,14072,11009,11919
85622,6752,70.5,57763,40227,2993,3759
85623,4961,50.6,55683,28615,2534,2427
85624,1269,59.1,38950,31589,601,668
85625,1800,64.1,34707,22261,906,894
85626,1036,34.1,15357,7708,618,418
85627,967,41.7,41094,18787,477,490
85629,23839,33,63343,25160,11744,12095
85630,2874,32.6,41822,18444,1532,1342
85631,3897,33.1,41063,18626,1959,1938
85632,857,60.1,37250,26579,456,401
85633,39,55.3,24500,25177,13,26
85634,5982,29.4,27854,10733,2836,3146
85635,34563,36.4,53510,26582,15776,18787
85637,1237,57.8,68667,37404,622,615
85638,2094,52.5,26897,18658,1055,1039
85640,487,62.1,23500,20210,226,261
85641,22293,36.8,81917,32574,11123,11170
85643,9233,40.9,43465,22365,4977,4256
85645,1922,41.3,51170,22291,936,986
85646,1444,61.3,56836,36517,714,730
85648,19205,31.1,47677,18137,9137,10068
85650,14525,47.9,79790,37359,7140,7385
85653,13876,38.9,55102,22051,7198,6678
85654,407,24.7,9449,5814,178,229
85658,8771,52,79873,43484,4451,4320
85701,4889,38.7,34017,24725,2373,2516
85704,30665,48.8,52918,33078,14352,16313
85705,54433,33.8,23769,15332,27795,26638
85706,56989,27.5,29814,12164,27885,29104
85707,545,21.4,45958,19200,453,92
85708,3916,21.4,46098,13338,1975,1941
85710,55323,42.3,42204,23515,26263,29060
85711,40291,35.9,32557,19999,19729,20562
85712,33830,36.9,31290,22504,15520,18310
85713,49712,33.7,33459,15139,25238,24474
85714,13725,34.4,24874,12298,6699,7026
85715,19034,46.7,53943,32080,8988,10046
85716,33098,35.2,33058,25399,16625,16473
85718,26932,51.8,73900,56854,12707,14225
85719,44220,22.9,27009,17625,21781,22439
85723,0,-666666666,-666666666,-666666666,0,0
85724,0,-666666666,-666666666,-666666666,0,0
85726,0,-666666666,-666666666,-666666666,0,0
85730,39142,37.1,46733,23423,19558,19584
85735,11395,40.3,52712,21870,5400,5995
85736,4752,36.8,42361,16486,2354,2398
85737,21395,47.4,82754,40088,10287,11108
85739,17715,61.4,58376,32120,8562,9153
85741,35191,34.7,51871,23064,17575,17616
85742,25414,38.3,66887,29772,12324,13090
85743,28858,41.2,69577,32411,14615,14243
85745,37654,36.8,49380,27133,17915,19739
85746,42704,31.8,41427,16176,20625,22079
85747,23490,34.5,81474,31039,11989,11501
85748,18275,45.4,69871,34353,8715,9560
85749,19107,50.4,84151,43241,9435,9672
85750,23741,52.1,74060,52071,11418,12323
85755,15716,55,75648,42289,7222,8494
85756,35522,31.8,46672,16574,20257,15265
85757,18341,29.5,51220,16733,9284,9057
85901,16896,45.3,38865,20521,7983,8913
85911,1546,28.9,9754,6262,884,662
85912,83,63.1,-666666666,15543,44,39
85920,325,68.4,31607,32056,174,151
85922,37,60.9,73750,60262,23,14
85923,793,15.5,11799,7594,321,472
85924,2561,52.6,35653,17897,1384,1177
85925,4892,31.3,54122,19655,2268,2624
85926,163,38.4,29653,23450,106,57
85927,66,76.2,36705,24489,26,40
85928,1129,51.1,28576,12879,572,557
85929,8698,43.9,44989,26607,4351,4347
85930,948,22.3,37500,11054,498,450
85931,151,63.8,40250,34570,70,81
85932,325,60.2,25085,17448,194,131
85933,2866,45.9,32407,16687,1263,1603
85934,684,21.1,55083,22333,466,218
85935,5264,51.2,60475,32061,2844,2420
85936,4389,44.9,34707,18783,2402,1987
85937,7492,35.9,52763,18369,3763,3729
85938,2510,37.1,43864,19373,1210,1300
85939,4481,35.3,55436,20732,2160,2321
85940,1274,48.2,44145,20616,646,628
85941,11183,24.3,27679,9354,5625,5558
85942,43,-666666666,-666666666,,0,43
86001,41378,28.9,46991,26398,21350,20028
86003,0,-666666666,-666666666,-666666666,0,0
86004,38750,33.6,58662,28371,19238,19512
86011,6512,19.4,10938,4898,2683,3829
86015,164,59.5,-666666666,27151,60,104
86016,55,52.4,23438,7844,30,25
86017,689,67.9,26719,19581,336,353
86018,663,50.6,40536,23321,324,339
86020,1917,32.4,21944,10248,862,1055
86021,6019,15.4,29944,6900,2746,3273
86022,2334,26.2,44519,14463,1109,1225
86023,1608,42.9,26771,21205,896,712
86024,497,65.2,55000,28977,225,272
86025,5646,35.8,51793,20426,2696,2950
86028,0,-666666666,-666666666,-666666666,0,0
86029,191,54.6,14076,22672,105,86
86030,1695,27.5,35625,12261,808,887
86031,1856,31.2,16667,7519,874,982
86032,1316,29,47750,16644,621,695
86033,7243,29.3,20919,8341,3597,3646
86034,1943,33,24783,9557,1035,908
86035,1737,36.6,27888,11097,807,930
86036,358,49.5,19444,17966,161,197
86038,23,-666666666,-666666666,,23,0
86039,1306,36.8,22237,10428,601,705
86040,10256,33.8,60377,23523,5505,4751
86042,2087,35.6,29500,15931,937,1150
86043,1787,25.2,23542,9109,825,962
86044,3793,27.9,24625,10864,1796,1997
86045,12308,28.1,48809,14643,5918,6390
86046,5963,42.4,47694,23250,2872,3091
86047,15278,32.2,33797,14863,8526,6752
86052,22,54.5,30938,38891,14,8
86053,2530,23.4,28239,10542,1253,1277
86054,1613,36.3,25481,11822,815,798
86301,21896,51.3,44764,27003,11209,10687
86303,16296,56.8,44262,31597,7994,8302
86305,18450,56,55120,31969,9025,9425
86313,87,60.7,-666666666,7329,87,0
86314,35577,34.2,39857,18976,17648,17929
86315,6643,50.7,56148,25548,2816,3827
86320,2073,43.7,25417,11534,1042,1031
86321,2293,29.6,61667,25968,1335,958
86322,11283,47.9,39803,20378,5497,5786
86323,15933,51.7,42922,22097,7796,8137
86324,4063,57.4,41355,24466,1812,2251
86325,4708,55.7,47932,28054,2240,2468
86326,24736,44.3,39953,21521,11923,12813
86327,9119,56.1,47116,26472,4490,4629
86329,870,36.4,45053,16128,477,393
86331,551,57.6,23793,29377,291,260
86332,1798,58.6,36467,21466,869,929
86333,5392,51.1,29851,18942,2672,2720
86334,4511,44.1,41402,17064,2261,2250
86335,5196,48.8,41339,21508,2448,2748
86336,10990,57.5,46775,43066,5139,5851
86337,870,56.1,37621,24400,446,424
86338,491,55.9,38264,22533,267,224
86343,89,58.1,38125,32121,48,41
86351,6825,61.3,60118,36804,3197,3628
86401,26231,43.9,45971,22196,13425,12806
86403,15666,45.6,39751,21743,7513,8153
86404,15893,55.6,41511,25294,7732,8161
86406,24584,52,43753,25293,11704,12880
86409,26031,46.7,32952,19756,13060,12971
86411,164,55.5,37813,26359,71,93
86413,14319,47,34680,12441,9400,4919
86426,13902,47.5,42562,23127,6327,7575
86429,7239,55.7,39357,27525,3712,3527
86431,257,64.4,14976,17253,173,84
86432,3041,46.7,36568,15319,1429,1612
86433,164,57.1,4811,10458,104,60
86434,1163,25.7,36136,17479,521,642
86435,181,36.7,36875,18250,103,78
86436,1729,54.4,33071,16719,590,1139
86437,62,56.5,30833,18461,35,27
86438,725,66.2,29016,19505,329,396
86440,7062,47.1,43021,21286,3287,3775
86441,2199,61.2,25563,17378,1250,949
86442,33223,48.4,36661,19774,16861,16362
86443,0,-666666666,-666666666,-666666666,0,0
86444,603,64.1,25032,16758,354,249
86445,311,62.3,32417,19395,154,157
86502,1535,36.8,16029,7971,863,672
86503,11227,28.1,30019,11173,5682,5545
86504,6396,29.1,34349,12114,3146,3250
86505,7831,33,23481,10642,3896,3935
86506,1440,40.9,21190,10191,676,764
86507,2464,24.1,22009,8346,1167,1297
86508,996,34.4,22768,10655,513,483
86510,5112,28.7,21132,8957,2491,2621
86511,2916,39.8,29909,12367,1561,1355
86512,2771,25.7,25000,10210,1276,1495
86514,2568,38,20089,10766,1265,1303
86515,4928,35.2,35897,14684,2211,2717
86520,1938,36,14583,7803,905,1033
86535,1149,26.9,22361,7588,620,529
86538,2552,22.5,34000,9505,1279,1273
86540,883,32.8,18125,9795,416,467
86544,1345,35.7,28250,11555,718,627
86545,1690,28.6,26581,9388,793,897
86547,1367,19.4,23889,7127,599,768
86556,1811,22.6,27969,9617,918,893
87001,4271,29.1,45441,12999,2114,2157
87002,22637,40,37373,19272,11193,11444
87004,10351,35,41159,20927,5196,5155
87005,404,53,24673,17067,233,171
87006,881,51.2,37500,18720,586,295
87007,841,39.1,23977,9398,499,342
87008,2958,50.6,82143,41196,1459,1499
87010,1092,50.5,47222,49228,669,423
87011,20,63.4,-666666666,30120,9,11
87012,234,50.4,31923,20889,119,115
87013,4533,32.8,28717,13386,2437,2096
87014,412,54.1,51165,23181,138,274
87015,13014,47,64240,30507,6679,6335
87016,4165,39.1,31846,17681,2409,1756
87017,358,47.8,20938,17720,187,171
87018,417,29,17750,8408,220,197
87020,11528,38,39868,18301,5640,5888
87021,3319,36.6,31850,13610,1988,1331
87022,828,32.1,38750,18013,438,390
87023,413,56.2,29213,20496,187,226
87024,2063,37.4,46821,16713,968,1095
87025,1168,52,69554,40786,634,534
87026,4104,33.3,29438,11473,1848,2256
87027,323,72.1,36333,19443,153,170
87028,286,36.6,33226,11387,170,116
87029,218,54.4,29265,28152,119,99
87031,44104,35.4,43330,18790,22761,21343
87032,0,-666666666,-666666666,-666666666,0,0
87034,2374,34.5,34674,11888,1046,1328
87035,7279,40.1,30602,17898,3483,3796
87036,1947,48.2,24250,17545,931,1016
87037,661,39.3,26667,14256,300,361
87038,495,46.5,31667,16203,233,262
87040,424,38.2,33611,19206,244,180
87041,768,45.7,26087,19563,375,393
87042,3657,41.6,48684,23011,1820,1837
87043,5502,55.4,83209,45757,2580,2922
87044,585,32,52825,19357,310,275
87045,1376,32.8,17188,10528,830,546
87046,38,55.8,70417,40550,16,22
87047,4635,54,75452,37826,2367,2268
87048,9052,52.6,80739,39318,4377,4675
87049,998,28.3,21964,12389,465,533
87051,959,47,85459,28310,626,333
87052,3189,26.5,40710,9266,1559,1630
87053,1082,33.7,38611,15993,538,544
87056,1253,47.1,78580,23910,683,570
87059,9598,47.3,82794,36473,4865,4733
87061,282,55.1,66755,29778,147,135
87062,1968,26.8,38050,14574,907,1061
87063,247,43.4,33864,21760,122,125
87064,111,52.7,20815,16888,39,72
87068,4789,45.2,58199,26475,2226,2563
87070,60,64.6,47583,26278,28,32
87072,490,35.9,33750,14070,249,241
87083,525,56.7,55875,30702,239,286
87102,19692,34.4,29571,18536,10080,9612
87104,12126,40.1,43379,30045,5677,6449
87105,57937,36.2,36883,17165,28874,29063
87106,25727,29.1,33240,25031,13098,12629
87107,31560,41.2,43572,28601,15521,16039
87108,37221,36.1,27207,20726,18187,19034
87109,39810,38.9,44243,28576,18973,20837
87110,38170,42.7,49664,28622,18355,19815
87111,57554,44.8,62844,39183,27224,30330
87112,43510,41.7,45967,27204,20739,22771
87113,15814,35,63281,30807,7313,8501
87114,64917,34.1,65277,28401,32210,32707
87116,4269,23.6,52587,20857,2547,1722
87117,292,21.9,-666666666,17883,234,58
87120,60487,33.9,62544,29360,29694,30793
87121,75581,28.2,42100,15720,37201,38380
87122,17777,47.7,114546,52866,8963,8814
87123,43690,36.2,44159,25480,21445,22245
87124,52049,38.1,55544,26770,24877,27172
87144,38441,34.6,65081,27773,19276,19165
87301,23830,31.1,46284,17789,11624,12206
87305,3230,33,23975,10207,1530,1700
87310,780,32.2,29531,12766,354,426
87311,3304,30.1,22022,9508,1556,1748
87312,366,42.3,16726,11290,162,204
87313,5800,27,27155,10226,2758,3042
87315,24,-666666666,-666666666,,14,10
87316,1411,32.6,26167,11769,796,615
87317,901,33.7,22273,7447,425,476
87319,2580,26.9,17944,9492,1118,1462
87320,753,30.2,31726,11916,322,431
87321,1729,41.9,29792,15942,922,807
87322,210,35.4,35313,9143,68,142
87323,4541,32.8,25956,10904,2288,2253
87325,3201,36.4,31875,13886,1462,1739
87326,1995,27.9,31296,10061,980,1015
87327,10935,32.2,29559,9778,5595,5340
87328,3461,22.6,27993,9459,1565,1896
87347,257,41.1,48553,24406,116,141
87357,779,32.4,24609,15563,373,406
87364,1089,39.4,21023,11795,548,541
87375,2870,25.7,16976,8751,1433,1437
87401,45784,31.2,47721,21628,22339,23445
87402,11090,35.5,75608,32173,5558,5532
87410,16968,37.4,54649,24613,8235,8733
87412,834,45.7,45078,20795,550,284
87413,16062,33.5,47366,21627,8295,7767
87415,1765,48,78307,31412,805,960
87416,5517,33.4,41989,18134,2893,2624
87417,5751,27,49055,18528,2774,2977
87418,1780,33.5,56728,19727,849,931
87419,241,37.7,27083,23706,144,97
87420,13006,29.9,31809,13493,6575,6431
87421,1716,33.1,50833,15272,824,892
87455,1725,39.9,22031,12142,872,853
87461,1400,35.3,21134,10549,726,674
87499,430,28.5,14868,8618,217,213
87501,15490,52.9,57172,46889,7070,8420
87505,30189,48.5,51401,36126,14578,15611
87506,13454,48.5,68982,44273,6632,6822
87507,46430,33.8,44081,22762,22645,23785
87508,19086,48.4,68405,35502,9301,9785
87510,690,60.5,78583,29389,347,343
87511,2512,35,49000,16959,1258,1254
87512,203,56.8,14934,14865,107,96
87513,993,43.9,53500,21990,343,650
87514,1352,54.3,34773,23462,635,717
87515,198,60.4,37778,17876,112,86
87516,176,52.3,44167,24355,82,94
87517,89,60.7,24861,28013,63,26
87518,116,31.3,41974,22218,57,59
87519,722,27.4,26085,14958,349,373
87520,1531,46,47692,20735,808,723
87521,757,55.8,25500,18533,387,370
87522,3044,38.4,32950,15434,1447,1597
87523,218,66.5,20919,11395,81,137
87524,94,36,15473,11498,45,49
87525,76,33.2,102500,28461,51,25
87527,618,52.9,12177,19718,284,334
87528,3405,29,39725,16182,1517,1888
87529,5560,54,39426,21321,2277,3283
87530,608,52.2,38889,19201,378,230
87531,415,63.2,19881,18825,227,188
87532,18222,38.4,40274,21247,9162,9060
87533,137,32.3,21875,14923,38,99
87535,971,50.9,25917,19072,391,580
87537,3677,29.8,35891,17233,1869,1808
87538,312,57.7,24128,30818,128,184
87539,309,51.3,33382,20466,156,153
87540,823,54.8,46400,39281,369,454
87543,535,51.3,22458,16684,237,298
87544,17979,43.7,106686,51044,9120,8859
87548,1067,45.1,73194,24033,534,533
87549,1114,29,45327,20233,465,649
87551,324,54.6,56500,30605,191,133
87552,3340,32.7,26840,20018,1731,1609
87553,1058,44.6,31667,18302,587,471
87554,23,-666666666,-666666666,,23,0
87556,2273,49.5,28795,20508,1147,1126
87557,6640,40.3,35940,19897,3445,3195
87558,434,50,44853,33115,240,194
87560,1489,44.2,24357,12708,593,896
87562,435,61.1,27167,21143,212,223
87564,382,54.1,41944,22052,200,182
87565,321,30.5,32578,12897,177,144
87566,3058,37.9,40590,15401,1545,1513
87567,1687,35.3,29400,15184,822,865
87569,443,52.6,24609,23069,156,287
87571,10247,46.3,31166,22678,5034,5213
87573,0,-666666666,-666666666,-666666666,0,0
87574,142,51,20972,11591,89,53
87575,813,41.1,55417,18063,432,381
87577,28,59.5,-666666666,22443,19,9
87578,1072,55,58348,29423,543,529
87579,947,41.4,40375,17228,511,436
87580,557,37.2,32201,31965,357,200
87581,91,31.3,8500,6182,85,6
87582,1595,31.4,49333,27305,637,958
87583,115,60.4,4955,5947,72,43
87701,20359,40.4,29534,17617,10019,10340
87710,2050,50,49260,26601,1016,1034
87711,484,43.6,27596,20949,330,154
87712,134,56.2,-666666666,28730,74,60
87713,161,77.3,11304,16174,53,108
87714,906,47.9,37895,20806,456,450
87715,811,48.8,18281,15794,420,391
87718,615,49.9,48929,26024,345,270
87722,200,65.9,11921,28187,131,69
87723,135,75.4,45352,24159,47,88
87724,0,-666666666,-666666666,-666666666,0,0
87728,277,41.8,21563,20356,142,135
87729,138,63.1,41125,19112,73,65
87730,13,22.8,33750,18238,7,6
87731,441,45.5,26279,14247,346,95
87732,1273,42.5,24256,31880,679,594
87733,219,51.3,35417,16271,111,108
87734,190,60.4,42813,19060,105,85
87735,46,-666666666,-666666666,,28,18
87736,544,25.8,28654,13331,178,366
87740,7663,43.7,34280,20786,3822,3841
87742,769,51,50625,19269,268,501
87743,365,56.5,29750,31368,168,197
87745,917,52.1,34414,17188,503,414
87746,12,58.7,29583,29067,7,5
87747,1708,46.2,34125,17118,934,774
87749,102,63.5,7381,12026,60,42
87750,24,-666666666,-666666666,,24,0
87752,799,47.3,35972,16764,418,381
87753,164,66.3,21691,8935,134,30
87801,9880,35.9,32998,18002,5284,4596
87820,73,69.3,20815,20612,44,29
87821,836,55.1,45694,20173,439,397
87823,776,42.1,91333,44412,330,446
87824,234,66.6,42115,34337,146,88
87825,1982,37.9,32854,14673,1155,827
87827,172,60.6,23875,14348,88,84
87828,653,19.4,31705,9894,292,361
87829,689,58.3,43382,20776,355,334
87830,1567,48.2,38587,17572,935,632
87831,408,54.3,26893,20621,184,224
87832,1057,32.7,49107,18960,426,631
87901,6870,54.1,24874,15918,3350,3520
87930,1231,38.8,31576,14515,526,705
87931,745,65.3,53229,27753,300,445
87933,0,-666666666,-666666666,-666666666,0,0
87935,1687,64.5,31156,19254,808,879
87936,457,47.9,26394,20831,303,154
87937,2833,30.5,24533,11253,1395,1438
87939,218,55.6,-666666666,32557,203,15
87940,205,61,33295,26159,113,92
87941,930,21.7,17000,11842,487,443
87942,709,53.8,31848,17510,428,281
87943,184,70.3,39350,21457,90,94
88001,35863,28.1,26356,14791,18049,17814
88002,1567,22.3,45625,19406,866,701
88003,1090,19.5,-666666666,3847,572,518
88004,277,35.6,-666666666,278,277,0
88005,29448,35.7,42744,23613,14497,14951
88007,26957,38.1,48582,22617,12958,13999
88008,6085,30.3,47937,20563,3072,3013
88009,196,22.2,24904,11247,72,124
88011,27235,38.5,60696,34299,12846,14389
88012,26150,31.3,44691,19722,13201,12949
88020,580,55.1,40284,26709,267,313
88021,18013,29.3,28797,12810,8375,9638
88022,1041,54.4,35972,23781,461,580
88023,2729,41.4,30118,17541,1308,1421
88024,211,27.1,26397,10096,137,74
88025,492,28.3,48036,15180,212,280
88026,1329,48,25354,13305,654,675
88027,426,45.6,38194,15827,216,210
88028,640,43.8,61706,26821,329,311
88029,1538,49.3,19531,12607,672,866
88030,23463,38.2,30297,16344,11724,11739
88032,283,22.1,55000,16500,159,124
88033,16,-666666666,-666666666,,16,0
88034,125,60.2,12256,13275,58,67
88038,454,52.3,45625,23371,224,230
88039,132,60.7,51146,39805,55,77
88040,92,53.8,82188,66751,57,35
88041,1266,50.7,36286,22687,671,595
88042,233,37.9,67031,29093,115,118
88043,1637,48.4,32411,17049,898,739
88044,4444,32.5,35734,17255,2326,2118
88045,3896,37.7,33825,17395,1977,1919
88046,760,40.8,35380,18654,361,399
88047,1758,28.6,24688,14367,830,928
88048,4028,22.9,24043,9516,1845,2183
88049,458,61.6,59938,29243,255,203
88051,51,47.7,-666666666,18927,36,15
88052,71,63.6,58182,28708,36,35
88053,69,65.2,43125,22339,44,25
88055,13,-666666666,-666666666,,13,0
88056,126,48,18929,13614,83,43
88061,18426,44.6,40686,24483,9144,9282
88063,13000,27.4,24728,9074,6081,6919
88065,685,36.3,50167,21988,282,403
88072,2714,28,19784,9119,1416,1298
88081,14455,29.2,26326,11059,7462,6993
88101,46046,30.7,39983,21292,23560,22486
88103,282,20.7,-666666666,15922,174,108
88112,214,39,34167,18010,104,110
88113,103,49.9,53971,23181,42,61
88114,20,50.3,18542,12340,11,9
88115,14,63.2,60313,44871,10,4
88116,372,54.9,37188,23310,167,205
88118,236,49.7,24125,20197,109,127
88119,1869,43.9,33250,24797,900,969
88120,206,46.4,35625,19822,99,107
88121,125,54.5,32031,26554,68,57
88124,1075,36.2,33889,22662,484,591
88125,61,23.6,61250,25933,28,33
88126,38,35.8,60000,24450,19,19
88130,18901,28.5,38668,17188,9653,9248
88132,178,52.5,44167,21598,86,92
88134,48,68,48750,22177,22,26
88135,1637,34.7,41172,20651,828,809
88136,58,59.1,61500,29741,39,19
88201,25462,40.3,47730,25015,12264,13198
88203,31351,31.2,34151,15831,15353,15998
88210,16865,33.2,51294,34155,8209,8656
88220,34840,37.9,48720,25473,17739,17101
88230,5425,32,40788,16385,2789,2636
88231,3210,37.2,56000,28930,1699,1511
88232,2556,34.8,40083,16328,1507,1049
88240,36906,31.7,47343,21280,18966,17940
88242,7144,33.4,83680,31087,3682,3462
88250,97,55.5,61750,26323,54,43
88252,2179,41.2,47702,23681,1102,1077
88253,908,38.2,52153,47503,533,375
88254,90,58.5,-666666666,36071,48,42
88255,68,56.7,-666666666,50762,42,26
88256,2087,39.9,40729,19559,1029,1058
88260,14770,29.3,46414,19503,7512,7258
88262,7,-666666666,-666666666,,3,4
88263,72,79.1,35313,21118,47,25
88264,0,-666666666,-666666666,-666666666,0,0
88265,283,31.3,87321,35687,188,95
88267,1162,39.8,44125,22588,591,571
88268,0,-666666666,-666666666,-666666666,0,0
88301,1280,52.1,28897,22549,742,538
88310,36328,39.4,42786,22821,18238,18090
88311,1717,38.6,37953,19082,920,797
88312,3072,56,44546,34275,1492,1580
88314,184,68.1,28173,20277,88,96
88316,2015,56,41771,27960,1019,996
88317,1337,55.5,29167,27426,631,706
88318,352,55.1,77083,36120,206,146
88321,117,57.4,27054,31962,52,65
88323,12,-666666666,-666666666,,6,6
88324,123,46.6,8155,21110,89,34
88325,871,55.6,27222,20354,492,379
88330,3599,22.3,45395,16365,1972,1627
88336,235,54,19886,11415,149,86
88337,2487,48.1,46996,23700,1211,1276
88338,208,49.1,53450,28901,88,120
88339,827,49,56756,36291,477,350
88340,3885,23.6,30230,10327,1888,1997
88341,299,64.4,46023,22522,124,175
88342,6,-666666666,-666666666,,6,0
88343,25,54.4,21563,16584,9,16
88344,170,64.2,9013,7331,85,85
88345,9001,46.7,47769,26663,4319,4682
88346,3226,36,36003,15691,1596,1630
88347,159,62.8,40607,16830,83,76
88348,296,48.4,18929,11617,190,106
88349,0,-666666666,-666666666,-666666666,0,0
88350,283,61.2,21964,17185,160,123
88351,237,39.6,36625,14732,98,139
88352,4771,42.8,36483,19495,2422,2349
88353,534,26.9,30179,12829,268,266
88354,122,57.6,75625,22969,61,61
88355,0,-666666666,-666666666,-666666666,0,0
88401,6816,42.1,28985,17277,3422,3394
88410,86,26.5,60529,29153,64,22
88411,57,57.1,52917,19075,17,40
88414,89,39.8,17222,7471,44,45
88415,3528,38.3,38889,18019,2058,1470
88416,68,40.1,-666666666,28185,34,34
88417,61,70,-666666666,15069,19,42
88418,330,38.5,31875,18214,153,177
88419,179,61.4,40300,24280,76,103
88421,0,-666666666,-666666666,-666666666,0,0
88422,103,58.8,61298,32060,21,82
88424,80,21.6,58333,15423,57,23
88426,1236,54,33125,18836,613,623
88427,109,53.7,56250,28747,60,49
88430,122,69.3,41389,22349,48,74
88431,0,-666666666,-666666666,-666666666,0,0
88434,418,47.8,41500,20915,149,269
88435,3629,41.5,29091,13514,2148,1481
88436,101,50.4,34740,18942,53,48
89001,878,48.6,50446,23607,413,465
89002,34191,36,76504,28620,17025,17166
89003,900,57.7,30056,18779,564,336
89004,385,43.5,148068,72553,167,218
89005,15116,50.1,58283,33025,7939,7177
89007,1694,30.2,67083,14072,918,776
89008,1390,34.2,23321,15121,692,698
89010,319,42.5,32679,18697,168,151
89011,17599,39,55856,31800,8573,9026
89012,28082,43.9,69037,38327,14025,14057
89013,409,49.9,43409,21845,231,178
89014,37768,35,52417,27285,17905,19863
89015,38048,38.7,50147,23866,18566,19482
89017,121,43.5,138661,57417,57,64
89018,5327,35.5,44015,7429,4789,538
89019,1892,50.1,38269,28209,1090,802
89020,1240,28.4,28185,14317,744,496
89021,3429,33,70317,22841,1864,1565
89022,127,65.7,44250,30781,68,59
89025,1332,32.6,36908,20086,689,643
89026,383,37.3,-666666666,4800,287,96
89027,15691,51.3,44579,23869,7934,7757
89029,7990,53.6,36536,23994,3913,4077
89030,48407,28.2,29964,11685,25242,23165
89031,62455,32.7,62811,23741,30551,31904
89032,43918,30.2,51734,19499,21830,22088
89039,144,71.1,21000,20553,46,98
89040,3521,40.2,40147,20591,1646,1875
89042,1581,31.3,42378,29801,852,729
89043,1326,35.8,43676,19126,841,485
89044,16249,54.7,72573,37976,7597,8652
89045,1831,33.3,92813,31427,889,942
89046,515,55.7,35515,18598,307,208
89047,111,63.6,21188,36477,29,82
89048,20380,53.3,37996,20958,10066,10314
89049,3392,44.2,40896,20678,1789,1603
89052,50246,41.9,75555,42001,24056,26190
89054,179,39.1,52536,18051,110,69
89060,10281,49.9,38217,21329,5091,5190
89061,4669,49.3,51513,26466,2464,2205
89074,47870,41.6,68383,35555,23451,24419
89081,32798,28.6,57416,21730,16620,16178
89084,20612,37.2,73551,34247,10465,10147
89085,4191,27.9,81319,25122,1857,2334
89086,4551,27.7,51736,23536,2352,2199
89101,44213,33.4,22401,12263,25263,18950
89102,37661,33.7,32562,19215,19691,17970
89103,49537,37.1,37223,22438,25906,23631
89104,38711,37.6,34184,17555,20029,18682
89106,27104,30.9,28506,14238,13162,13942
89107,36204,35.3,44271,20022,18413,17791
89108,68972,34.2,41659,19649,34864,34108
89109,6852,47.7,40074,51138,3606,3246
89110,71150,30.8,44737,17223,36038,35112
89113,24623,37,65966,39668,12503,12120
89115,58870,26.8,33496,13616,30214,28656
89117,54646,40.7,54556,33055,26259,28387
89118,20644,36.4,51250,28539,10407,10237
89119,44425,34.5,34434,19621,24165,20260
89120,23195,40.5,49335,27910,11363,11832
89121,61911,40.5,40836,21639,31451,30460
89122,46236,36.2,45260,20645,23149,23087
89123,58991,37,59629,28796,28974,30017
89124,821,50.5,71705,31712,374,447
89128,38561,37,52703,27374,18344,20217
89129,52145,37,65246,30282,25285,26860
89130,31215,41.7,64866,28373,15460,15755
89131,45220,35.6,80013,30964,22562,22658
89134,25455,61.9,61561,45912,11967,13488
89135,25178,43.6,91579,57238,12834,12344
89138,13203,34.1,104361,42910,6859,6344
89139,32332,32.5,69983,29440,17659,14673
89141,28290,33.2,86895,36051,14025,14265
89142,31185,34.2,53284,19966,15293,15892
89143,11964,30.8,83590,28759,5727,6237
89144,20074,40.3,73492,40321,9555,10519
89145,24285,41.5,56524,31467,11897,12388
89146,18517,39.5,43003,24881,9615,8902
89147,51419,37.5,56009,26071,25036,26383
89148,42934,32.4,64084,29558,20770,22164
89149,33420,33.4,69273,33447,17259,16161
89156,27288,33.4,44420,18351,13460,13828
89161,93,54.7,-666666666,38482,51,42
89166,11860,29.6,65645,25305,6513,5347
89169,21809,33.9,31331,21003,11067,10742
89178,28781,31.3,78849,32021,14453,14328
89179,2815,33.1,78639,30883,1513,1302
89183,38800,30.8,62079,26031,18635,20165
89191,763,21.3,30278,21582,691,72
89301,6716,43.1,49340,26339,3933,2783
89310,523,43,43691,21209,331,192
89311,124,38.8,56719,24906,66,58
89314,242,44.5,27500,22738,112,130
89316,1513,38.7,63603,26280,771,742
89317,530,37,60682,20392,188,342
89318,1677,48.1,33750,17324,829,848
89319,766,26.3,55917,25030,472,294
89402,0,-666666666,-666666666,-666666666,0,0
89403,14089,41.5,48916,23926,7144,6945
89404,30,-666666666,-666666666,,13,17
89405,206,22.6,52560,17144,143,63
89406,24572,39.2,49830,24716,12124,12448
89408,19203,37.5,53111,22296,9693,9510
89409,128,60.5,25435,18449,72,56
89410,10432,48.3,53784,30703,5397,5035
89411,891,54.8,128793,88807,360,531
89412,265,54.6,65117,33165,123,142
89413,408,63.4,114196,123705,193,215
89414,308,50.4,58500,31715,151,157
89415,3862,50.8,37003,25061,1943,1919
89418,134,32.7,71005,39417,79,55
89419,5620,41.2,51389,16909,3763,1857
89420,39,59.8,10469,9787,15,24
89421,694,32.2,24375,8573,373,321
89422,82,68.3,21094,16374,36,46
89423,10722,50.9,72841,35311,5409,5313
89424,275,47.8,38043,17169,170,105
89425,756,52.9,35476,12934,447,309
89426,308,53.9,45781,44163,190,118
89427,717,32.8,27986,14334,332,385
89428,183,43.6,80389,26930,121,62
89429,7322,49.5,32459,16469,3763,3559
89430,465,38.8,68993,20538,308,157
89431,36812,34.9,37110,18625,18299,18513
89433,19630,34.2,41639,17272,9569,10061
89434,24948,41.4,52454,25196,12037,12911
89436,37781,37.7,79313,32998,18487,19294
89438,0,-666666666,-666666666,-666666666,0,0
89439,1687,50.7,64145,58338,893,794
89440,688,58.2,75217,46524,352,336
89441,11660,40.1,77619,31113,5838,5822
89442,999,29.9,22721,12159,467,532
89444,2580,55.1,48920,24628,1326,1254
89445,15679,35,65098,27342,8191,7488
89446,105,12.6,-666666666,,63,42
89447,8290,48.3,40565,21887,4191,4099
89448,1365,56.5,63239,46723,702,663
89449,2960,43,57054,46390,1637,1323
89450,154,60.5,59274,37462,96,58
89451,8500,46.1,71366,45804,4662,3838
89460,13338,44.5,55932,29069,6472,6866
89501,3533,49.5,22345,28253,2183,1350
89502,44329,33.9,33258,18890,22668,21661
89503,28191,31.5,39912,22680,15265,12926
89506,42054,32.4,54753,21848,21828,20226
89508,11276,40.9,65659,26679,5771,5505
89509,33302,43.5,52516,36664,16239,17063
89510,1574,50.1,60066,29880,846,728
89511,26311,45.4,81080,51228,13519,12792
89512,24450,30.5,31081,15823,12468,11982
89519,8407,48.4,117975,67060,4165,4242
89521,25111,36.8,77282,34958,12313,12798
89523,31732,35.4,64756,32958,15191,16541
89701,26637,40.6,50752,23632,13666,12971
89702,179,35.4,-666666666,2977,179,0
89703,10169,49.4,70399,40378,5173,4996
89704,4822,48,81909,43664,2500,2322
89705,5350,41.1,56146,29476,2601,2749
89706,19543,39.9,42955,21605,9881,9662
89801,22824,30.9,71623,28519,11510,11314
89815,14404,35.1,89296,34859,7760,6644
89820,5610,35.8,74637,29758,2858,2752
89821,455,39.3,91250,37937,269,186
89822,2643,34.9,69048,28913,1498,1145
89823,166,56.9,103446,53427,71,95
89825,1326,41.3,41220,15163,634,692
89826,193,23.9,107150,44782,56,137
89828,379,52.8,58686,29991,155,224
89830,198,52.6,21477,21182,100,98
89831,30,-666666666,-666666666,,15,15
89832,1531,33.4,33689,14361,868,663
89833,246,44.4,26674,20776,147,99
89834,168,49.1,47656,14842,116,52
89835,1729,36.1,49167,23507,877,852
89883,4442,26.1,37740,14982,2330,2112
90001,54760,27,35097,11409,26926,27834
90002,49475,25.8,31258,10705,23989,25486
90003,66200,26.2,29686,9963,32356,33844
90004,62760,35.8,37976,26401,31899,30861
90005,39548,33.8,31893,18210,20735,18813
90006,59498,33.6,30961,13139,30859,28639
90007,43173,23.7,22420,11049,21471,21702
90008,33280,39.7,38210,24086,14929,18351
90010,4133,39.8,51359,46897,2155,1978
90011,100882,27.6,30171,9505,50624,50258
90012,29528,36.3,28879,18754,17916,11612
90013,10256,43.2,20271,24579,6296,3960
90014,6008,43.6,16551,27661,3714,2294
90015,18358,32.7,27393,22255,9793,8565
90016,47273,35,37242,18997,21911,25362
90017,23755,29.7,21030,17142,12867,10888
90018,48498,33.9,32447,16224,23033,25465
90019,65408,36.6,42043,25568,31715,33693
90020,39866,34.8,38510,26021,19866,20000
90021,2940,47.6,13415,25322,2084,856
90022,70147,29.7,38925,12785,34752,35395
90023,45126,29.4,33849,11173,22610,22516
90024,50964,23.2,54373,40289,23875,27089
90025,43555,34.5,73478,49246,22073,21482
90026,68726,33.8,44327,24415,35014,33712
90027,45942,38.5,47993,37227,23142,22800
90028,28151,32.9,30953,25363,15561,12590
90029,40208,34.4,36979,18428,20893,19315
90031,40052,34.4,34655,14522,19890,20162
90032,47784,32.6,46508,17020,23412,24372
90033,49049,28.3,28005,11337,24526,24523
90034,58703,32.6,56946,34061,29229,29474
90035,30999,36.9,75863,47129,14589,16410
90036,36101,34.9,71589,50508,17825,18276
90037,61845,28.9,26796,10515,30401,31444
90038,29836,32.5,35144,21486,15001,14835
90039,27049,38.9,64080,39001,14122,12927
90040,12696,33.5,47758,15771,6335,6361
90041,28203,38.8,63770,28984,13220,14983
90042,60623,35.1,50996,22288,29653,30970
90043,43527,38.5,40658,24812,19990,23537
90044,87590,29.8,29870,12932,41812,45778
90045,40272,34.7,77893,40989,19734,20538
90046,50499,37.8,52641,54707,26451,24048
90047,47533,36.5,41842,19552,21690,25843
90048,21316,38.4,72701,61354,9956,11360
90049,35310,41.4,110854,93796,16219,19091
90056,8536,48.7,86858,52685,3680,4856
90057,45392,32.5,28035,13790,24452,20940
90058,2980,28.2,16750,8914,1528,1452
90059,41831,25.8,33962,11308,19712,22119
90061,27457,27.7,33476,12023,12823,14634
90062,32450,33.6,33192,13430,15608,16842
90063,54160,29.7,38441,12648,27229,26931
90064,26103,39.5,84579,54737,12605,13498
90065,45242,36.8,53635,26110,23508,21734
90066,59031,36.9,66744,39987,29446,29585
90067,2312,63,90972,104464,1031,1281
90068,22043,39,67500,70930,12362,9681
90069,20731,42.5,75451,82072,12305,8426
90071,0,-666666666,-666666666,-666666666,0,0
90073,773,54.4,-666666666,10085,642,131
90077,8506,47.7,168036,111116,3984,4522
90079,0,-666666666,-666666666,-666666666,0,0
90089,3276,19.3,11750,2775,1512,1764
90090,0,-666666666,-666666666,-666666666,0,0
90094,5852,32.8,91042,72234,2680,3172
90095,0,-666666666,-666666666,-666666666,0,0
90201,101932,27.9,37267,11699,51794,50138
90210,21548,46.4,132254,111364,10047,11501
90211,7748,41.3,68589,46409,3339,4409
90212,12510,41.5,83679,61224,5713,6797
90220,49810,29.6,43592,14945,23622,26188
90221,52446,27.2,42853,12489,25617,26829
90222,31893,27,40707,12750,15446,16447
90230,32335,39.4,71235,39792,15314,17021
90232,15454,38.9,73103,41828,7652,7802
90240,25411,37.5,72777,26912,12796,12615
90241,43776,34.1,56479,23564,21773,22003
90242,43147,31.8,58217,20268,21370,21777
90245,16760,38.3,84341,43218,8654,8106
90247,47361,36.1,44693,20588,22118,25243
90248,9822,45.2,52013,23350,4920,4902
90249,26800,36.9,51871,23951,12969,13831
90250,93994,31.5,45995,21018,45623,48371
90254,19605,37.5,101655,69606,10305,9300
90255,76620,29.4,37651,12165,38335,38285
90260,35508,32.4,51777,19437,17625,17883
90262,70137,27.9,40831,12197,33545,36592
90263,1899,20.3,-666666666,4639,826,1073
90265,17630,47,129750,90228,8814,8816
90266,35324,41.1,139259,81090,17419,17905
90270,27527,26.8,37082,11889,13837,13690
90272,22779,47.5,159696,110892,10900,11879
90274,25339,48.1,151469,81968,12416,12923
90275,42051,49,118860,57705,19976,22075
90277,34635,42.8,97158,59837,17106,17529
90278,40574,38.9,101575,49391,19133,21441
90280,95000,30.3,42776,14259,46711,48289
90290,7093,44.5,118750,53954,3290,3803
90291,27253,37.7,79736,59717,14396,12857
90292,21536,41.7,100441,75095,9944,11592
90293,12403,40.2,87308,62160,6169,6234
90301,36798,32.5,38160,17052,17862,18936
90302,30502,32.4,43042,21718,13980,16522
90303,26339,29.3,41622,15780,12863,13476
90304,28101,28.7,37783,12195,14152,13949
90305,14814,44,64735,33589,6474,8340
90401,6821,40,62794,56695,3816,3005
90402,11749,48.6,140139,108825,5797,5952
90403,24864,40.4,71424,59165,11631,13233
90404,20807,37.9,59695,37653,9617,11190
90405,28560,40.1,75717,53431,13466,15094
90501,42373,35.1,55138,25966,20525,21848
90502,16947,41.5,63721,28297,8115,8832
90503,46780,40.3,76082,35777,22576,24204
90504,31633,41.6,72194,31124,15887,15746
90505,36306,44.6,81772,38659,17125,19181
90506,0,-666666666,-666666666,-666666666,0,0
90601,33145,36.2,69375,28598,16765,16380
90602,25768,31.3,49873,22749,12440,13328
90603,20083,38.7,90477,34242,9821,10262
90604,40661,33.4,65570,23388,19779,20882
90605,42017,33.2,67482,22145,20588,21429
90606,32791,34.3,61800,19773,16085,16706
90620,45266,37.8,77526,25171,21890,23376
90621,35507,34.3,54126,21759,17621,17886
90623,15689,40.7,85100,34429,7451,8238
90630,48590,40.6,78745,32650,23328,25262
90631,68065,34.4,65804,26990,33355,34710
90638,49222,37.8,81722,28863,24113,25109
90640,63016,35.3,47438,20986,30678,32338
90650,105940,33.6,60770,19449,52844,53096
90660,63310,35,57605,18974,30928,32382
90670,15489,37.3,55525,21277,7764,7725
90680,30261,34,49294,21060,15032,15229
90701,16657,37.5,59946,21879,8529,8128
90703,49526,43.4,89113,34108,23648,25878
90704,3960,34.9,65721,28436,1948,2012
90706,76989,32,49637,20397,37219,39770
90710,26830,36.3,54065,24892,12708,14122
90712,31710,38.8,77495,30196,15038,16672
90713,27653,39.5,85742,32790,13817,13836
90715,20953,33.8,65481,23697,10144,10809
90716,14280,30.9,41910,14430,7027,7253
90717,21459,39.9,58320,29162,10330,11129
90720,22227,42.2,92780,42427,10541,11686
90723,54468,29.4,44934,14476,27289,27179
90731,61432,35.6,50210,24750,30648,30784
90732,19651,46.4,80172,40282,8999,10652
90740,24073,57.7,51211,44136,10798,13275
90742,866,53.9,70762,63751,471,395
90743,441,57.2,65139,42918,229,212
90744,57358,28.2,41920,14383,28834,28524
90745,58162,36.3,71854,21954,28626,29536
90746,26276,40.7,80092,28653,12578,13698
90747,0,-666666666,-666666666,-666666666,0,0
90755,11260,36,71077,32213,5545,5715
90802,39297,35.5,43404,32208,20624,18673
90803,30563,43.1,72653,61328,14718,15845
90804,40472,29.9,42672,21348,20204,20268
90805,92991,30.2,44070,16863,45335,47656
90806,43176,30.2,42998,17303,21029,22147
90807,32645,40.9,71645,37140,15936,16709
90808,40016,41.5,94335,40604,20018,19998
90810,36113,33,49269,17054,17774,18339
90813,59178,27.6,31334,12700,30019,29159
90814,18937,38.6,55415,41248,9490,9447
90815,40966,36.9,82805,37281,19799,21167
90822,176,62.6,-666666666,41167,141,35
90831,0,-666666666,-666666666,-666666666,0,0
91001,37832,41.2,85108,41528,18341,19491
91006,32271,41.8,80183,39728,15303,16968
91007,33586,43.5,73615,35263,15745,17841
91008,1217,54.9,85556,58568,556,661
91010,24708,39.9,59198,23264,11821,12887
91011,20590,44.5,156557,76941,10272,10318
91016,41985,37.7,71733,31749,20158,21827
91020,8585,38.5,63250,33299,4141,4444
91024,10983,47.3,88837,49626,5182,5801
91030,25747,39.4,85058,47043,12303,13444
91040,19296,43.5,69312,32778,9680,9616
91042,28725,40.2,57500,26892,13747,14978
91046,176,76.5,18380,17268,29,147
91101,21378,33.8,56980,39018,10139,11239
91103,26984,37.3,59682,30591,13364,13620
91104,37590,37.5,67068,33212,18614,18976
91105,11401,50.1,109922,79727,5433,5968
91106,24355,35.2,66250,46599,12569,11786
91107,32415,41.6,80936,45308,16364,16051
91108,13540,45.9,140703,78589,6506,7034
91201,23272,39.7,50107,24719,11200,12072
91202,22610,42.7,66067,36535,10484,12126
91203,13213,38.3,43078,22756,6342,6871
91204,15924,38.8,37634,19171,7515,8409
91205,38504,37.6,36906,19666,18862,19642
91206,33014,43.4,52570,31241,15648,17366
91207,10435,45.6,91005,47259,5375,5060
91208,15962,41.4,92532,42193,7677,8285
91210,651,26.1,90714,45699,379,272
91214,31653,41.7,90414,37192,15335,16318
91301,26218,44.3,109675,51578,12969,13249
91302,25070,43.9,129708,76142,12298,12772
91303,26744,32,47484,20550,13573,13171
91304,53194,35.9,58889,25531,25553,27641
91306,47879,35.3,61112,22708,24592,23287
91307,25496,43.4,97081,40029,12883,12613
91311,38117,42.3,78414,37547,18515,19602
91316,27736,39.4,59199,42960,13335,14401
91320,45060,39.3,104665,43615,22745,22315
91321,35243,33.3,56079,26453,18241,17002
91324,27304,35.6,58663,28013,13355,13949
91325,33121,35.1,59646,30570,16426,16695
91326,35900,42.4,99230,42685,17122,18778
91330,2138,19.9,-666666666,3835,890,1248
91331,100535,30.4,51477,14095,50338,50197
91335,76616,35.2,51266,20674,37496,39120
91340,35161,31.3,54440,16326,17535,17626
91342,89686,33.4,59329,19296,44709,44977
91343,62321,32.8,54166,21048,31492,30829
91344,52892,41.6,77604,30945,25996,26896
91345,18254,38.3,60352,22802,8810,9444
91350,35410,35.6,98112,35335,17857,17553
91351,31773,36.5,71153,28023,16213,15560
91352,46334,32.9,48844,18191,22986,23348
91354,29487,37.3,107654,40182,14824,14663
91355,32282,38.1,88415,41681,16192,16090
91356,30090,41.9,70759,42149,14398,15692
91360,43767,41.3,93042,39400,21022,22745
91361,20631,47.8,101146,60454,10100,10531
91362,35093,43.3,104715,52738,16917,18176
91364,25971,43.8,91100,49578,12956,13015
91367,40506,40,76548,43265,19801,20705
91371,0,-666666666,-666666666,-666666666,0,0
91377,14564,40.4,128218,58927,6774,7790
91381,19800,37,116420,48236,9940,9860
91384,29189,32.7,100404,29009,18319,10870
91387,41058,33.2,83484,33071,20388,20670
91390,20875,40.1,106190,38851,10593,10282
91401,39466,35.4,46420,25395,19801,19665
91402,71486,30.1,40186,14249,35890,35596
91403,23672,41.1,69956,56485,11718,11954
91405,54435,32,38847,17645,27254,27181
91406,52682,34,49231,21853,26282,26400
91411,24546,35.2,44570,24510,12824,11722
91423,31466,38.4,74011,54682,15169,16297
91436,14147,47.8,132520,75744,6758,7389
91501,20398,38.2,56740,29765,9585,10813
91502,11420,36.8,40714,24461,5232,6188
91504,25228,38.8,73151,34730,11765,13463
91505,31636,37.7,77378,37497,15409,16227
91506,18260,41.3,71914,36051,8889,9371
91601,37807,32.9,48638,28040,19852,17955
91602,17771,37.9,66652,47889,8706,9065
91604,28468,40.7,88579,67802,13845,14623
91605,55793,33,43301,16886,27707,28086
91606,45788,34,42521,19231,22881,22907
91607,28993,37.6,56635,39607,14468,14525
91608,0,-666666666,-666666666,-666666666,0,0
91701,40270,40.1,77765,32546,19962,20308
91702,60036,28.3,55495,17642,29482,30554
91706,77192,31.1,51232,15376,38847,38345
91708,3585,37.1,119063,14982,904,2681
91709,75551,36.7,96497,34955,37240,38311
91710,81596,34.1,70768,24428,43328,38268
91711,36011,39.4,88240,37047,17012,18999
91722,35370,35.5,66268,23177,17186,18184
91723,19778,32.7,61348,24301,9553,10225
91724,25407,36.2,77198,29815,12753,12654
91730,66362,32.6,62856,25825,32587,33775
91731,29744,34.8,36614,14745,15749,13995
91732,62548,33.1,42465,15234,30921,31627
91733,43593,32.4,40692,13789,21437,22156
91737,24138,38.6,96418,42146,11568,12570
91739,37242,33.8,103203,36816,18610,18632
91740,25961,38.7,66880,26394,12439,13522
91741,25540,40.7,82550,36316,12644,12896
91744,84674,31.1,57291,15724,42681,41993
91745,55776,40.4,76663,28315,26438,29338
91746,28869,34.3,59016,16932,14190,14679
91748,46966,40,62517,25914,23517,23449
91750,34045,40.6,79140,33486,16760,17285
91752,30073,33.2,64409,23121,15070,15003
91754,33616,41.2,57630,26081,16476,17140
91755,26945,45.2,54569,23640,12769,14176
91759,363,48.5,61094,39879,180,183
91761,58919,31.4,60971,19920,28636,30283
91762,55982,31.6,51495,18446,26969,29013
91763,37191,33.3,50220,17319,18926,18265
91764,53688,30,50270,16902,26389,27299
91765,47273,40.8,88819,34785,22842,24431
91766,71541,28.7,49725,16653,34987,36554
91767,48768,31.4,49881,18158,24209,24559
91768,36142,27.8,47228,14821,17690,18452
91770,62489,40,47373,18311,30159,32330
91773,33441,42,78509,35084,15972,17469
91775,25363,41.6,81613,35340,12509,12854
91776,37246,41.3,47368,21368,18139,19107
91780,34890,40.9,66158,27275,16400,18490
91784,26464,44,100120,42128,12788,13676
91786,51381,33.2,51805,23292,24413,26968
91789,42609,42.5,91623,33534,21384,21225
91790,46404,34.7,66402,21846,21997,24407
91791,31796,37.9,70111,29182,14609,17187
91792,30452,35.8,66718,24766,14859,15593
91801,54176,39.1,53027,25627,26178,27998
91803,29591,40.6,55659,25810,14254,15337
91901,17123,43.9,79792,39801,8479,8644
91902,18579,44.2,86981,37625,9215,9364
91905,1099,42.9,70264,22303,540,559
91906,4071,34.1,46875,21081,2084,1987
91910,77320,35.4,54056,24667,38164,39156
91911,81872,33.3,48111,19297,39032,42840
91913,40954,31.7,84299,28209,19809,21145
91914,17516,33.8,103393,34235,7781,9735
91915,26271,32.2,94665,29992,12987,13284
91916,1487,47.7,53843,28388,761,726
91917,884,36.1,64926,15957,399,485
91931,489,35.4,24426,9990,312,177
91932,25827,31.1,49268,20774,13146,12681
91934,239,55.7,41607,40746,170,69
91935,8238,43.6,86406,36253,4193,4045
91941,32413,41.2,69678,36728,15868,16545
91942,38828,37.2,51694,30576,18419,20409
91945,25719,35.4,51542,22341,12800,12919
91948,45,23.4,-666666666,33964,15,30
91950,60784,31.5,37987,16508,30927,29857
91962,1377,55.8,73333,36599,717,660
91963,1091,34.6,38563,14029,585,506
91977,60542,33.7,59849,23768,30335,30207
91978,9276,35.4,69601,29274,4533,4743
91980,195,61.7,-666666666,16202,85,110
92003,4157,49.3,69821,36622,2073,2084
92004,2679,54.3,40539,21634,1497,1182
92007,11273,40.7,99412,49587,5541,5732
92008,26536,41.7,63449,38143,13412,13124
92009,42649,40.8,100100,45985,21102,21547
92010,14968,38.9,90417,40344,7611,7357
92011,23120,42.2,96153,46854,11274,11846
92014,13403,49.8,114880,81119,6799,6604
92019,44406,38.2,72206,30750,22136,22270
92020,57747,34.1,46856,22078,28474,29273
92021,65175,34.3,49521,21942,32029,33146
92024,49048,41.7,90960,46155,24186,24862
92025,49110,30.9,45983,21612,24158,24952
92026,49537,38.3,55839,25525,24404,25133
92027,55461,32.6,52242,20798,27022,28439
92028,47282,40.8,61067,30146,23980,23302
92029,20198,42.3,71628,35767,10185,10013
92036,2807,50.7,65869,30997,1382,1425
92037,40114,39.1,99367,64476,19229,20885
92040,41214,37.8,64044,27903,20111,21103
92054,42751,31.3,49534,25551,22191,20560
92055,12457,21.8,60313,22931,11747,710
92056,52182,39.3,64033,28908,25932,26250
92057,54901,34.9,64004,26771,27663,27238
92058,45943,24.9,49521,20067,24300,21643
92059,1374,29.8,55938,28799,666,708
92060,74,53.2,-666666666,61372,29,45
92061,2113,49.9,53167,46653,1053,1060
92064,48622,39.8,93750,40363,24115,24507
92065,37299,39.4,76273,29903,18975,18324
92066,233,50.4,37143,21767,113,120
92067,8068,50,125051,69312,3709,4359
92069,46492,34,51158,21881,23033,23459
92070,1165,40.6,50750,20951,601,564
92071,54469,36.8,71100,29358,25768,28701
92075,12345,43.8,87701,56471,6005,6340
92078,44007,37.3,54441,28802,20333,23674
92081,27785,37,54448,26954,13681,14104
92082,20559,40.5,81835,30420,10153,10406
92083,37282,32.2,46580,18100,18733,18549
92084,46811,36.5,47559,23194,23311,23500
92086,1343,57.5,38021,20802,640,703
92091,1383,53.6,131406,73618,626,757
92101,35914,35.7,52550,46294,21230,14684
92102,43853,30.1,40557,18995,22632,21221
92103,31064,40.5,62092,50933,16477,14587
92104,45471,34.7,47947,30633,22718,22753
92105,68469,29.1,37534,14636,33655,34814
92106,20087,36.1,82075,47554,10228,9859
92107,26535,35.6,60929,40626,13163,13372
92108,18794,31.2,63098,40772,9513,9281
92109,44012,30.5,64478,44856,23271,20741
92110,27444,31.9,59719,31243,14200,13244
92111,47271,35.9,57350,27391,23830,23441
92113,58158,25.5,27675,13498,31759,26399
92114,68160,33,56310,18544,33624,34536
92115,61084,27.5,41866,21011,30675,30409
92116,32218,35.8,53448,36428,16979,15239
92117,52648,39.3,64026,32901,27024,25624
92118,21247,42.3,91103,51135,10593,10654
92119,22965,43.1,67616,34648,11017,11948
92120,25131,44,81000,40340,12646,12485
92121,4580,30,104063,46165,2613,1967
92122,45556,30.5,65871,39636,22995,22561
92123,28943,32.1,71412,32005,14719,14224
92124,30742,30.6,80463,35968,15181,15561
92126,77860,33.2,81505,30040,40716,37144
92127,40246,36.2,120106,50178,19493,20753
92128,49332,42.1,92531,44129,22829,26503
92129,53387,37.8,107870,39475,26449,26938
92130,48721,38,127968,60490,23719,25002
92131,33672,39.5,124099,51824,16067,17605
92132,0,-666666666,-666666666,-666666666,0,0
92134,101,24,-666666666,23174,89,12
92135,688,22.2,-666666666,26864,561,127
92139,36594,32.3,58079,20504,18138,18456
92140,2514,20.1,-666666666,15347,2383,131
92145,1529,37.1,226875,63536,751,778
92147,514,21.2,-666666666,24045,391,123
92154,84060,32.1,57618,18071,42972,41088
92155,775,23.6,-666666666,32706,764,11
92173,31031,29.3,36621,12673,15002,16029
92201,62551,30.6,41335,17094,30707,31844
92203,26183,36.9,72005,32713,12883,13300
92210,4876,69.1,84286,88958,2391,2485
92211,23729,62.4,56737,43598,11416,12313
92220,32134,46.2,39291,21208,14983,17151
92222,0,-666666666,-666666666,-666666666,0,0
92223,44458,34.9,65692,26840,22047,22411
92225,23624,37.3,42799,16188,15671,7953
92227,26438,31.3,42614,18820,13198,13240
92230,2699,30.2,33333,10792,1397,1302
92231,39245,31.9,35723,13160,18417,20828
92233,10578,33,35152,9630,7322,3256
92234,51927,34.5,44440,19816,26500,25427
92236,41815,25.6,41467,11909,21123,20692
92239,383,40.7,27031,9075,293,90
92240,35078,31.8,33682,15183,17637,17441
92241,9378,53.3,37279,20330,4541,4837
92242,1313,65.2,27279,24950,643,670
92243,48190,31.3,42618,19090,23514,24676
92249,7103,28.8,55886,15803,3601,3502
92250,8424,34.6,41133,19354,4430,3994
92251,21858,32,71574,19784,12805,9053
92252,10047,45,42338,22951,5214,4833
92253,37750,45.2,68107,38722,18270,19480
92254,11366,24.5,27156,8251,5519,5847
92256,3664,47.8,28594,19935,1736,1928
92257,1962,47.6,16082,13033,958,1004
92258,397,31.9,16151,7819,137,260
92259,366,58.6,20951,9667,202,164
92260,32452,52.8,49446,39327,14418,18034
92262,25852,48.6,46515,34237,14425,11427
92264,20240,55.7,43246,37415,11422,8818
92266,47,-666666666,-666666666,,47,0
92267,0,-666666666,-666666666,-666666666,0,0
92268,561,53.3,40333,33765,266,295
92270,17456,61,77526,61620,8961,8495
92273,1295,35.1,41354,15347,624,671
92274,18780,26.3,27305,11035,10380,8400
92275,1122,39.1,19854,14041,641,481
92276,7429,42.9,42842,19485,3653,3776
92277,23691,26.4,39382,19644,11506,12185
92278,4441,21.9,66875,24205,4120,321
92280,0,-666666666,-666666666,-666666666,0,0
92281,1773,40.9,30543,13667,826,947
92282,668,43.9,36544,15627,309,359
92283,2670,31,28913,14034,1367,1303
92284,24951,38.1,41398,20534,12267,12684
92285,2739,50.1,22917,17840,1429,1310
92301,32222,24.8,37565,11131,16822,15400
92304,17,-666666666,-666666666,,17,0
92305,295,39.7,75076,29950,182,113
92307,37265,38,56477,25056,18118,19147
92308,39987,36.8,43472,21498,19186,20801
92309,837,27.1,32833,13657,482,355
92310,9049,22.7,49778,19066,5231,3818
92311,32724,35,46279,20150,16405,16319
92313,12169,37.9,64129,30446,5877,6292
92314,10235,40,45473,21780,5160,5075
92315,5213,42.9,34088,24688,2429,2784
92316,31151,28.8,48276,14004,16146,15005
92320,7940,52.2,43839,24180,3912,4028
92321,965,53.8,62669,28789,511,454
92322,811,30.8,56292,33708,427,384
92324,57326,28.5,41198,16227,28894,28432
92325,8053,44.5,47000,24307,4168,3885
92327,1291,26,37000,12294,593,698
92328,285,49.4,38500,32133,118,167
92332,8,-666666666,-666666666,,8,0
92333,635,56,38125,33631,326,309
92335,98460,27.9,42943,13529,49857,48603
92336,90633,29.3,87116,23674,44854,45779
92337,37474,30.4,69804,19346,18422,19052
92338,0,-666666666,-666666666,-666666666,0,0
92339,984,47.8,61563,37252,426,558
92341,326,54.5,28500,19542,149,177
92342,6800,39.6,65794,25062,3435,3365
92344,20116,31.6,65339,21390,9930,10186
92345,80683,31.7,42421,16227,40676,40007
92346,57499,35.5,62198,23836,29349,28150
92347,1696,42.5,63462,19416,799,897
92352,6410,45.5,69296,29813,3031,3379
92354,21427,36.8,58700,30937,10157,11270
92356,6504,45.3,31662,16137,3315,3189
92358,986,43.7,57368,24153,485,501
92359,8087,40.1,54792,23777,3983,4104
92363,5242,38.9,30077,17854,2591,2651
92364,57,21.5,46500,33347,32,25
92365,2308,52.7,39504,18711,1094,1214
92368,930,44.6,27885,16298,477,453
92371,14729,42.9,48451,21510,7922,6807
92372,4920,50.5,35896,27885,2384,2536
92373,33891,38.1,65649,38534,16612,17279
92374,40605,33,64896,26350,19508,21097
92376,84699,28.2,44550,14442,42306,42393
92377,19137,29.9,79611,22806,9202,9935
92378,135,67.2,49115,24735,49,86
92382,5577,39.6,57090,26000,2825,2752
92384,56,56.4,54750,28382,34,22
92385,274,56.8,97989,40607,146,128
92386,1866,51.1,33428,20945,892,974
92389,108,57.5,20000,14382,59,49
92391,2693,33.3,41042,19620,1460,1233
92392,54557,27.9,58667,19090,26074,28483
92394,35027,30.4,53993,14394,18509,16518
92395,42364,30.6,38084,16184,19943,22421
92397,4497,42.9,65469,30816,2340,2157
92398,949,40.2,58568,24555,514,435
92399,53370,37,58420,26542,26942,26428
92401,2076,25.8,14946,7589,966,1110
92404,61918,29.6,37175,14361,30180,31738
92405,29967,27.7,37936,14078,14904,15063
92407,58275,28,51471,17813,28603,29672
92408,14548,31.4,36504,14749,7630,6918
92410,47192,25.7,27324,9973,23935,23257
92411,25822,27.2,31288,11215,12159,13663
92501,22211,31,48234,18449,11648,10563
92503,90989,30.2,56373,19453,45342,45647
92504,54221,33.3,56108,22051,27000,27221
92505,49435,29.7,57063,19267,24838,24597
92506,44704,40.6,78236,37286,21576,23128
92507,54152,24.6,39465,16468,26291,27861
92508,35937,34,100243,32035,17808,18129
92509,78117,29.7,56517,17997,39397,38720
92518,1049,63.9,62652,39170,614,435
92530,50141,30.1,49942,18119,25705,24436
92532,20383,29.7,81807,23972,10014,10369
92536,3454,46.6,52194,24600,1474,1980
92539,3887,49.5,38564,19342,1761,2126
92543,34406,36.5,26909,14425,16626,17780
92544,45256,35.6,43726,20615,22743,22513
92545,39770,44.9,38770,20416,18841,20929
92548,7017,37.1,39709,16836,3583,3434
92549,2157,55.1,58924,32968,1062,1095
92551,30468,28.3,52505,16304,14940,15528
92553,75024,27.6,42825,14088,36348,38676
92555,39748,30.8,73994,22901,18740,21008
92557,51196,31.4,62592,21673,24726,26470
92561,1509,51.5,82344,47892,741,768
92562,62070,35.2,75053,30614,30302,31768
92563,56252,31.9,78880,26284,27953,28299
92567,8906,31.8,56132,18500,4517,4389
92570,54115,29.5,41365,14479,27363,26752
92571,53820,26.8,50598,13992,26119,27701
92582,16580,30.8,58051,19557,7842,8738
92583,30029,32,39588,17294,14874,15155
92584,45510,32.2,75147,25341,22698,22812
92585,19222,33,61782,21108,9415,9807
92586,19091,62.2,35935,24051,8548,10543
92587,16081,37.1,67321,28573,7996,8085
92590,3529,44.5,42516,37771,1705,1824
92591,39092,31.4,68275,26426,18992,20100
92592,72760,36.5,88355,30704,36060,36700
92595,30448,34.4,62507,24049,15588,14860
92596,24297,32.7,82832,26192,12174,12123
92602,22239,34.3,103309,51403,10891,11348
92603,20172,40.4,111307,60685,9654,10518
92604,27942,39.3,89071,39413,13347,14595
92606,21740,36.9,86500,41034,10635,11105
92610,11250,35.8,124471,46909,5609,5641
92612,28040,29,68953,37507,13783,14257
92614,25131,35.8,92989,41920,12249,12882
92617,16388,21,38843,19684,7768,8620
92618,18617,34.9,92862,48602,9923,8694
92620,41443,37.7,103385,44488,20418,21025
92624,6258,43.3,68066,40179,3235,3023
92625,11975,49.5,116270,100232,5623,6352
92626,51904,34.4,77127,36431,26312,25592
92627,59488,33.5,58167,32208,30524,28964
92629,27173,45.3,85530,51346,13586,13587
92630,59401,39.6,84871,37813,29018,30383
92637,16251,75.7,36675,39341,5840,10411
92646,55184,43,84144,40150,26270,28914
92647,58081,35.7,75599,31110,28865,29216
92648,45598,40.7,82564,50941,22810,22788
92649,33470,44.3,86043,52331,16605,16865
92651,23559,48.8,95865,76705,12097,11462
92653,28607,42.7,91878,44533,14074,14533
92655,9231,36.9,45577,17679,4506,4725
92656,50820,35.8,97931,44160,24249,26571
92657,10078,44.4,156440,103549,4977,5101
92660,34068,43.5,111109,75066,16992,17076
92661,3840,51.6,90357,75314,2054,1786
92662,2903,52.1,78750,75392,1332,1571
92663,23141,38.4,83550,62239,12194,10947
92672,35224,41.2,75681,42606,17297,17927
92673,29263,38.8,120219,51196,14449,14814
92675,35192,40.3,75551,38097,17548,17644
92676,2146,47.4,97717,50133,1194,952
92677,63797,43.4,99101,50408,30407,33390
92678,436,48,126371,54617,227,209
92679,33377,39.8,142803,58284,16634,16743
92683,90640,39,52409,22965,45221,45419
92688,44767,34.8,98821,40069,22040,22727
92691,47275,42.7,92710,37657,23035,24240
92692,48739,42.6,99314,43726,23852,24887
92694,22527,32.7,127906,47811,11256,11271
92701,54117,27,41331,13567,27797,26320
92703,69952,29.6,50824,13635,36268,33684
92704,87208,29.7,58463,16929,43129,44079
92705,45815,37.5,82411,39826,22160,23655
92706,36287,30.4,60785,21645,18407,17880
92707,60288,29.6,57384,16685,30173,30115
92708,56510,43.3,80619,33900,28245,28265
92780,58755,32.8,64680,26678,28947,29808
92782,22889,35.8,99778,46067,11171,11718
92801,62859,31.1,47715,18703,31373,31486
92802,42502,31.1,49099,18443,21062,21440
92804,84648,33.6,53293,19920,41777,42871
92805,71568,29.2,53532,17331,37167,34401
92806,39468,32.6,59315,23927,19475,19993
92807,36027,42.3,98027,41111,17826,18201
92808,20495,40.9,105144,47490,10275,10220
92821,37254,38.3,78077,34090,18160,19094
92823,2761,42.3,113478,44145,1359,1402
92831,34970,30.1,61216,27889,16244,18726
92832,25264,31.4,59754,24992,12773,12491
92833,52232,35.6,65330,26093,25355,26877
92835,23477,43.4,97723,46701,11303,12174
92840,55513,35,61834,21211,28364,27149
92841,32512,37.5,54277,20385,16355,16157
92843,44351,33.3,51991,17186,22251,22100
92844,24614,35.6,49936,18179,12551,12063
92845,17125,41.6,89693,32975,8181,8944
92860,27177,39.6,84905,27076,15078,12099
92861,5842,49.7,155275,66912,2999,2843
92865,19529,35.3,85057,30508,9927,9602
92866,15213,34,58002,28402,7419,7794
92867,44148,35.6,79650,31056,21537,22611
92868,27149,31.9,69780,24453,14697,12452
92869,38001,38.7,91755,37550,18971,19030
92870,52794,36.8,78730,29816,26128,26666
92879,48327,31.5,62529,21340,23580,24747
92880,66353,31.9,100452,28820,33485,32868
92881,32048,35.4,94389,32624,16416,15632
92882,68885,32.2,71402,25125,34663,34222
92883,30364,37.1,93511,35017,14530,15834
92886,47786,42.1,108008,46035,23917,23869
92887,19700,41.3,125265,53658,9643,10057
93001,32094,38.1,52407,30929,15799,16295
93003,50446,40.2,67860,33201,24711,25735
93004,30737,39.1,73473,30911,15229,15508
93010,43924,39.7,85479,37705,21746,22178
93012,34964,40.6,94368,43007,16893,18071
93013,16156,42.4,69766,38113,7959,8197
93015,17440,31,57971,20939,8963,8477
93021,35847,36.5,97079,35680,17532,18315
93022,6726,44.6,75756,34070,3478,3248
93023,20512,47.7,62133,36758,9989,10523
93030,59435,29.2,55271,19429,30367,29068
93033,81644,28.9,53400,15401,41970,39674
93035,27207,40.4,80538,37932,13597,13610
93036,43568,30.4,65432,22592,21722,21846
93040,1914,29.3,45486,16056,951,963
93041,23874,30.9,52814,23974,11628,12246
93042,64,22.6,-666666666,41822,60,4
93043,0,-666666666,-666666666,-666666666,0,0
93060,33489,31,55038,20258,17392,16097
93063,55846,38.4,84216,34205,28124,27722
93064,0,-666666666,-666666666,-666666666,0,0
93065,71899,38.1,91686,38257,34457,37442
93066,3240,45.1,85363,51619,1773,1467
93067,543,49.2,74832,70229,247,296
93101,32523,31.2,55042,27139,16461,16062
93103,20607,35.1,67053,34673,10628,9979
93105,24379,47.9,81035,50397,11483,12896
93108,11446,51.4,119539,78530,5212,6234
93109,10443,40.8,88750,53318,5095,5348
93110,17572,42,76215,42557,9235,8337
93111,17313,46.3,95560,43533,8378,8935
93117,54251,21.9,56669,22722,27160,27091
93201,1084,23.5,27443,10863,531,553
93202,3738,28.4,40484,12112,1838,1900
93203,21208,23.6,33147,10394,11157,10051
93204,15001,30.1,28794,8013,9680,5321
93205,2190,54.2,21552,19001,956,1234
78418,32129,36.1,55487,28138,16142,15987
78419,841,25.5,44594,17578,364,477
78501,61827,33.5,31214,16587,30243,31584
78503,21739,32.5,35660,20732,10741,10998
78504,49936,31.4,61277,26145,24909,25027
78516,38277,27.6,32977,11913,19423,18854
78520,61328,30.4,29835,14068,29535,31793
78521,90446,28.2,26684,11306,42404,48042
78526,45360,28.1,44672,16600,21792,23568
78535,630,37.6,23795,9604,337,293
78536,433,33.8,30000,24350,231,202
78537,37256,27.5,25338,10613,17539,19717
78538,11941,25,25806,9857,5746,6195
78539,33495,33.1,52167,21293,16808,16687
78541,42696,25,34586,13719,21145,21551
78542,65704,26.2,29878,11020,33342,32362
78543,8101,28.8,22121,11636,3987,4114
78545,163,46.3,24917,15035,76,87
78548,604,22.5,25962,14692,318,286
78549,436,43.6,22599,8987,134,302
78550,52238,32.4,33780,16535,25536,26702
78552,36331,34.6,39602,19462,17715,18616
78557,12544,27.8,39033,12001,5562,6982
78558,1033,22.6,17000,8931,488,545
78559,12410,32.8,31901,15302,5967,6443
78560,4230,29.3,34297,13196,2083,2147
78561,514,30.4,16000,6525,263,251
78562,2210,31.3,30938,10552,1235,975
78563,171,52.3,30809,18282,122,49
78564,19,-666666666,-666666666,,9,10
78565,216,41.3,8611,5960,118,98
78566,17280,27.5,39361,13252,8718,8562
78567,455,35.8,19500,11769,225,230
78569,3817,31.7,36750,12796,1948,1869
78570,31747,26.1,25445,9760,14619,17128
78572,73998,32.8,37735,15966,36245,37753
78573,36251,25.4,33809,12392,17460,18791
78574,60589,24.3,29818,11747,29426,31163
78575,9290,32.3,52039,20720,4202,5088
78576,10255,23.1,28853,9830,5010,5245
78577,72047,28.6,32054,12969,34179,37868
78578,11312,34.6,35523,19665,5383,5929
78579,3933,26.3,31099,8967,1892,2041
78580,15613,31.8,28106,11580,8633,6980
78582,41646,27.7,27337,11901,20737,20909
78583,5799,42.1,34324,17478,3188,2611
78584,17893,33.9,19881,10219,8082,9811
78585,289,42.6,38333,14550,110,179
78586,58144,30.5,31303,11841,28269,29875
78588,111,53.1,25500,24411,61,50
78589,37773,26.8,33648,12697,18687,19086
78590,341,37,32083,8988,158,183
78591,219,46.8,38625,16161,96,123
78592,1050,29.5,25441,9125,422,628
78593,5726,29,24073,10383,2861,2865
78594,1590,32.5,14565,7445,789,801
78595,6087,26,24464,8859,3002,3085
78596,66125,29.6,34297,13193,31520,34605
78597,2911,60,45432,44076,1502,1409
78598,192,64.1,9143,8124,105,87
78602,26278,38.6,50376,23596,13993,12285
78605,5011,45.6,52277,25432,2480,2531
78606,5379,45.3,48438,26270,2754,2625
78607,101,71.1,20238,22829,55,46
78608,264,42,56727,21211,99,165
78609,1560,61.5,39779,30528,749,811
78610,25580,34.6,79049,31048,13060,12520
78611,13226,44.6,48409,23381,6460,6766
78612,10807,38.4,63144,28324,5176,5631
78613,68426,34.7,81928,34311,33571,34855
78614,492,48.6,78958,32997,277,215
78615,818,52.2,65625,40383,444,374
78616,5645,34.1,50848,21917,2836,2809
78617,21096,30,45212,15029,11199,9897
78618,283,63.1,63393,41988,147,136
78619,3446,43.5,87228,38974,1841,1605
78620,14660,42.2,89899,40232,7588,7072
78621,21863,35.2,52471,23080,11204,10659
78622,201,42.3,46250,23910,132,69
78623,809,55,63487,33096,408,401
78624,21850,48.9,54286,30167,10513,11337
78626,27346,32,57787,23621,13636,13710
78628,24603,42.9,80363,36942,12086,12517
78629,12018,36.4,42807,20517,5879,6139
78631,2227,56.9,43340,32800,1122,1105
78632,723,46.1,41573,22989,393,330
78633,18462,65.5,74986,44834,8756,9706
78634,24306,31.8,73729,27564,11854,12452
78635,19,-666666666,-666666666,,0,19
78636,4014,47.5,47660,24141,2078,1936
78638,2272,44.8,44708,24533,1251,1021
78639,7334,43.1,32865,21679,3651,3683
78640,43427,31,64137,22199,21368,22059
78641,48854,33.4,71885,29372,24589,24265
78642,9341,39,75375,28780,4652,4689
78643,6081,53.6,42939,25688,2810,3271
78644,17542,37.4,46967,20483,8933,8609
78645,10148,50,73601,41359,5217,4931
78648,7866,42.7,34903,21937,3803,4063
78650,1746,36.9,54474,22595,854,892
78652,5117,36.5,76604,35643,2271,2846
78653,16917,30.5,59763,21044,8497,8420
78654,16916,44.1,46086,25215,8395,8521
78655,3917,37.1,46823,20873,1855,2062
78656,2118,29.4,43922,13622,1035,1083
78657,6236,57.8,69592,52001,3013,3223
78659,3140,45.1,68452,28461,1748,1392
78660,75038,32.5,76007,28353,36121,38917
78661,312,46,39821,14729,180,132
78662,3266,37.7,75050,24434,1768,1498
78663,827,57.5,71971,31715,374,453
78664,57806,30.9,61401,26891,28323,29483
78665,36291,32.4,85907,32435,17653,18638
78666,66027,24.2,33827,18289,33067,32960
78669,8418,49,83024,47960,4272,4146
78670,367,37.1,44265,17946,211,156
78671,739,37.4,55479,16707,404,335
78672,994,60.9,30521,24051,526,468
78675,224,52.3,54773,45934,146,78
78676,12453,52,66050,35853,5868,6585
78677,101,53.2,92778,40140,62,39
78681,54141,35.1,92453,34024,27243,26898
78701,5915,33.8,86541,89670,3331,2584
78702,21655,32.3,36197,19715,10857,10798
78703,19860,36.2,80569,66049,10126,9734
78704,41999,31.6,50930,37301,21900,20099
78705,31282,20.9,12143,9791,15624,15658
78712,548,19.6,-666666666,3448,247,301
78717,24099,33.6,93701,38401,11724,12375
78719,1746,36.1,38305,19582,954,792
78721,11482,32.2,33798,15789,5461,6021
78722,6355,33.6,50923,36289,3333,3022
78723,31234,30.9,42939,22439,15367,15867
78724,21454,26.8,38479,13452,11524,9930
78725,8169,31.7,52381,18279,4263,3906
78726,13181,30.3,67466,41210,6539,6642
78727,28563,32.7,69570,34953,14060,14503
78728,20817,31,48612,29156,10092,10725
78729,26906,33.6,60690,34237,12683,14223
78730,8916,37.8,120568,73526,4548,4368
78731,25575,39.4,75269,56169,12028,13547
78732,15097,37.2,131216,52104,7504,7593
78733,9475,41,122860,62990,4661,4814
78734,18290,43.1,87300,46328,9262,9028
78735,17118,35.6,79984,51690,8120,8998
78736,6599,45.6,84940,40537,3435,3164
78737,13539,40.6,121094,48326,6666,6873
78738,13141,39.6,118795,49878,6470,6671
78739,17198,36,128597,49116,8245,8953
78741,48654,26.3,30871,16930,25745,22909
78742,810,33.6,19688,15485,372,438
78744,44375,27.8,41721,16335,22720,21655
78745,57559,35.3,50672,27260,28404,29155
78746,27506,41.7,128936,76782,13586,13920
78747,15919,32.4,61599,27087,7950,7969
78748,41710,32.2,66309,31940,20826,20884
78749,34392,36.2,84907,39897,16535,17857
78750,27012,38.9,76236,42397,13225,13787
78751,14045,29.3,39032,33636,7223,6822
78752,18381,30.2,34716,18845,10429,7952
78753,52674,29.8,38884,18115,27637,25037
78754,15109,31.7,54896,27663,7819,7290
78756,8125,34.8,59854,43422,4404,3721
78757,22655,37.8,57429,35045,11079,11576
78758,45623,30.2,43537,23608,24521,21102
78759,39895,37.8,66828,47979,19669,20226
78801,21761,32.9,33306,17469,10503,11258
78802,1002,36.4,51944,12473,559,443
78827,1775,31.7,24310,11237,777,998
78828,202,54.8,33462,24704,103,99
78829,1151,39.5,20536,9400,436,715
78830,713,41.3,24861,14571,343,370
78832,3589,46.1,33257,16700,1875,1714
78833,1372,49.7,29180,15793,722,650
78834,7634,36.5,42222,19166,3678,3956
78836,20,-666666666,-666666666,,8,12
78837,181,36.7,30556,15693,84,97
78838,213,63.9,51667,29015,95,118
78839,8747,30.3,25560,12073,4445,4302
78840,48325,32.1,40533,17854,24192,24133
78843,197,20.8,-666666666,23462,197,0
78850,1297,47,46500,25494,539,758
78851,31,40.9,-666666666,11310,20,11
78852,53600,29.2,31214,13397,26208,27392
78860,293,56.9,19535,29399,117,176
78861,13006,35.5,45118,17646,7574,5432
78870,977,35.4,37500,19452,535,442
78871,18,82.5,-666666666,12650,4,14
78872,2079,31.3,31050,18330,1087,992
78873,1731,49.9,38594,18202,905,826
78877,987,53.2,42250,23672,498,489
78879,300,76.1,36806,27146,133,167
78880,1842,47.4,47083,21623,910,932
78881,2039,30.6,34250,16999,1003,1036
78883,305,63.1,44231,46325,141,164
78884,915,54.7,46389,22391,448,467
78885,106,55.5,80417,38706,61,45
78886,624,50.2,74196,30817,307,317
78931,189,64.1,67917,31220,97,92
78932,481,58.6,36548,26184,266,215
78933,1347,55.9,59974,35344,729,618
78934,6349,46.3,46350,26496,3204,3145
78935,1144,37.3,82391,26474,581,563
78938,517,54,52098,21697,302,215
78940,2383,49,51905,31622,1266,1117
78941,2754,45.7,40304,23115,1327,1427
78942,8486,34.9,43798,22138,4133,4353
78943,298,46.2,45598,16107,155,143
78944,722,45.4,47083,19894,385,337
78945,10465,46.4,49351,27973,4839,5626
78946,1007,45.6,46719,21835,509,498
78947,4631,46.2,64516,29521,2358,2273
78948,865,48.3,63029,25158,472,393
78949,392,46.1,58523,26415,177,215
78950,2591,49.4,49261,27013,1219,1372
78951,34,-666666666,-666666666,,19,15
78953,804,40.5,44604,20019,377,427
78954,1179,45.8,55000,25631,553,626
78956,5270,46.8,39923,25160,2654,2616
78957,8502,42.8,42994,23200,4032,4470
78959,2209,40.3,39648,17973,1239,970
78962,4803,49.3,45545,27226,2431,2372
78963,921,46.5,70017,26212,488,433
79001,287,42.1,53214,41325,141,146
79003,233,33.9,64653,31764,117,116
79005,1692,30.1,62750,29354,904,788
79007,14388,35.2,42613,22426,7224,7164
79009,2334,25.4,41552,13738,1208,1126
79010,705,31.8,74911,20632,334,371
79011,286,55.2,71250,44838,148,138
79012,1044,29.5,97083,29788,575,469
79013,3192,24.8,42349,13041,1756,1436
79014,3956,35.4,55690,30439,1934,2022
79015,20629,28.7,51951,26128,9733,10896
79016,99,19.4,-666666666,4785,0,99
79018,400,29.9,40833,25275,187,213
79019,1581,42.5,57202,25728,747,834
79021,104,26.5,56250,17961,45,59
79022,11126,35.7,49521,22105,6330,4796
79024,343,31.2,54167,24718,199,144
79025,32,65.6,-666666666,10316,9,23
79027,5080,32.3,29805,18702,2464,2616
79029,16333,31.6,51971,20276,8347,7986
79031,1346,39.1,43688,21816,708,638
79032,128,38.8,70547,25483,69,59
79033,60,81.2,250001,112867,33,27
79034,793,43.9,66023,25854,400,393
79035,4989,33.5,46467,18181,2420,2569
79036,5287,44.1,51035,24986,2513,2774
79039,727,51.7,54122,33393,397,330
79040,1583,37.8,57604,26584,859,724
79041,3784,31.7,36667,17090,1789,1995
79042,1330,36.5,54821,23714,701,629
79043,1722,35.6,39145,18534,903,819
79044,570,37.4,40000,18987,280,290
79045,19483,30.9,41975,17560,9766,9717
79046,448,37.2,40750,24616,225,223
79051,30,-666666666,-666666666,,13,17
79052,1189,40.3,43250,23783,604,585
79053,163,29.2,86607,27550,93,70
79054,360,57.9,40000,20816,214,146
79056,60,52.3,44375,51282,27,33
79057,1198,40,41500,24538,565,633
79058,0,-666666666,-666666666,-666666666,0,0
79059,857,43.8,67404,35861,416,441
79061,482,43.7,60357,36859,268,214
79062,324,42.3,61000,24055,166,158
79063,711,44.1,55938,28253,339,372
79064,2405,40.9,37865,19163,1261,1144
79065,21431,37.6,43921,21728,11321,10110
79068,2948,38.9,65050,26018,1495,1453
79070,10312,30.8,49810,22691,5301,5011
79072,28073,31.9,40832,17650,14840,13233
79078,326,45.2,50341,25451,203,123
79079,2392,46.1,41625,31425,1170,1222
79080,647,41.8,42000,19567,285,362
79081,3988,35.7,47292,23020,1990,1998
79082,342,50.4,54375,22533,168,174
79083,2529,37.3,51141,25949,1298,1231
79084,2495,34.4,44417,20342,1245,1250
79085,53,37,-666666666,,41,12
79086,2421,39.3,53810,25457,1209,1212
79087,857,30,48375,19038,491,366
79088,5707,36.2,34519,16218,3102,2605
79091,155,25,53250,25212,48,107
79092,1109,38.7,44632,24426,534,575
79093,24,24,-666666666,14633,7,17
79094,104,56.4,76190,33026,69,35
79095,2685,36.7,40494,22530,1241,1444
79096,2233,37.2,54750,26173,1095,1138
79097,1239,42.3,71429,29142,558,681
79098,480,46.7,54875,25017,223,257
79101,2653,45.6,21250,19203,1200,1453
79102,9689,30.6,40216,19941,4851,4838
79103,11613,29.5,47308,18640,5734,5879
79104,7191,30.2,27490,12820,3716,3475
79105,0,-666666666,-666666666,-666666666,0,0
79106,28697,34,38685,21798,14130,14567
79107,34436,28.7,32002,12851,17285,17151
79108,16968,41.2,51746,21591,10143,6825
79109,42512,39,53945,30904,20520,21992
79110,18635,32.1,47834,21769,9335,9300
79111,1496,32.3,53850,17273,845,651
79118,20026,34.6,62323,25783,10316,9710
79119,12500,35.4,88370,41052,5875,6625
79121,6688,44.1,69676,41885,3212,3476
79124,8766,39.1,78627,41001,4497,4269
79201,7166,34.1,41607,19741,4195,2971
79220,261,48.2,55781,24640,137,124
79225,914,48.6,48333,25348,502,412
79226,3048,44.2,38750,21344,1510,1538
79227,1208,46.1,33882,21929,608,600
79229,369,52.1,38068,22735,182,187
79230,189,46.5,59250,17989,119,70
79231,17,50.3,-666666666,11582,5,12
79233,217,39.9,19375,40690,94,123
79234,100,24.4,42250,18649,56,44
79235,3747,37.2,38808,21095,1769,1978
79236,275,45.4,65000,29552,147,128
79237,491,38,65000,24816,234,257
79239,198,44.8,58929,22442,94,104
79240,61,12.7,-666666666,5452,29,32
79241,2512,39.2,47969,22428,1279,1233
79243,92,26.7,77981,19099,40,52
79244,504,36.8,35000,21769,297,207
79245,2262,43.8,31761,15621,1080,1182
79247,42,56.8,32083,15202,24,18
79248,1496,50.2,34361,20904,656,840
79250,1461,37.5,42132,20469,690,771
79251,73,51.1,50625,21327,45,28
79252,3213,42.2,35373,18803,1461,1752
79255,622,46,29559,18716,279,343
79256,430,44.3,35208,19716,239,191
79257,1070,43.9,39792,22506,595,475
79258,45,12.3,-666666666,,34,11
79259,81,44.9,108047,42606,38,43
79261,625,41.6,37969,24085,309,316
79311,3898,33.1,50690,20720,1966,1932
79312,1171,34.2,37500,15983,536,635
79313,1555,35.6,39097,24928,777,778
79314,72,46.5,59583,24097,37,35
79316,11120,35.3,36667,21265,6071,5049
79322,2077,37.3,39420,20779,1028,1049
79323,6192,35.3,54697,22743,2985,3207
79324,6,-666666666,-666666666,,2,4
79325,2345,36.2,44559,22937,1297,1048
79326,0,-666666666,-666666666,-666666666,0,0
79329,3552,35.3,62472,30898,1821,1731
79330,174,57.4,83333,80436,117,57
79331,13195,32.7,39847,17692,7673,5522
79336,16941,33.6,50843,22228,8280,8661
79339,7170,34.4,35487,17724,3588,3582
79342,571,34.4,61250,20509,315,256
79343,1393,41.2,42188,19700,679,714
79344,44,69.9,30481,30407,21,23
79345,968,41.1,53281,22971,529,439
79346,2387,38.1,37115,16690,1189,1198
79347,7338,33.3,46406,19781,3834,3504
79350,268,49,41488,18856,133,135
79351,1491,33.6,33274,18659,681,810
79353,7,-666666666,-666666666,,4,3
79355,2340,28.7,45640,18247,1182,1158
79356,6157,37.4,47627,14349,3793,2364
79357,2480,35.5,34688,16804,1165,1315
79358,1112,37.2,50809,20009,604,508
79359,2913,27.5,48042,16341,1542,1371
79360,13914,27.9,52864,22553,6996,6918
79363,5182,34.9,54601,24169,2512,2670
79364,8234,40.4,40284,20800,3951,4283
79366,1397,43.2,102500,52435,691,706
79367,803,26.7,45250,15624,380,423
79369,86,45.8,166000,53764,45,41
79370,1738,41.2,36208,19361,995,743
79371,1415,30.6,37235,19574,711,704
79372,1270,28.4,49191,20267,633,637
79373,3356,41.1,46875,22303,1779,1577
79376,77,44.6,21771,33214,32,45
79377,233,41.1,42292,20843,136,97
79378,362,31.4,50625,22378,147,215
79379,664,27.9,42778,19853,334,330
79380,281,27.4,42344,17905,143,138
79381,1263,36.1,45789,19856,639,624
79382,6052,34.3,61563,26140,2942,3110
79401,7092,22.5,13450,10411,3999,3093
79403,17888,32.4,33554,14645,9167,8721
79404,10947,33.2,27434,12787,5473,5474
79406,7154,19.2,-666666666,2953,3825,3329
79407,17485,29.4,40221,26553,8541,8944
79410,8863,27.9,36715,26085,4372,4491
79411,9178,24.8,24244,13029,4248,4930
79412,16052,31.1,33317,15407,7657,8395
79413,20967,35.3,49384,26040,9913,11054
79414,18259,28.1,34504,18192,8623,9636
79415,17406,27.8,27270,15321,8769,8637
79416,32772,26.2,45937,23645,16211,16561
79423,33809,34.1,54784,30018,16576,17233
79424,40114,38.5,75921,39589,20293,19821
79501,3126,43.8,41757,22714,1494,1632
79502,1215,44.9,41190,20256,610,605
79503,183,53.5,55326,21433,99,84
79504,2933,46.6,41406,23461,1478,1455
79505,377,32.3,35278,18393,148,229
79506,762,47.4,39500,41372,408,354
79508,1266,46,65526,63068,641,625
79510,7973,42,46555,22757,3818,4155
79511,941,48.7,62500,32118,426,515
79512,8171,34.5,47954,15076,5129,3042
79517,171,31.7,76875,80602,70,101
79518,182,45.4,52917,31792,92,90
79519,86,45.2,43750,22403,39,47
79520,2254,40.4,33864,20635,1095,1159
79521,3737,45.8,39479,22128,1920,1817
79525,2409,41.5,38787,17198,1270,1139
79526,817,38.1,71250,32567,425,392
79527,245,24.7,50688,18551,167,78
79528,677,47,45446,23445,323,354
79529,1336,40.1,36979,17555,628,708
79530,426,40.4,44792,20123,224,202
79532,981,52.7,27131,21411,474,507
79533,329,56.7,41786,35998,169,160
79534,200,39.5,26250,17453,139,61
79535,78,59.5,38333,30795,40,38
79536,4190,43.4,45054,21086,2023,2167
79537,107,54.8,46563,29650,59,48
79538,195,44.2,46250,19079,85,110
79539,200,55.3,34821,21755,121,79
79540,82,72.1,116563,74427,49,33
79541,1096,32.8,58833,17522,523,573
79543,1224,39.4,46667,18495,569,655
79544,421,50.1,35417,29276,194,227
79545,1760,42.9,44188,22790,866,894
79546,1932,43.6,36250,24649,920,1012
79547,740,44,35625,22186,366,374
79548,227,36.6,41696,21948,146,81
79549,15938,37.3,46791,22422,8452,7486
79553,3465,44,35904,18537,1493,1972
79556,13006,37.9,36499,18473,6504,6502
79560,75,66.6,48750,29421,45,30
79561,618,38.7,46154,25077,349,269
79562,3745,45,74750,36072,1834,1911
79563,1200,32.9,38750,17752,576,624
79565,294,31.3,56389,23751,141,153
79566,264,71.5,40833,36944,138,126
79567,3151,40.7,41600,19218,1582,1569
79601,27825,29.1,34556,14423,15873,11952
79602,21634,34.3,51295,25657,10898,10736
79603,24213,33.5,38176,17412,11777,12436
79605,29105,34.3,41305,22823,13909,15196
79606,23369,34,56844,29617,11887,11482
79607,3067,21.6,44779,17372,1834,1233
79699,331,19.5,-666666666,3815,135,196
79701,28757,30.1,45030,21235,14445,14312
79703,21214,30.5,57842,23946,10127,11087
79705,32784,36.8,68649,38947,16027,16757
79706,20577,33.3,58737,27204,10465,10112
79707,35381,34.5,76543,47269,17435,17946
79713,628,35.1,52188,24667,328,300
79714,15554,34.2,57825,27429,7801,7753
79718,1111,33.2,38636,15445,547,564
79719,464,46.2,28958,15976,228,236
79720,34255,37.1,45000,19661,19443,14812
79730,276,31.4,44342,16657,155,121
79731,4282,34.5,49848,22482,2192,2090
79733,180,33.5,61250,20692,74,106
79734,2143,55.2,49146,27339,1069,1074
79735,13396,35.9,45291,19197,7608,5788
79738,301,40.2,72656,46912,152,149
79739,956,38.4,81250,31455,519,437
79741,243,32.7,65000,36414,120,123
79742,469,27.2,35833,15346,237,232
79743,328,45,66875,23732,151,177
79744,1288,36.9,68594,28504,707,581
79745,6110,34.4,48488,22978,3026,3084
79748,108,44.4,70417,27125,53,55
79749,368,27.3,64712,25734,203,165
79752,2255,31.4,40809,20184,1025,1230
79754,71,47.2,68000,32532,53,18
79755,168,47.5,75625,29292,96,72
79756,9134,36.4,44432,23315,4477,4657
79758,1550,41.3,57460,39866,768,782
79759,0,-666666666,-666666666,-666666666,0,0
79761,31644,31.8,44174,21921,15664,15980
79762,40531,30.9,56235,30272,20281,20250
79763,34258,28.1,47230,19324,16712,17546
79764,20868,34.2,50556,21883,10716,10152
79765,8298,31.9,86367,39368,4145,4153
79766,7928,32.3,55102,20497,3909,4019
79770,0,-666666666,-666666666,-666666666,0,0
79772,12063,35,41354,14917,7014,5049
79777,321,19,63958,16270,196,125
79778,900,44.6,61806,28706,483,417
79780,447,42.8,26029,32077,221,226
79781,290,42.3,50000,30605,160,130
95064,7865,19.5,54669,6039,3952,3913
95065,8443,43.7,85156,43928,4218,4225
95066,14993,40.7,106519,45253,7442,7551
95070,30923,47.8,158655,76429,15173,15750
95073,10571,46,73987,39759,5309,5262
95075,293,40.2,52500,30462,134,159
95076,82930,32.1,55208,20378,41387,41543
95110,18739,31,63184,29505,9788,8951
95111,59521,32,57120,19067,29948,29573
95112,55481,30.5,48370,26241,29280,26201
95113,838,35.5,34345,43123,413,425
95116,51010,32.4,48805,17323,26096,24914
95117,32277,32.3,63465,29481,17294,14983
95118,31858,37.4,89265,38417,15571,16287
95119,10291,37.8,109745,36007,5218,5073
95120,38366,44.7,150675,57059,19073,19293
95121,37699,35.7,82001,26585,19044,18655
95122,55438,31.6,56140,16143,27766,27672
95123,63621,36.6,87180,35614,31401,32220
95124,47446,39.2,105924,45127,23859,23587
95125,54200,38.8,97694,52052,25773,28427
95126,33711,33.3,70351,39987,17019,16692
95127,65258,34.1,68379,23299,33772,31486
95128,35898,36,66533,37626,18699,17199
95129,39740,39.1,104705,45876,19753,19987
95130,13954,36.5,90759,40535,7321,6633
95131,28999,36,104919,38364,15055,13944
95132,40838,39.1,95198,32008,20363,20475
95133,26867,37.3,66705,25466,13540,13327
95134,15517,31.9,113212,51672,8222,7295
95135,20908,43.4,124288,48091,9968,10940
95136,42464,35.5,86547,37538,20740,21724
95138,18870,37.2,143261,52436,8962,9908
95139,6545,39.6,92421,38486,3108,3437
95140,299,44.2,163229,44805,175,124
95148,45741,37,105438,32244,22579,23162
95202,5404,35.6,14404,11565,2699,2705
95203,14857,35,39301,18604,7788,7069
95204,29227,35.3,44809,22401,13906,15321
95205,35831,28.9,33043,12489,18370,17461
95206,66092,27.7,43559,13957,32967,33125
95207,47883,31.6,39301,20320,22139,25744
95209,41221,35.5,72430,26121,20150,21071
95210,40180,29.6,40182,15088,19698,20482
95211,1904,19.6,-666666666,2051,725,1179
95212,25892,33,61214,24668,12574,13318
95215,24067,33.1,41736,18183,12572,11495
95219,27686,37.1,73911,38765,13165,14521
95220,7395,43.3,54000,31191,3800,3595
95222,5146,52.8,52088,30506,2334,2812
95223,3056,59.1,54360,34503,1540,1516
95224,297,65,21429,16446,148,149
95225,565,53.8,52788,19214,279,286
95226,284,14.2,-666666666,,165,119
95227,675,60.2,102117,83172,287,388
95228,4286,38.3,61488,29841,2138,2148
95230,711,47.2,45769,28501,278,433
95231,5179,30.9,37258,11293,3271,1908
95232,286,46.2,55417,24376,132,154
95233,475,50.8,52222,24540,166,309
95234,263,49.6,-666666666,15369,249,14
95236,3768,37.7,81510,33192,1902,1866
95237,3269,38.7,44542,22400,1741,1528
95240,46482,33.1,41172,19814,22834,23648
95242,25525,39.9,65601,33315,12257,13268
95245,2273,56.2,62077,33585,1151,1122
95246,1207,52.8,47379,29646,578,629
95247,4599,56,47479,33798,2067,2532
95248,131,57.9,21382,20157,30,101
95249,3575,45.4,44038,21851,2038,1537
95250,62,62.9,-666666666,10648,31,31
95251,1022,47.1,67171,27467,567,455
95252,14908,45.3,65395,29109,7865,7043
95254,463,54,151298,64601,188,275
95255,2162,51.1,39308,20456,1062,1100
95257,396,55.6,46111,24318,152,244
95258,3874,42.6,67386,32480,2124,1750
95301,37593,32.5,48103,20895,19286,18307
95303,1085,29.5,53750,21457,552,533
95304,17314,35.2,79029,25464,10402,6912
95305,78,41.5,-666666666,14076,30,48
95306,918,54.8,57679,24913,445,473
95307,43160,31,47691,19311,21243,21917
95310,1648,56.3,48929,25775,840,808
95311,2182,52.9,33649,21210,1057,1125
95312,251,34.8,51750,17976,134,117
95313,1012,36.5,30811,15498,545,467
95314,0,-666666666,-666666666,-666666666,0,0
95315,12168,30.5,46010,15282,5989,6179
95316,6820,38.7,70269,29058,3124,3696
95317,972,27.8,34783,19457,585,387
95318,549,50.4,100744,41845,257,292
95319,1490,34.2,24469,11966,698,792
95320,13000,38.8,55688,25597,6642,6358
95321,3401,55.6,47321,27653,1748,1653
95322,9042,31.2,35462,20675,4929,4113
95323,1182,37.9,49896,21457,626,556
95324,7546,38.6,49485,24638,3889,3657
95325,62,41.5,-666666666,31492,49,13
95326,8922,34.4,50254,25494,4210,4712
95327,9306,40.3,43042,17100,6164,3142
95328,4726,25.7,35042,11164,2389,2337
95329,2646,50.2,62371,31624,1300,1346
95330,16889,31.1,60887,18494,8240,8649
95333,3108,33.7,40274,18190,1556,1552
95334,16057,27.2,48462,16120,8091,7966
95335,623,54.3,32951,29921,293,330
95336,45015,34.2,57317,22521,22181,22834
95337,31302,32.3,64813,25465,15234,16068
95338,11471,50.4,49780,26052,5676,5795
95340,33512,33.4,47779,24846,15685,17827
95341,33713,24.8,33046,11893,17685,16028
95345,344,43.7,41583,37988,167,177
95346,1191,60.8,50983,23508,647,544
95348,30838,28.4,40864,18099,15008,15830
95350,50260,37.2,39195,22257,24173,26087
95351,47534,29.3,31551,12954,23786,23748
95354,24856,30.9,36285,18535,12233,12623
95355,59111,34.9,55049,25854,27686,31425
95356,31134,38.1,62050,31156,14925,16209
95357,11195,36.2,55379,22316,5572,5623
95358,31639,30.4,48183,17488,16394,15245
95360,11660,28.9,42909,15994,5990,5670
95361,32374,37.3,60972,27707,15883,16491
95363,26426,31.3,53426,20058,13924,12502
95364,0,-666666666,-666666666,-666666666,0,0
95365,5041,26.1,32500,12536,2696,2345
95366,16651,37,71560,33496,8243,8408
95367,23428,30.9,57404,20211,12054,11374
95368,14656,32.3,70875,23776,7570,7086
95369,1094,29.7,49500,21661,522,572
95370,28021,48.2,48583,28359,13889,14132
95372,1614,40.1,71250,30292,781,833
95374,1778,30.7,37391,16515,1084,694
95375,142,74.1,-666666666,15195,59,83
95376,49442,33.5,63374,24868,25659,23783
95377,31597,31.3,98072,29450,15855,15742
95379,3782,47.8,50081,23286,1816,1966
95380,41109,32.1,40564,18743,20275,20834
95382,36860,35.3,65412,27825,18644,18216
95383,3440,50.2,50368,29668,1759,1681
95385,347,30.3,38060,21566,150,197
95386,9794,33.7,52560,17996,5148,4646
95387,943,26.4,43480,11769,459,484
95388,14274,27.7,40842,15317,7409,6865
95389,1236,35.9,36875,24636,831,405
95391,11996,32.6,99764,29030,5794,6202
95401,36646,35.7,52830,25081,18054,18592
95403,44914,37.5,60394,30809,22846,22068
95404,39988,39.4,66366,36603,20093,19895
95405,21168,44.2,71163,36593,10387,10781
95407,40741,31.2,53729,20183,20887,19854
95409,26055,49,66567,37927,12259,13796
95410,884,52.9,31760,21201,379,505
95412,322,36.5,51667,21457,167,155
95415,1657,37.8,35871,16879,969,688
95417,197,60.6,71321,37477,81,116
95420,358,34.4,50074,21599,176,182
95421,1490,54.1,57917,37389,765,725
95422,15427,41.6,25460,16552,7761,7666
95423,3234,49.2,28354,18779,1872,1362
95425,10628,42.9,57379,28573,5058,5570
95426,1895,45.2,61944,24961,992,903
95427,201,60.6,26071,25863,124,77
95428,2561,37,27339,12559,1284,1277
95429,84,68.2,52159,31507,57,27
95430,0,-666666666,-666666666,-666666666,0,0
95431,525,43,-666666666,6398,318,207
95432,375,60.3,34044,19117,150,225
95435,322,30.1,-666666666,22384,181,141
95436,5092,49.2,47455,29691,2720,2372
95437,14527,45.3,41496,25638,7478,7049
95439,791,45.5,50139,24672,389,402
95441,2226,43.6,60357,29076,1230,996
95442,3475,52.3,57065,47237,1730,1745
95443,370,25.3,31848,10180,200,170
95444,660,44,73092,27426,252,408
95445,1709,53.9,37389,24843,893,816
95446,4598,48.8,39258,31969,2424,2174
95448,16910,41.8,61952,34413,8274,8636
95449,1571,39.8,40563,19488,876,695
95450,224,54.5,51250,42940,113,111
95451,12248,44.7,47603,22361,5991,6257
95452,1223,52.1,65223,57308,591,632
95453,10701,46.5,43136,26677,5346,5355
95454,2279,45.2,34755,20090,1191,1088
95456,725,62.6,38689,24740,217,508
95457,3292,46.4,46277,24849,1721,1571
95458,3126,41,25458,13517,1511,1615
95459,543,42.6,42426,24781,262,281
95460,2361,61,51693,36015,1080,1281
95461,3439,52,57726,29291,1796,1643
95462,1267,50.8,37137,25931,578,689
95463,0,-666666666,-666666666,-666666666,0,0
95464,2426,48.3,26336,16836,1025,1401
95465,2274,49.6,76439,46904,1114,1160
95466,1192,27.9,48365,17632,758,434
95467,5410,37.8,63281,25446,2709,2701
95468,1177,43.2,44122,21693,629,548
95469,1906,35.9,52902,24780,1014,892
95470,6236,42.9,62090,25239,3177,3059
95471,453,28,39299,16742,200,253
95472,29381,50.3,68223,40149,14467,14914
95476,38800,44.9,58785,40040,18887,19913
95482,33538,36,47698,22605,16635,16903
95485,2044,51.7,29741,18813,1125,919
95486,42,25.6,-666666666,22938,14,28
95488,267,52.7,53333,32926,133,134
95490,12158,46.9,38394,22551,5750,6408
95492,29552,37.8,80327,32004,14359,15193
95493,291,62,55104,27732,119,172
95494,219,28.9,47361,25649,107,112
95497,869,68.8,59667,50452,403,466
95501,23704,37,37600,21122,12107,11597
95503,24899,41.6,47537,26536,12051,12848
95511,398,38.4,11955,8705,279,119
95514,191,60.4,20625,8859,68,123
95519,19055,37.7,48914,25556,9581,9474
95521,20319,27.5,34046,21029,10115,10204
95524,1964,42.8,62557,32834,993,971
95525,1751,39,49934,27874,893,858
95526,273,57.9,20083,18129,118,155
95527,491,57.2,33167,23045,254,237
95528,1207,34.9,41597,20261,551,656
95531,24687,37.9,39486,19046,13993,10694
95536,3156,45,45188,32709,1602,1554
95537,71,50.4,-666666666,29089,43,28
95540,12877,38.7,40751,21707,6304,6573
95542,2252,35.9,43021,21262,1138,1114
95543,549,54.5,29038,18947,202,347
95545,92,38.3,49167,17604,63,29
95546,3476,28.9,26786,13777,1647,1829
95547,1443,40.8,58250,27494,734,709
95548,1398,40.9,27243,14804,846,552
95549,745,51.7,52222,27874,328,417
95550,272,36.4,65417,19382,177,95
95551,1944,40.4,45417,25525,1089,855
95552,554,53.6,31688,20335,266,288
95553,1381,28.4,37993,15808,706,675
95554,455,34.5,31107,17965,209,246
95555,360,49,32750,27557,188,172
95556,637,41.3,49833,20174,430,207
95558,353,51.9,36538,30002,217,136
95559,113,61.7,23059,20747,27,86
95560,1145,52.5,27635,18750,594,551
95562,3409,40.4,42325,25347,1617,1792
95563,679,55.1,36696,23701,325,354
95564,454,30.7,48571,27118,280,174
95565,1064,28.5,52853,26282,505,559
95567,1723,47.1,43125,22944,692,1031
95568,93,53.3,53333,22566,32,61
95569,308,54.6,37727,16503,211,97
95570,2085,49.4,47417,28383,1084,1001
95571,133,55,-666666666,22795,90,43
95573,1443,56.4,31530,19398,750,693
95585,443,40.8,27083,20329,253,190
95587,126,66.5,112083,59971,66,60
95589,1198,45.5,50188,32922,658,540
95595,128,58,29318,19865,73,55
95601,139,54.5,19688,30815,75,64
95602,18049,49.6,64329,32799,8955,9094
95603,28054,46.6,57779,32770,14144,13910
95604,44,51,-666666666,69989,21,23
95605,14160,30.4,38791,17660,7003,7157
95606,98,61.1,178295,67342,48,50
95607,371,56.6,77697,37165,226,145
95608,60255,43.4,54322,34695,29122,31133
95610,43333,36.4,50928,25334,21385,21948
95612,968,53.3,58147,34259,456,512
95614,4341,41.1,92721,35831,2155,2186
95615,999,41.4,74583,31763,459,540
95616,47995,23,44741,27145,22447,25548
95618,27262,29.5,82313,38314,13941,13321
95619,4893,40.1,57340,24958,2377,2516
95620,20845,34.6,71261,27791,10191,10654
95621,41573,37.4,53134,24521,19347,22226
95623,3913,47.6,62321,31659,1894,2019
95624,62335,34.6,77652,29126,30750,31585
95625,188,30.4,75114,16673,70,118
95626,5979,37,58333,21282,2847,3132
95627,3171,33,58092,23444,1450,1721
95628,40921,44.2,73720,38075,19923,20998
95629,949,56.2,41181,19674,469,480
95630,72462,37.7,98547,37815,39804,32658
95631,5874,49.2,62976,29951,2868,3006
95632,29892,34.5,59731,23167,14293,15599
95633,3441,46.2,65603,32408,1752,1689
95634,3080,48.2,56528,25375,1557,1523
95635,921,52.9,43542,28278,529,392
95636,937,37.3,50000,19335,513,424
95637,622,27.2,72778,20445,240,382
95638,1984,50.8,88188,38935,1026,958
95639,299,49,75870,22113,81,218
95640,10825,42.2,58309,17776,7375,3450
95641,1590,54.4,41618,25534,781,809
95642,6705,45.4,44811,26675,3248,3457
95645,1962,32.9,44954,21246,1038,924
95646,66,20.5,-666666666,8367,22,44
95648,48243,41.8,71713,32209,23223,25020
95650,11741,44.6,79743,41826,5630,6111
95651,451,48,55446,37343,175,276
95652,836,24.4,29583,13727,480,356
95653,481,43.2,42083,17677,230,251
95655,4802,32.8,80865,28611,2308,2494
95658,6522,51.1,64821,34139,3155,3367
95659,760,38.4,42109,30989,366,394
95660,32835,31.3,41036,16032,16522,16313
95661,30269,42.1,69703,36077,14706,15563
95662,31411,41.9,64991,31186,15386,16025
95663,2332,45.4,125303,53592,1099,1233
95664,1095,47.6,89141,40019,569,526
95665,4240,53.5,46345,33686,2119,2121
95666,5525,58.5,53391,29620,2544,2981
95667,35924,48.9,57468,30870,17489,18435
95668,844,45.7,72422,42614,496,348
95669,2864,48.6,67770,35411,1421,1443
95670,53259,36.1,54915,28377,26152,27107
95672,5273,49,93209,38148,2642,2631
95673,15430,36.4,53429,21943,7545,7885
95674,739,43.2,78929,40877,374,365
95675,405,30.7,32470,13666,215,190
95677,22675,38.8,68160,33968,10851,11824
95678,42606,32.7,60513,29453,20578,22028
95679,29,-666666666,-666666666,,8,21
95680,245,15.6,-666666666,5059,133,112
95681,992,44.7,73229,26134,569,423
95682,29590,43.7,77718,35933,14348,15242
95683,6354,51.5,96165,49089,3059,3295
95684,3069,50.9,53148,38750,1521,1548
95685,4368,53.9,59239,38362,2025,2343
95686,1020,35.6,30491,16311,490,530
95687,66129,38,73583,28137,36812,29317
95688,34599,38.4,79452,35759,17390,17209
95689,1151,67.1,78352,37336,559,592
95690,2015,46.1,61150,31464,978,1037
95691,35485,33.9,63559,27489,17580,17905
95692,4992,33.4,61627,23137,2437,2555
95693,5640,48.3,76392,34285,2696,2944
95694,10008,40.8,55163,27989,4769,5239
95695,37686,37.8,51158,27272,18432,19254
95697,307,36.4,60469,24463,188,119
95698,177,51.1,47857,25273,104,73
95699,267,35.7,73555,22419,199,68
95701,759,50.3,55682,32011,388,371
95703,1055,45,75217,35190,480,575
95709,4942,50.5,68628,37593,2483,2459
95713,9645,48.8,60025,29193,4916,4729
95714,271,62.4,52679,35718,144,127
95715,88,49.9,40313,30732,40,48
95717,188,60.5,38375,24738,98,90
95720,67,57.2,55938,39618,35,32
95721,14,-666666666,-666666666,,14,0
95722,4583,51.6,69231,37655,2240,2343
95724,0,-666666666,-666666666,-666666666,0,0
95726,8902,47.4,55526,27966,4330,4572
95728,495,49.3,42574,30272,237,258
95735,31,36.4,33750,12452,18,13
95736,278,21.5,43375,13085,142,136
95742,8873,31.5,96278,33493,4547,4326
95746,24012,44.7,127736,54466,12006,12006
95747,53452,37.7,86595,35122,25175,28277
95757,42752,32.8,84297,26032,22085,20667
95758,61155,33.7,70616,28949,29233,31922
95762,40829,40.7,119382,47519,21055,19774
95765,35914,34.8,84417,34305,17583,18331
95776,22083,30.6,61599,25568,11006,11077
95811,7370,32.5,36421,30333,3830,3540
95814,9802,35.5,34085,28379,6067,3735
95815,25627,31.7,31274,16320,12644,12983
95816,16624,35.3,49953,40756,8332,8292
95817,14377,31.4,34990,21132,6574,7803
95818,19960,39.4,57500,43653,9304,10656
95819,17705,38.6,81076,44420,7874,9831
95820,33967,34.1,39295,21094,16002,17965
95821,33190,39.6,38750,24557,16056,17134
95822,43024,37.8,43624,21383,19932,23092
95823,74154,30.1,37931,16192,35264,38890
95824,29344,30.7,29771,12364,15218,14126
95825,31505,31.8,37605,25381,14305,17200
95826,37215,33.9,53432,25498,18573,18642
95827,20120,36.2,51981,23557,9298,10822
95828,60993,31.9,46820,17508,30673,30320
95829,25565,34,74550,26665,12604,12961
95830,725,39.7,73333,30392,382,343
95831,41224,45.3,68461,38128,19353,21871
95832,12051,26.2,39735,13241,5615,6436
95833,38264,31.1,56280,26545,18126,20138
95834,24201,29.8,55177,26499,12267,11934
95835,38606,33.6,79528,30310,19925,18681
95837,240,47,42500,38723,120,120
95838,35584,28.9,38271,14666,17787,17797
95841,18612,33.3,36967,20499,8608,10004
95842,31689,31.2,45537,19626,15234,16455
95843,46775,32.5,65779,24008,22539,24236
95864,21554,46.8,79778,50085,10400,11154
95901,32569,31.9,40260,18114,16327,16242
95903,1981,22.4,40000,17778,1246,735
95910,135,59.6,22000,13791,29,106
95912,4814,30.6,53333,19165,2326,2488
95914,629,51.2,45875,20824,331,298
95915,63,53,10625,7248,27,36
95916,1244,52.5,36875,21421,731,513
95917,3336,34.7,43915,20039,1803,1533
95918,1549,54.8,76583,41427,857,692
95919,1305,41.3,45914,19030,605,700
95920,449,26.7,66250,17659,213,236
95922,637,55.7,24700,18918,328,309
95923,33,81.4,45875,38642,17,16
95925,47,42.5,-666666666,10072,47,0
95926,37747,28.1,39216,23678,18593,19154
95928,36194,30.9,45224,25110,17307,18887
95930,0,-666666666,-666666666,-666666666,0,0
95932,7776,36.7,50531,24490,4132,3644
95934,317,28.7,31250,10283,126,191
95935,366,55.8,56771,27968,240,126
95936,250,35.7,50917,20367,166,84
95937,1320,35.9,56705,22218,648,672
95938,4015,41.8,61849,34335,2046,1969
95939,488,44.2,29861,13580,253,235
95941,589,41.3,51417,18741,291,298
95942,1362,55.3,41323,55913,767,595
95943,894,33.2,48906,32427,435,459
95944,0,-666666666,-666666666,-666666666,0,0
95945,24762,49.7,42828,28017,11927,12835
95946,9874,52.8,60750,32452,4650,5224
95947,1795,50.5,31687,28395,878,917
95948,10289,34.5,44034,19950,5222,5067
95949,19999,51.5,62224,31453,9595,10404
95950,664,32.6,58125,20037,356,308
95951,2671,28.2,39150,14624,1383,1288
95953,10575,34.1,45414,18495,4959,5616
95954,12464,46.4,39932,21365,6380,6084
95955,1251,32.3,43977,24361,548,703
95956,346,46.8,49444,34393,198,148
95957,875,44.4,56875,31110,457,418
95959,17668,50.7,63132,35125,9006,8662
95960,989,35.9,29773,14570,457,532
95961,26753,29.9,46144,17756,13569,13184
95962,1527,49.1,64671,35347,841,686
95963,15214,36,41738,19380,7641,7573
95965,20130,35.9,36080,17226,10028,10102
95966,30983,43.5,42555,21466,15583,15400
95968,1494,33.9,46618,16119,682,812
95969,27298,51.1,41179,24761,13276,14022
95970,525,46,60658,32542,297,228
95971,5639,46.6,50912,27042,2658,2981
95973,33046,34.5,55426,28349,16352,16694
95974,0,-666666666,-666666666,-666666666,0,0
95975,2005,49.7,49688,29482,1040,965
95977,1971,37.2,50820,23059,1141,830
95978,24,-666666666,-666666666,,24,0
95979,631,55.7,42167,23301,346,285
95981,169,30.7,2499,7948,108,61
95982,3154,36.9,63277,31755,1571,1583
95983,557,44,51792,29287,312,245
95984,21,-666666666,-666666666,,10,11
95986,36,-666666666,-666666666,,0,36
95987,5931,30.7,53596,18679,3159,2772
95988,8937,41.9,47184,28221,4510,4427
95991,41309,31.2,42589,19409,20350,20959
95993,35628,38.8,64011,28314,18017,17611
96001,33702,41.8,47988,26680,16671,17031
96002,33730,37.7,44017,22140,16428,17302
96003,44405,39.9,45722,24128,21741,22664
96006,532,52.4,57321,24430,261,271
96007,22785,41.5,38258,19235,11081,11704
96008,983,50.7,51500,24465,599,384
96009,443,51.6,69318,27824,227,216
96010,214,47.5,29773,16392,148,66
96011,134,61,32083,17652,86,48
96013,3626,47.7,37629,20546,1680,1946
96014,190,48.7,40000,32051,105,85
96015,704,43.4,23167,11817,359,345
96016,687,46.1,58241,22376,343,344
96017,212,54.2,31042,15650,111,101
96019,10094,40.3,39111,19811,4877,5217
96020,2211,55.2,43750,29112,1183,1028
96021,16352,33.5,41099,16726,8265,8087
96022,17023,40.4,53663,25196,8233,8790
96023,1193,30.8,29792,16091,608,585
96024,1204,52,41776,24779,621,583
96025,2179,51,32000,21614,1093,1086
96027,2379,51.2,43325,23761,1217,1162
96028,1637,44.2,39212,21371,677,960
96029,131,49.6,59000,22447,72,59
96031,204,47.9,28125,27356,83,121
96032,2223,42.1,45493,20571,1227,996
96033,463,51.7,29135,18486,266,197
96034,338,57.7,35250,21369,199,139
96035,3253,42.3,42150,21076,1646,1607
96037,215,66.1,14881,12216,99,116
96038,549,55.1,39792,22714,215,334
96039,1285,45.9,28750,17240,615,670
96040,219,52.1,49408,26561,116,103
96041,2993,38.8,34844,20554,1721,1272
96044,946,50.3,36645,18410,466,480
96046,200,56.6,27031,14767,107,93
96047,779,47.1,28646,22077,421,358
96048,1053,46.7,42250,19536,479,574
96049,89,21.9,12054,3422,48,41
96050,411,57.9,28250,20299,216,195
96051,1120,52.9,46304,28918,570,550
96052,1580,52.1,33438,23654,895,685
96054,250,57,16944,14990,133,117
96055,4067,44.2,35750,19529,1963,2104
96056,1496,57.3,46184,28254,721,775
96057,1475,53.1,41445,22063,758,717
96058,848,45.8,30000,16394,451,397
96059,783,57.3,46667,23030,410,373
96061,27,51.4,69688,36800,12,15
96062,1123,45.3,59271,26536,590,533
96063,212,48.8,44375,30491,113,99
96064,4482,47.1,41940,23283,2186,2296
96065,338,53.3,35156,19955,200,138
96067,7313,51.7,44692,28046,3654,3659
96068,183,39.7,34375,13322,135,48
96069,799,53.1,35813,22487,409,390
96071,85,68.6,38516,16555,43,42
96073,4664,48.8,79188,38605,2420,2244
96074,226,34.6,39271,7689,174,52
96075,345,42.8,19306,13417,217,128
96076,177,64.1,31316,14154,87,90
96080,28084,41.2,39934,20777,13858,14226
96084,593,55,31897,23506,237,356
96085,46,65.3,29519,24554,30,16
96086,368,54,32688,20023,203,165
96087,576,52.8,31488,27235,345,231
96088,4317,56,46045,25517,2366,1951
96090,390,37.8,39583,19452,187,203
96091,694,60.3,36806,25840,403,291
96092,242,53.1,61389,33824,124,118
96093,3755,43.7,40172,25510,1639,2116
96094,6422,42.9,42857,22582,3240,3182
96096,842,51.1,56250,27263,443,399
96097,9932,42.7,29443,20561,4839,5093
96101,4915,46.8,37148,22327,2403,2512
96103,1200,55.6,58090,42839,573,627
96104,675,58.9,34779,28041,341,334
96105,406,31.5,43208,14953,138,268
96106,224,63.4,76250,45713,117,107
96107,1329,37.4,56719,26427,754,575
96108,16,-666666666,-666666666,,8,8
96109,783,56.6,34313,23826,359,424
96110,128,56.2,23750,37426,61,67
96111,60,60.1,56146,36052,23,37
96112,254,37.5,24545,15954,118,136
96113,2058,33.5,45833,11652,1705,353
96114,3260,43.7,71786,31030,1762,1498
96115,194,58.2,38482,20759,88,106
96116,214,54.8,26250,16036,115,99
96117,227,40.9,60375,32388,111,116
96118,1592,46.1,42264,21407,757,835
96119,74,64.5,45313,20191,34,40
96120,1045,46.7,58611,26762,657,388
96121,262,56.8,72143,41061,142,120
96122,4697,40.9,40313,23560,2359,2338
96123,6,58,-666666666,25650,3,3
96124,351,54.8,30893,26257,164,187
96125,340,58.5,120781,60302,123,217
96126,105,39.5,-666666666,9467,76,29
96128,647,44.1,67986,32750,389,258
96129,133,58.2,48977,85774,64,69
96130,21963,35,54372,18621,14799,7164
96132,64,55.4,24167,12591,38,26
96133,108,41.6,28257,15925,29,79
96134,2869,32.5,34934,17070,1517,1352
96135,0,-666666666,-666666666,-666666666,0,0
96136,157,22,81607,32294,77,80
96137,3826,54.3,46463,34771,2160,1666
96140,1116,51.2,71081,36534,556,560
96141,761,50.5,70670,51466,408,353
96142,669,33.1,40913,24828,279,390
96143,4225,36.2,40683,21606,2575,1650
96145,2997,42.1,66628,34442,1618,1379
96146,853,46.3,52333,31355,410,443
96148,786,30,58478,34848,423,363
96150,28686,40,46859,25479,14866,13820
96155,0,-666666666,-666666666,-666666666,0,0
96161,18113,38.2,67750,38015,9442,8671
96701,39324,42.7,83255,35056,20234,19090
96703,2491,38.8,56912,21699,1269,1222
96704,7117,42.5,49847,24567,3472,3645
96705,2611,37.4,69777,22616,1327,1284
96706,65260,32.5,86093,26598,32982,32278
96707,39967,34.2,96611,31511,20127,19840
96708,10598,39.6,58202,31965,5043,5555
96710,572,34.6,64522,25926,274,298
96712,8192,35,74356,32746,4328,3864
96713,1735,38.4,54250,21825,975,760
96714,886,49.8,42530,25422,455,431
96716,3007,42.2,73000,25604,1446,1561
96717,5232,30.9,61094,21485,2456,2776
96719,2847,33.2,60781,15651,1412,1435
96720,47109,41,52822,25710,23361,23748
96722,2633,42.4,50893,27897,1307,1326
96725,3995,40.4,65338,27184,2108,1887
96726,825,45.4,48452,23175,355,470
96727,5625,36.6,57717,21976,2882,2743
96728,554,52,53750,27804,302,252
96729,1249,35.9,43542,18805,619,630
96730,1200,38.1,70216,33821,587,613
96731,3034,32.6,55938,19242,1405,1629
96732,25065,39.1,62981,23851,11823,13242
96734,53068,34.7,89016,36481,27118,25950
96737,3766,46.2,43173,20762,1847,1919
96738,6785,41.3,73285,32312,3625,3160
96740,35818,41.8,61875,30333,17791,18027
96741,5601,38.1,54393,24839,2857,2744
96742,71,53.8,59375,45515,34,37
96743,12113,37.4,58392,28123,5936,6177
96744,53818,41.8,85608,33689,26212,27606
96746,18195,43.9,61647,28611,9241,8954
96747,918,36.3,70313,17363,447,471
96748,4232,38.9,42727,23677,2115,2117
96749,16095,37.7,40201,19678,8285,7810
96750,3817,41.5,51518,22351,1982,1835
96751,130,42.2,36964,14863,40,90
96752,3234,43.6,58824,24235,1640,1594
96753,28182,40,60458,34077,14129,14053
96754,4198,40.9,60804,25709,2159,2039
96755,2803,45.4,49125,25767,1442,1361
96756,5450,45.5,61595,31665,2485,2965
96757,780,34.9,43611,16867,389,391
96759,689,24,48346,11512,403,286
96760,2424,43.7,35577,18653,1226,1198
96761,20826,39.9,64603,32292,10725,10101
96762,5749,22.9,78047,16211,2749,3000
96763,3315,37.4,58472,23511,1816,1499
96764,743,36.4,65625,27441,367,376
96765,517,48.9,57292,30461,236,281
96766,15780,38.8,66083,26097,8043,7737
96768,17353,42.3,71069,30337,8800,8553
96769,364,50.4,73125,29606,215,149
96770,771,35.8,42125,26099,371,400
96771,6576,40.6,28771,17714,3136,3440
96772,2298,47.3,29250,23329,1173,1125
96773,180,53.2,98516,26738,57,123
96774,376,40.5,46927,15203,255,121
96776,1646,42.1,55351,24665,902,744
96777,1442,45,41406,17819,772,670
96778,14056,40.7,31422,16410,6918,7138
96779,2805,41.6,69868,33133,1510,1295
96780,799,31.9,67054,21743,409,390
96781,1917,39.9,42697,19201,1014,903
96782,41139,38.7,78848,28598,21905,19234
96783,2149,40.4,31705,17613,1140,1009
96785,2597,49.2,43938,23723,1271,1326
96786,43264,27.2,53706,21158,22591,20673
96789,54731,38,92309,35922,28056,26675
96790,8549,46.6,72719,35968,4160,4389
96791,6974,39.3,72995,29127,3415,3559
96792,46812,30.5,53059,17075,23010,23802
96793,31125,37.8,75056,27413,16190,14935
96795,10519,34.1,68563,21849,5051,5468
96796,1857,42,68125,26108,828,1029
96797,74752,36.9,81897,26542,37220,37532
96813,22118,42.5,60665,37363,11416,10702
96814,18195,45.1,54085,38229,9169,9026
96815,29784,43.7,49971,35618,15036,14748
96816,51209,44.2,75448,34705,25191,26018
96817,55812,44.9,52532,26985,27254,28558
96818,51522,31.3,70850,26894,25339,26183
96819,52416,35.8,74763,21345,26490,25926
96821,19652,48,110842,49772,9734,9918
96822,45292,39.1,63379,35481,22281,23011
96825,30142,45.8,108425,44855,14848,15294
96826,30698,40.1,42460,29375,14598,16100
96850,0,-666666666,-666666666,-666666666,0,0
96853,308,22.1,-666666666,23084,266,42
96857,2691,22.3,-666666666,23906,2532,159
96859,0,-666666666,-666666666,-666666666,0,0
96860,1091,22.5,-666666666,27058,943,148
96863,24,-666666666,-666666666,,24,0
97001,306,30.6,56538,14083,127,179
97002,5556,44.1,65150,29642,2888,2668
97004,4735,45.5,77829,31950,2351,2384
97005,24655,33,39677,21693,12771,11884
97006,65482,31.8,60407,27515,32365,33117
97007,69469,35.5,68941,31486,33788,35681
97008,29684,38.6,52956,28135,14408,15276
97009,7423,49.3,60082,31825,3447,3976
97011,854,44.1,53077,29250,524,330
97013,23269,35.9,57943,24249,11157,12112
97014,1129,40.7,42500,19169,592,537
97015,20872,32.8,58954,27314,9980,10892
97016,6714,45.6,57153,25154,3412,3302
97017,2462,46.3,63047,26486,1328,1134
97018,2276,42.1,67200,26042,1106,1170
97019,3573,43.9,60208,24681,1775,1798
97020,750,43.1,57813,25541,380,370
97021,843,40.9,48750,24256,416,427
97022,3208,43.9,66927,24343,1623,1585
97023,10759,41.8,60505,24427,5580,5179
97024,9914,37.7,51182,25738,4734,5180
97026,3917,34.9,51467,18008,1991,1926
97027,12434,41.1,54796,26579,6042,6392
97028,139,59.7,250001,139926,71,68
97029,295,46.5,65833,26768,144,151
97030,37723,34.7,43071,21664,18491,19232
97031,18762,37.2,56884,25425,9277,9485
97032,4749,35.2,47554,18535,2392,2357
97033,72,60.9,37000,38119,30,42
97034,18962,47.5,99492,68034,9194,9768
97035,23925,42.1,72114,45633,11054,12871
97037,887,50.6,41515,21021,428,459
97038,15085,37.3,51831,23935,7267,7818
97039,540,36.9,38000,23458,272,268
97040,1218,43.2,60536,27238,534,684
97041,2603,42.1,64677,26252,1296,1307
97042,3246,47.1,61279,24874,1634,1612
97045,51040,40,64023,29103,26164,24876
97048,6405,46.3,48886,24227,3192,3213
97049,1696,50.8,57821,30576,835,861
97050,225,50.9,23750,15033,126,99
97051,15744,35.4,52852,23119,7816,7928
97053,2955,49.7,64331,30478,1508,1447
97054,1393,45.2,68500,28971,697,696
97055,16506,39.9,61733,27809,7983,8523
97056,11572,42.7,55166,31724,5722,5850
97057,7,70.3,-666666666,7943,4,3
97058,20274,41.2,43435,23186,10225,10049
97060,21530,33.2,59422,24780,10643,10887
97062,27625,35.9,63314,33260,13682,13943
97063,880,59.1,42569,25164,438,442
97064,3430,47.1,57143,25224,1747,1683
97065,733,49,49667,25450,348,385
97067,1873,47.1,68043,41875,931,942
97068,28747,43.9,86042,42670,14340,14407
97070,21921,36.5,58662,31753,10295,11626
97071,28527,31.9,43331,17355,14576,13951
97080,40718,35.7,62886,25784,19807,20911
97086,26425,38.7,72257,32987,13038,13387
97089,11998,45.9,87052,34766,6115,5883
97101,3903,39.3,56425,24636,2053,1850
97102,234,63.1,32438,20729,116,118
97103,17085,43.7,46871,26069,8466,8619
97106,4133,40.8,82232,30100,1985,2148
97107,1567,48.1,50100,23166,819,748
97108,409,52.6,55257,30179,231,178
97109,825,47.5,64365,31106,398,427
97110,1305,43.2,41625,37496,642,663
97111,3471,41.1,65000,23200,1847,1624
97112,2000,40.1,47000,20886,988,1012
97113,14262,32.5,53502,19896,7190,7072
97114,4935,37.5,59120,23177,2362,2573
97115,4073,38.9,69500,29374,1947,2126
97116,24816,36.2,49663,23408,11751,13065
97117,412,57.1,68500,28589,211,201
97118,736,54.4,38889,23617,402,334
97119,4377,43.2,61667,28037,2147,2230
97121,1498,36.7,35427,19942,729,769
97122,616,48.2,55694,22226,371,245
97123,45035,33.3,64599,24617,22070,22965
97124,48406,34,69724,32016,24167,24239
97125,204,46.1,75278,48257,119,85
97127,3733,33.9,58117,18227,1847,1886
97128,36250,36.4,44541,22340,17484,18766
97130,457,49.6,43462,25299,238,219
97131,2719,44.7,43254,22222,1549,1170
97132,28687,36,63318,26189,14246,14441
97133,4558,38.9,73750,35933,2301,2257
97134,106,40.6,58125,43330,86,20
97135,696,67.6,28269,22058,358,338
97136,1545,60,37436,22015,750,795
97137,1404,36.8,63036,24377,744,660
97138,9996,45.2,43750,24941,5015,4981
97140,23697,36.8,82377,34775,11890,11807
97141,13675,43.5,44878,22188,6666,7009
97144,186,49.9,11250,16637,114,72
97145,248,63.6,32434,43622,85,163
97146,5795,40.1,41192,23133,2687,3108
97147,358,56.4,31458,18781,165,193
97148,3096,51.6,63494,46451,1654,1442
97149,361,62.1,50347,29185,171,190
97201,15133,30.5,40380,52213,7534,7599
97202,39229,35.6,55212,34123,18819,20410
97203,31895,31.8,42585,21342,15305,16590
97204,1387,41.1,13350,9537,1153,234
97205,6736,40.4,25938,38706,3867,2869
97206,48384,37,50694,24784,24016,24368
97208,0,-666666666,-666666666,-666666666,0,0
97209,14698,36.3,39258,51124,8201,6497
97210,11422,36.8,66807,57493,5444,5978
97211,32376,34.9,61962,29956,16343,16033
97212,24433,39.9,81930,45848,11724,12709
97213,30186,38,58469,33436,14754,15432
97214,24072,34.3,50917,36227,12237,11835
97215,16158,39.9,63514,37632,7712,8446
97216,16445,38.2,46097,21703,8061,8384
97217,31929,36.9,53972,28829,16377,15552
97218,15252,35.8,47099,22946,7705,7547
97219,39392,39.1,77756,43372,19188,20204
97220,28847,38,47303,23279,14587,14260
97221,12348,43.5,92024,54822,5951,6397
97222,35108,39.2,49095,25379,17384,17724
97223,46574,37.4,64519,33891,23349,23225
97224,31981,42.8,54567,33678,14824,17157
97225,25737,41.2,71746,44667,12767,12970
97227,4111,31.4,50129,28185,2017,2094
97229,59983,37.8,100063,44657,29838,30145
97230,40197,38.5,46385,22524,19891,20306
97231,4131,46.7,87281,49166,2339,1792
97232,11784,36.8,45066,39416,5683,6101
97233,39849,31.1,35970,16763,19477,20372
97236,37033,34.5,43517,20016,17970,19063
97239,15530,38.3,74834,52994,7524,8006
97266,33933,34.8,38914,17844,17041,16892
97267,31897,40.9,59329,28635,15325,16572
97301,55437,31.8,37006,16057,28807,26630
97302,37969,39.8,53114,29610,18364,19605
97303,38694,35,51289,23755,18717,19977
97304,28871,40.9,65377,29881,13667,15204
97305,38466,33.2,40385,18806,18976,19490
97306,27820,38.5,58730,31246,13085,14735
97317,24921,34.4,50263,20238,12939,11982
97321,24852,41.1,60271,27961,12194,12658
97322,34766,34.7,42451,19268,16788,17978
97324,1237,51.5,33625,20367,672,565
97325,6980,36.9,56587,22493,3433,3547
97326,953,55.3,41510,28461,485,468
97327,2784,45.9,51709,25310,1294,1490
97329,56,66.5,28625,32250,24,32
97330,42120,30.2,42955,26929,20995,21125
97331,2488,19.2,2499,4422,1322,1166
97333,20867,32,43811,27252,10459,10408
97338,20176,39.8,52863,23125,9943,10233
97341,2650,48.4,43333,25237,1221,1429
97342,168,59.4,43462,22510,62,106
97343,292,46.5,34375,35309,147,145
97344,1178,44.9,34438,15891,533,645
97345,319,52.5,14719,12453,153,166
97346,966,45.2,47628,21883,489,477
97347,1726,44.5,43188,20854,752,974
97348,1863,28.9,50551,16491,913,950
97350,161,54.8,38125,18334,103,58
97351,10118,27.5,45683,17905,5161,4957
97352,6094,38.8,47446,19985,3017,3077
97355,28234,41.2,46641,21555,14172,14062
97357,310,53.8,56417,25219,164,146
97358,2315,46.6,61734,27309,1222,1093
97360,2144,35.4,52054,21082,1083,1061
97361,11286,25.8,38868,19894,5357,5929
97362,4161,39.2,40799,19503,2145,2016
97364,846,43.9,42358,23859,358,488
97365,10863,44.4,45185,26779,5162,5701
97366,1301,58.8,53135,36010,595,706
97367,9358,47.1,36735,22246,4589,4769
97368,3349,50,48750,27307,1556,1793
97369,300,62.2,49821,21546,140,160
97370,7931,41.2,59040,28660,3996,3935
97371,721,53.7,56957,34292,371,350
97373,190,31.8,-666666666,7064,190,0
97374,5636,46.5,51324,22588,2788,2848
97375,1149,48.4,73616,25321,613,536
97376,1297,61,43866,27849,595,702
97377,1018,42.8,62288,25572,691,327
97378,8483,40.4,42892,17677,5094,3389
97380,2604,43.2,40510,21688,1314,1290
97381,15193,36.8,55217,23284,7254,7939
97383,9781,37.9,39919,19742,4937,4844
97384,0,-666666666,-666666666,-666666666,0,0
97385,3121,49.4,58125,28499,1410,1711
97386,14236,41.4,38601,19473,6949,7287
97388,876,63.1,40219,28092,452,424
97389,1576,36.5,46250,21717,841,735
97390,409,57.5,35708,19398,225,184
97391,5030,44.7,47628,22833,2585,2445
97392,5156,41.8,54932,27049,2468,2688
97394,4236,57.6,41055,26399,2178,2058
97396,2827,44.3,36848,18929,1315,1512
97401,40482,28.6,31080,23892,20399,20083
97402,51025,35.5,38414,21421,25389,25636
97403,12374,21.9,38053,20647,6056,6318
97404,33229,39.7,52574,24096,16456,16773
97405,44220,42.2,56250,33708,21725,22495
97406,108,65.1,26538,14551,72,36
97408,11654,46.3,56800,35843,5420,6234
97410,705,62.3,45592,30185,363,342
97411,7093,57.7,38515,25020,3592,3501
97412,527,51.8,32083,16490,297,230
97413,1063,42.6,29333,19315,512,551
97414,216,29.1,24157,14100,154,62
97415,14146,53.6,42045,24904,6672,7474
97416,925,42.2,43102,14899,455,470
97417,2577,43.9,37072,16912,1366,1211
97419,1336,53.3,49438,26857,699,637
97420,26761,42.6,34755,20553,13219,13542
97423,7112,48.3,42581,20873,3479,3633
97424,17111,44.7,38318,20503,8343,8768
97426,9661,37.2,50503,24931,4663,4998
97429,653,53.4,40750,20900,315,338
97430,256,59.8,26818,20795,127,129
97431,2450,47,54535,24583,1211,1239
97434,831,51.6,31607,17585,414,417
97435,2108,46.3,39792,18556,1149,959
97436,857,51.1,41538,23934,419,438
97437,2421,51.9,48555,23618,1123,1298
97438,1041,44.9,66367,26663,585,456
97439,14715,56.3,33969,23150,6972,7743
97441,202,53.5,51612,27898,59,143
97442,2159,47.5,44712,23463,1105,1054
97443,2404,35.8,49348,21843,1001,1403
97444,4711,52.9,41841,24339,2317,2394
97446,4862,40.2,52353,22957,2572,2290
97447,841,56,27350,13439,403,438
97448,12441,45,45625,22493,6403,6038
97449,1965,62,40417,20859,1051,914
97450,732,58.6,30500,17854,402,330
97451,401,50.1,57344,27441,223,178
97452,1466,45.8,50521,21463,702,764
97453,708,54,42279,24726,340,368
97454,1476,46.7,59327,23836,808,668
97455,2580,46.4,51750,26341,1266,1314
97456,3227,41.7,44688,22076,1558,1669
97457,9710,44.6,39728,19604,4720,4990
97458,4184,50,30711,27149,1923,2261
97459,14341,46.3,44319,24133,6965,7376
97461,559,51,51375,21219,240,319
97462,4074,50.7,39493,20230,2171,1903
97463,3736,55.9,43982,22049,1933,1803
97465,2618,54.6,29103,20292,1319,1299
97466,1142,51.4,32368,15687,573,569
97467,5308,50.1,34657,21653,2632,2676
97469,2566,47.4,42768,19547,1206,1360
97470,19972,42,38270,20885,9729,10243
97471,30300,47.7,45473,25945,15289,15011
97473,304,68,33750,20136,141,163
97476,46,83.1,16250,29000,33,13
97477,36962,36.2,37409,20286,17149,19813
97478,37934,37.9,49088,22171,18986,18948
97479,9314,44.3,37277,19431,4281,5033
97480,334,55.8,30208,19376,170,164
97481,471,58.7,43333,25354,237,234
97484,280,59.8,32625,17826,141,139
97486,566,55.5,57768,29346,305,261
97487,7884,39.5,47823,23456,3916,3968
97488,1051,42.7,47596,21905,560,491
97489,706,57.4,52969,26608,280,426
97490,464,48.6,40795,14806,227,237
97492,642,47.5,42321,20230,365,277
97493,258,63.8,26875,21881,131,127
97494,0,-666666666,-666666666,-666666666,0,0
97495,1157,61.5,35037,25236,578,579
97496,7353,40,34858,17298,3698,3655
97497,1952,48.9,46098,17822,1014,938
97498,2007,59.2,40231,23928,993,1014
97499,1922,54.6,35431,20890,934,988
97501,43209,34.6,36051,19023,21442,21767
97502,27993,41.8,49378,24282,13992,14001
97503,10890,36.2,48313,17855,5697,5193
97504,45144,43.2,49026,28015,21717,23427
97520,24689,45.8,46398,31529,11190,13499
97522,590,41.7,38456,16835,320,270
97523,6323,45.4,25663,15370,3222,3101
97524,13231,40,54354,24313,6495,6736
97525,4419,53.8,43265,22698,2276,2143
97526,35208,46.7,36465,22373,17083,18125
97527,33322,47.6,40129,22730,16025,17297
97530,7283,54.5,45828,29959,3523,3760
97531,212,60.9,32596,19404,100,112
97532,2343,44.7,42313,21507,1180,1163
97534,339,37.2,26538,15925,131,208
97535,5382,46.7,38953,21554,2623,2759
97536,1028,51,41607,21045,495,533
97537,7012,51.7,38407,22003,3623,3389
97538,1671,58.5,35962,19983,853,818
97539,3490,51,36607,22397,1540,1950
97540,8168,43.3,38557,23134,3920,4248
97541,897,59.3,26964,21229,387,510
97543,734,52.5,44375,21621,389,345
97544,2371,55.9,39242,21307,1172,1199
97601,22540,38.5,33902,21028,10930,11610
97603,29450,40.4,45456,22745,14468,14982
97604,90,29.2,-666666666,23771,54,36
97620,84,48.2,47083,23689,44,40
97621,203,74.3,34315,17677,119,84
97622,407,55.7,15972,24942,219,188
97623,2446,48.5,38472,17702,1226,1220
97624,2998,55.3,34750,18951,1541,1457
97625,224,46.4,27188,17241,115,109
97626,203,62.6,66378,34703,89,114
97627,827,57.3,43750,24455,395,432
97630,5142,48.6,39831,22837,2798,2344
97632,1363,34.6,45750,16627,716,647
97633,1416,36.3,40742,18448,853,563
97634,330,38.8,67344,18033,140,190
97635,464,42.1,49313,17061,250,214
97636,497,48.7,36000,34214,225,272
97637,87,45.1,32500,28223,62,25
97638,470,43.8,24938,19969,222,248
97639,497,59.8,23375,18992,289,208
97640,72,61.2,18750,30133,44,28
97641,1045,52.1,24244,16246,498,547
97701,58602,40.2,53444,31259,28483,30119
97702,42272,39.3,58157,28297,21287,20985
97707,5971,46.2,47585,33351,3215,2756
97710,180,42,33125,22367,99,81
97711,123,34.5,27188,12480,59,64
97712,65,4,-666666666,16197,39,26
97720,4106,49,38770,22251,2129,1977
97721,610,30.7,27321,11412,320,290
97722,88,54.4,49063,31005,46,42
97730,363,55.5,53393,30109,143,220
97731,506,42.7,38800,17856,362,144
97732,188,35.4,29583,11073,91,97
97733,678,55.8,57188,22751,372,306
97734,3091,35.5,42469,17819,1441,1650
97735,136,33.8,11484,19352,87,49
97736,175,47.2,63750,24383,82,93
97737,356,65.2,29803,32743,175,181
97738,1644,41.4,35846,20760,768,876
97739,11142,51.7,33927,19173,5830,5312
97741,11616,38.5,42222,22301,6153,5463
97750,366,55.4,37250,22929,180,186
97751,136,28,52222,22798,82,54
97752,43,55.8,-666666666,26426,35,8
97753,1969,52.9,71630,35535,990,979
97754,18512,45.7,35764,19298,9173,9339
97756,34639,37.9,42876,20780,16457,18182
97758,117,35.6,17222,14652,55,62
97759,6675,46.3,54913,28593,3421,3254
97760,6082,52.2,52877,32419,2994,3088
97761,4116,26.1,44157,12326,2088,2028
97801,21829,39.2,49576,22808,11287,10542
97810,794,49.3,67708,29673,395,399
97812,968,45.1,55076,27038,565,403
97813,1120,41.3,53250,23718,520,600
97814,12215,47,42854,24189,6215,6000
97817,39,50.8,11071,16305,14,25
97818,4010,27.3,50239,16984,2066,1944
97819,26,64.7,76250,36900,10,16
97820,789,58.4,39219,34411,407,382
97823,844,55.7,32375,24102,409,435
97824,1891,48.1,51628,28180,958,933
97825,269,59.1,35000,22971,129,140
97826,1016,37.3,52917,25532,457,559
97827,2380,44,45217,19382,1190,1190
97828,2978,53.8,43972,23536,1382,1596
97830,686,54.3,39196,25192,317,369
97833,950,44.5,44293,18526,452,498
97834,942,53.9,37143,21996,459,483
97835,444,34.9,51250,20828,206,238
97836,2030,45,38107,22437,990,1040
97837,94,41.5,50625,24294,47,47
97838,25598,33.1,51588,21897,13279,12319
97839,484,43.7,54375,27476,226,258
97840,173,42.6,97656,30589,105,68
97841,402,41.5,40804,21263,185,217
97842,176,57.9,26000,15676,107,69
97843,675,45.9,64375,29494,354,321
97844,3860,42.8,52210,22221,2079,1781
97845,2606,46.1,40071,24790,1315,1291
97846,1866,53,38628,24718,992,874
97848,233,40.5,39688,18173,122,111
97850,17095,36.8,40951,23033,8359,8736
97856,406,51,28125,23188,203,203
97857,576,41.8,53750,24014,283,293
97859,74,57.9,31181,17277,32,42
97862,12033,35.9,37625,17913,6035,5998
97864,253,57.2,26000,19014,134,119
97865,1224,52.3,36620,21897,595,629
97867,887,35.9,44464,16739,361,526
97868,1998,38.9,42891,20006,986,1012
97869,1331,43.1,32061,19854,612,719
97870,419,63.2,27228,20870,216,203
97873,131,57.3,26563,21537,67,64
97874,302,55.5,33958,22305,158,144
97875,2707,36,55478,22277,1315,1392
97876,914,52.5,52880,24943,483,431
97877,192,64.9,25000,20111,106,86
97880,201,48.3,25000,26143,129,72
97882,7404,32,46667,12722,4567,2837
97883,2380,41.5,40855,20275,1184,1196
97884,117,55.5,42250,20993,70,47
97885,1328,45.3,37600,20598,656,672
97886,1262,49.7,44079,24526,629,633
97901,610,52.3,50446,31659,287,323
97903,173,52,56000,20113,106,67
97904,196,53,36429,26629,105,91
97905,208,66.6,45491,23746,94,114
97906,253,48.9,44250,21830,119,134
97907,542,55.1,25893,14306,274,268
97908,70,61.6,26667,43136,32,38
97909,8,-666666666,-666666666,,4,4
97910,617,45.5,38438,20372,335,282
97911,60,51.5,30250,20988,32,28
97913,5678,31.9,44172,17699,2852,2826
97914,18726,36.2,31478,15086,10722,8004
97918,4569,36.8,36728,16799,2253,2316
97920,95,58.9,11410,5774,54,41
98001,33655,38.4,71746,28419,16920,16735
98002,33281,35.5,43568,21418,15699,17582
98003,45131,35.1,45894,23884,21997,23134
98004,30072,37.4,93521,66689,15011,15061
98005,17346,39.2,84774,47264,8792,8554
98006,36327,42.2,110290,50715,18081,18246
98007,24926,32.1,73162,38335,13137,11789
98008,24408,40.7,92986,44215,12347,12061
98010,4825,42.7,85398,37011,2241,2584
98011,30069,38,71720,37695,14543,15526
98012,52351,37.2,88283,39165,25517,26834
98014,7211,40.4,95394,46064,3618,3593
98019,10964,38,95025,39858,5399,5565
98020,18561,49.9,78083,48284,8274,10287
98021,27547,38.6,92138,40038,13364,14183
98022,21670,43,66295,33171,11036,10634
98023,48964,35.7,67906,29629,24270,24694
98024,5921,42.3,93777,43186,3327,2594
98026,36370,43.7,73220,36435,17522,18848
98027,27909,41.1,100644,49332,13513,14396
98028,20896,40.1,82448,39388,10020,10876
98029,26054,37.2,99974,45607,12437,13617
98030,33074,31.4,51446,22210,16275,16799
98031,35936,33,63709,25080,18129,17807
98032,33791,33.2,48853,24576,17229,16562
98033,32502,38.6,103250,58696,16018,16484
98034,38234,35.8,77688,40753,18473,19761
98036,36597,37.4,64738,30338,18985,17612
98037,27546,36.1,59798,28077,13315,14231
98038,33468,37.8,95043,37072,16500,16968
98039,3024,44.2,183833,99911,1432,1592
98040,23301,45.4,126359,72605,11484,11817
98042,43666,39.4,87342,35067,21657,22009
98043,20195,37.3,58865,28475,9795,10400
98045,13898,41.5,88906,43584,7100,6798
98047,6495,32.8,52482,20387,3430,3065
98050,176,42.4,250001,71378,76,100
98051,3852,42.3,77623,32555,2055,1797
98052,59822,35.2,99192,51582,31150,28672
98053,21816,41.2,116518,55246,10759,11057
98055,21660,36.1,66461,31502,10882,10778
98056,33492,36.4,70683,35346,16981,16511
98057,10875,37.9,43339,30172,5521,5354
98058,43971,38.3,77780,33763,21910,22061
98059,37181,36.6,91465,39209,18969,18212
98065,12690,34.8,121415,49014,6554,6136
98068,366,42.5,65625,35550,197,169
98070,11122,51.1,72774,43727,5361,5761
98072,22370,42.4,107654,54281,10942,11428
98074,26158,37.9,143686,56118,12931,13227
98075,21408,37.3,142926,56074,10505,10903
98077,14885,41.5,137125,62715,7789,7096
98087,31120,32,63639,27672,15321,15799
98092,39964,36.2,70877,31881,20009,19955
98101,10643,43,42938,61716,5836,4807
98102,22493,33.2,65054,55079,11594,10899
98103,47019,34.2,75763,47853,23469,23550
98104,12871,40.8,26637,29533,7582,5289
98105,45332,22.9,45560,31239,22262,23070
98106,23855,35.3,57875,27922,12029,11826
98107,21996,34.6,67566,44232,11097,10899
98108,24026,35.3,52232,24049,12200,11826
98109,22030,34,77034,57253,10921,11109
98110,23084,48.2,95481,54897,11294,11790
98112,21622,40.1,96054,71159,10807,10815
98115,47611,37.6,84159,49162,23671,23940
98116,23671,42.3,74274,50532,11193,12478
98117,30719,40.1,86986,44466,15165,15554
98118,43618,37.3,52276,27140,20871,22747
98119,22360,33.1,68383,54053,10834,11526
98121,12183,35.6,59355,61431,6819,5364
98122,32722,31.7,53570,43230,16545,16177
98125,36644,38.8,53044,35772,17822,18822
98126,20631,38.8,66408,40087,9759,10872
98133,46405,38.1,51499,29390,22467,23938
98134,856,42.9,43151,15981,565,291
98136,14899,42.1,84344,49994,6910,7989
98144,26429,39.5,55950,37648,13443,12986
98146,25281,38.7,56809,28416,12921,12360
98148,10521,33.5,45424,23335,5187,5334
98154,0,-666666666,-666666666,-666666666,0,0
98155,32942,41.3,72281,36757,16263,16679
98158,0,-666666666,-666666666,-666666666,0,0
98164,57,34.1,73833,41560,28,29
98166,20154,43.8,63320,38241,10034,10120
98168,33585,34.5,49233,21286,17250,16335
98174,63,37.3,-666666666,3943,49,14
98177,18642,47.3,95648,53835,9018,9624
98178,24844,39.4,58707,27481,11951,12893
98188,23478,34.6,40815,22554,12220,11258
98195,29,55.3,-666666666,9245,26,3
98198,35197,36,56364,25702,18673,16524
98199,20623,40,82882,58018,9892,10731
98201,28423,36.9,43229,25123,14557,13866
98203,35378,38.7,57119,28428,17233,18145
98204,40843,30.1,41517,21316,20600,20243
98205,11845,34.5,72463,29637,6061,5784
98207,1346,22.3,-666666666,24435,1225,121
98208,52683,35.5,71698,29918,26208,26475
98220,667,45.3,43792,20736,407,260
98221,20305,49.8,60369,33694,9857,10448
98222,44,55.8,56250,50405,27,17
98223,40833,39.5,65863,28610,20727,20106
98224,315,43.7,27143,19394,175,140
98225,46251,27.4,35765,22118,22444,23807
98226,41481,39.6,55952,27470,21115,20366
98229,31119,39.2,59394,31059,15298,15821
98230,15753,43.1,56641,31130,7879,7874
98232,3858,48.3,75359,35089,2083,1775
98233,14287,37.7,52906,25086,6966,7321
98235,50,24.2,-666666666,7202,31,19
98236,5959,52.8,64902,36911,3140,2819
98237,3990,47.1,48071,20392,2071,1919
98238,39,34.2,-666666666,103018,14,25
98239,6969,53.7,60275,35027,3340,3629
98240,3346,47.3,67292,26673,1634,1712
98241,2328,38.5,39280,24118,1209,1119
98243,330,62.3,55804,53084,181,149
98244,2653,48.2,35895,24017,1255,1398
98245,3651,50.7,47279,35198,1747,1904
98247,10016,32.1,57694,27873,5218,4798
98248,22518,37.7,58493,25765,11366,11152
98249,4571,53.8,59142,39235,2229,2342
98250,7929,50.8,59414,38162,3823,4106
98251,4839,39.3,64336,26720,2530,2309
98252,8747,40.1,70726,28945,4606,4141
98253,1668,60.8,60605,39828,832,836
98255,360,38.3,40469,12571,213,147
98256,462,49.2,32386,25480,194,268
98257,4147,52.2,51799,28202,1992,2155
98258,31339,36.1,77590,30915,16283,15056
98260,5294,56.9,59931,37252,2324,2970
98261,2435,57.2,50278,34336,1171,1264
98262,1098,52.7,70625,39945,607,491
98263,69,45.8,32321,25677,35,34
98264,18319,39.2,57026,25312,8753,9566
98266,4310,35.6,41015,17821,2119,2191
98267,406,57.5,35625,22375,153,253
98270,46105,35.2,65130,26833,22910,23195
98271,27625,35.1,66188,26674,14022,13603
98272,27983,36.6,78070,27874,15101,12882
98273,29400,34,48350,22123,14800,14600
98274,17215,40.7,61829,29745,8308,8907
98275,20457,42.4,93717,44096,10976,9481
98276,553,31.2,65179,19381,263,290
98277,37484,33.3,53556,26539,18503,18981
98278,1405,22,-666666666,21254,1178,227
98279,619,57.3,52292,36556,314,305
98280,373,65.1,69444,62143,175,198
98281,1287,52.9,39500,39441,657,630
98282,15456,50.7,65601,32782,7605,7851
98283,574,47.8,59083,24247,194,380
98284,24427,39.9,60784,26941,12220,12207
98286,249,56.6,49125,31490,126,123
98288,194,55.3,26750,19364,93,101
98290,33018,41.8,76489,33495,16101,16917
98292,21307,41.9,72457,31301,10634,10673
98294,6498,38.8,60707,22839,3321,3177
98295,2129,36.3,59750,24530,1037,1092
98296,28905,39,109355,39931,14613,14292
98297,83,67.6,33571,19336,46,37
98303,904,66.4,43333,39162,469,435
98304,720,50.4,33168,18833,451,269
98305,257,58.7,25547,23578,168,89
98310,19220,37.2,47817,25246,9331,9889
98311,26280,39.7,66706,30354,13326,12954
98312,31059,35.6,55717,27677,16433,14626
98314,1849,23.2,148229,27499,1651,198
98315,5637,22.5,42277,18604,3761,1876
98320,1201,58.5,39219,24722,625,576
98321,14051,40.1,70123,28655,7210,6841
98323,688,33.5,61250,23426,358,330
98325,1845,49.7,62583,30019,888,957
98326,955,29.1,13750,8006,753,202
98327,8672,32,83171,32567,4325,4347
98328,9469,43.4,57199,27111,4640,4829
98329,10330,44.4,67958,31599,5268,5062
98330,155,62.5,7684,27831,59,96
98331,6243,40.2,40788,20826,3505,2738
98332,15982,44.9,86174,41948,7311,8671
98333,3816,44,93188,45221,1778,2038
98335,25646,46.2,76192,41779,12526,13120
98336,855,50.6,35924,18305,440,415
98337,6952,29.3,38826,21838,3635,3317
98338,23560,39.8,67680,28983,11916,11644
98339,3024,47.4,30932,18351,1596,1428
98340,2912,52.2,64333,34886,1318,1594
98342,1310,48.4,61477,37674,589,721
98345,466,40.8,80664,38964,240,226
98346,10300,41.8,64988,29239,4923,5377
98349,4304,42.9,52802,27326,1926,2378
98350,451,24.5,37083,13482,214,237
98351,1270,51.9,49755,30767,696,574
98353,0,-666666666,-666666666,-666666666,0,0
98354,7136,35.5,63675,32082,3302,3834
98355,513,54.1,34174,37393,267,246
98356,1762,55.5,36884,22504,845,917
98357,1473,33,31607,17468,826,647
98358,1237,51.6,51146,28010,658,579
98359,4790,45.1,71676,29726,2653,2137
98360,12018,35.5,74936,28730,6027,5991
98361,1010,61.3,40107,30794,537,473
98362,22052,47.5,43827,25914,10942,11110
98363,13866,42.9,47792,25288,6675,7191
98364,132,37,-666666666,,35,97
98365,4345,62.5,63779,37495,2226,2119
98366,33176,37.2,56549,27693,17425,15751
98367,28126,41.2,72575,29962,14202,13924
98368,14588,55.4,43235,28857,6764,7824
98370,28900,42.9,71410,33740,13544,15356
98371,20227,41.3,64335,31913,9911,10316
98372,22730,40.6,60953,31691,11414,11316
98373,22890,33.5,60056,27545,11305,11585
98374,37619,36.3,74694,29649,18318,19301
98375,27748,33,70373,26169,13911,13837
98376,2011,53.1,47981,30054,1020,991
98377,1906,51.4,35061,20015,1010,896
98380,4960,47.6,80317,35882,2410,2550
98381,654,48,73984,21733,439,215
98382,27411,57.4,47771,28039,12999,14412
98383,20479,37.9,60635,33808,10107,10372
98385,502,40.5,63125,22283,281,221
98387,44393,32.3,64758,23858,21955,22438
98388,6889,42.2,59604,32586,3811,3078
98390,10320,36.5,51863,27206,5037,5283
98391,44930,35.3,83560,32927,22487,22443
98392,2987,41.5,55385,29072,1432,1555
98394,1567,39.1,57941,24595,865,702
98396,540,38.1,73875,30986,288,252
98402,6848,32.4,31500,26353,4157,2691
98403,7257,39.4,52763,41703,3607,3650
98404,32500,30.8,43832,16805,15702,16798
98405,22957,35.4,42697,21826,11104,11853
98406,22313,38,58969,31532,10365,11948
98407,21025,40.4,66833,37872,10245,10780
98408,19704,36.7,49535,23421,9911,9793
98409,23423,31.4,46886,21513,11080,12343
98416,1245,19.5,-666666666,8304,544,701
98418,9597,37.1,45633,23692,4725,4872
98421,2,-666666666,-666666666,,2,0
98422,20711,39.2,82585,37179,10334,10377
98424,10214,31.9,58892,25827,5118,5096
98430,21,9.9,-666666666,,5,16
98433,17906,21.8,47190,16700,10708,7198
98438,271,22.5,-666666666,20103,214,57
98439,5520,25.5,33445,15105,3042,2478
98443,5338,46.9,59178,34911,2790,2548
98444,35693,30,39846,18715,18050,17643
98445,29948,35.9,59940,24360,14685,15263
98446,10065,39.2,61703,29816,4866,5199
98447,877,19.8,-666666666,5105,390,487
98465,6167,45.3,46816,33580,2948,3219
98466,26760,37.8,53559,30396,12117,14643
98467,14748,38.9,61386,32634,7522,7226
98498,27848,43.3,54303,30795,13463,14385
98499,29829,34.8,37840,23138,14751,15078
98501,40035,39.9,66729,34166,19072,20963
98502,30490,38.7,60837,32105,14786,15704
98503,35316,36,58112,27508,16729,18587
98506,17503,41.8,58095,32687,8556,8947
98512,29447,39.2,65692,29652,14593,14854
98513,33436,36.2,68502,29180,16233,17203
98516,21786,39.1,66466,32458,10869,10917
98520,23969,38,41903,20068,12941,11028
98524,3125,54.7,60938,31741,1564,1561
98526,269,48.1,44904,22196,129,140
98527,157,58.4,28516,27299,81,76
98528,9399,41.2,53082,22492,4744,4655
98530,510,35.5,41750,20639,239,271
98531,23889,35.6,38594,21113,11857,12032
98532,23647,41,49762,23032,11771,11876
98533,810,51.4,36744,19313,458,352
98535,502,59,31548,15636,315,187
98536,138,54.2,2499,15321,84,54
98537,2119,44.8,52903,23536,1026,1093
98538,284,44.8,65313,27748,138,146
98541,10339,40.4,48202,22081,5449,4890
98542,680,43.8,59063,25737,322,358
98544,0,-666666666,-666666666,-666666666,0,0
98546,3488,43.5,65585,27406,1866,1622
98547,1586,55.5,27924,19859,783,803
98548,2360,58.4,36375,21534,1147,1213
98550,11616,39.7,36036,20593,5584,6032
98552,680,43.6,47375,18291,349,331
98555,332,71.7,30653,27517,173,159
98557,3238,39.5,51690,22113,1632,1606
98558,207,59.4,41442,27753,93,114
98559,144,13.5,-666666666,,30,114
98560,164,41.5,36806,16654,70,94
98562,85,75.7,-666666666,22539,32,53
98563,8031,44.8,50538,27339,4054,3977
98564,2492,52.3,43482,24442,1254,1238
98565,617,31.9,67500,26530,369,248
98568,2687,35.1,46425,19486,1265,1422
98569,5890,57.6,42944,27344,2773,3117
98570,3952,49.1,51106,25723,2172,1780
98571,298,58.5,57195,32135,184,114
98572,712,46.9,39333,21361,346,366
98575,198,59.2,63750,29783,98,100
98576,4685,47.2,57889,26911,2367,2318
98577,6680,47.9,40741,21799,3452,3228
98579,13367,41.4,55419,25128,6937,6430
98580,10676,38.7,62676,25879,5423,5253
98581,225,69.8,33333,21228,95,130
98582,649,43.4,26083,21424,215,434
98583,69,52.7,28750,21801,36,33
98584,35611,41.9,46425,22624,18559,17052
98585,594,48.9,51500,25740,290,304
98586,1952,44.6,33966,19551,965,987
98587,895,32.1,28984,15024,474,421
98588,2278,47.8,52750,24912,1187,1091
98589,6637,41.5,55720,26224,3350,3287
98590,331,53.4,40938,46555,175,156
98591,3837,49,50488,24795,1905,1932
98592,1622,57.2,63363,29326,709,913
98593,771,48.1,36000,17934,380,391
98595,2229,39.3,29821,18799,1290,939
98596,7772,38.5,44829,18178,3685,4087
98597,21333,33,55226,22971,10645,10688
98601,2345,42.8,57120,25303,1134,1211
98602,90,50.4,51146,22939,68,22
98603,836,48.9,58094,30484,448,388
98604,34033,35.7,64873,26214,16530,17503
98605,1473,33.6,50708,21065,782,691
98606,8810,45.2,75866,32330,4358,4452
98607,28582,38.5,79486,35796,14495,14087
98610,2810,45.4,41278,23447,1546,1264
98611,10402,40.6,57532,25736,5293,5109
98612,2569,51.8,44152,24249,1254,1315
98613,546,39.9,52232,21950,291,255
98614,253,55.7,24205,18085,119,134
98616,189,65.4,45167,34102,88,101
98617,1103,48.6,46250,25022,562,541
98619,509,43.5,39750,20061,243,266
98620,7785,43.8,36846,18974,3959,3826
98621,567,39.4,26176,14692,238,329
98624,1466,43.2,42500,24105,769,697
98625,6923,41.8,59654,25711,3278,3645
98626,23927,37.7,44636,21663,12185,11742
98628,307,47.1,28125,17801,153,154
98629,8716,39.6,74724,30642,4437,4279
98631,3656,54.9,44116,28867,1794,1862
98632,48786,41.7,42930,23297,23529,25257
98635,1644,54.4,35027,21784,806,838
98638,1422,39.1,47813,22383,781,641
98639,848,48.4,45893,29690,414,434
98640,3982,61.8,37308,24156,1907,2075
98641,0,-666666666,-666666666,-666666666,0,0
98642,15973,45.4,78108,34682,8144,7829
98643,457,48.4,42000,20100,223,234
98644,439,41.3,42981,18816,248,191
98645,1276,51,55903,26073,654,622
98647,242,65.4,26375,23944,127,115
98648,2971,44.1,53009,26534,1500,1471
98649,1052,42.8,67589,25686,556,496
98650,999,50.4,49375,25505,478,521
98651,877,37.9,60441,30053,458,419
98660,12539,36.5,38014,24048,6183,6356
98661,42097,33.9,39665,23078,20842,21255
98662,33132,35.4,55986,23976,16331,16801
98663,12925,38.6,49358,27012,6625,6300
98664,21361,41.7,53290,29931,10017,11344
98665,23462,37.3,49983,26622,11433,12029
98670,84,52.3,27083,18499,50,34
98671,22496,38.2,68358,29865,11398,11098
98672,5237,46.1,52783,28096,2440,2797
98673,414,47.2,30536,23040,230,184
98674,10836,36.8,64572,25849,5493,5343
98675,6844,28.4,59085,21445,3708,3136
98682,55759,32,58274,22610,27563,28196
98683,31182,40.1,54168,30209,15067,16115
98684,28078,37,58549,25919,13623,14455
98685,26528,40,77231,33440,13000,13528
98686,18362,37.7,75210,33200,9014,9348
98801,41416,37.2,51176,26025,20088,21328
98802,28557,38.4,56893,24016,13912,14645
98811,95,28.8,63750,30608,36,59
98812,4456,32.5,42212,18350,2205,2251
98813,3409,30.7,37392,13884,1952,1457
98814,346,38.5,32121,21249,161,185
98815,7105,42.5,56098,28048,3541,3564
98816,6929,38,51411,24306,3867,3062
98817,403,32.7,17589,9177,212,191
98819,123,61.1,34000,22326,63,60
98821,576,42.1,62455,17351,322,254
98822,2143,45.2,50750,24303,1021,1122
98823,10982,35,48164,19278,5780,5202
98824,340,24.9,48250,14140,145,195
98826,6438,50,49559,28284,3040,3398
98827,750,36.4,36906,19082,465,285
98828,1785,48.4,59053,27973,899,886
98829,645,45.6,58375,27097,364,281
98830,434,49,42045,26608,247,187
98831,3522,40.2,44357,22560,1854,1668
98832,285,22.2,58250,19080,170,115
98833,152,47.9,78409,29708,55,97
98834,177,54,56563,28305,109,68
98836,764,38.2,62244,24591,406,358
98837,40819,33.6,49062,22142,20463,20356
98840,4932,42.2,45025,22887,2471,2461
98841,8819,39.9,42725,20139,4276,4543
98843,1588,34.2,54514,19605,871,717
98844,4341,49.1,32158,19609,2263,2078
98845,221,38.8,48056,18062,122,99
98846,1137,39.6,45625,23478,607,530
98847,2047,33,48266,23037,1161,886
98848,12323,28.8,42325,16880,5970,6353
98849,1531,40.6,46667,19014,809,722
98850,1450,32.3,32500,17623,672,778
98851,3539,50.6,30884,23125,1914,1625
98852,15,28.3,86250,30433,3,12
98853,2,-666666666,-666666666,,2,0
98855,6380,42.3,39643,19668,3093,3287
98856,2448,53.6,33967,21756,1202,1246
98857,4088,30.5,46875,17373,2137,1951
98858,2046,33.7,45150,22952,1071,975
98859,144,56.5,15078,13978,60,84
98860,322,37.6,47841,18897,136,186
98862,2050,51.3,46597,28704,1104,946
98901,29573,32.6,35738,17011,15368,14205
98902,46412,32,36943,17980,23336,23076
98903,15194,38.9,46082,21082,7484,7710
98908,36063,39.8,58891,29645,17109,18954
98921,648,14.4,20767,4459,297,351
98922,5668,48.7,46509,27544,3009,2659
98923,1213,32.1,54000,12628,734,479
98925,489,53,57837,25026,239,250
98926,30484,28.2,40412,21546,15100,15384
98929,0,-666666666,-666666666,-666666666,0,0
98930,16725,28,44563,15363,8436,8289
98932,5086,23.1,39281,13307,2399,2687
98933,1112,38.6,53462,24030,564,548
98934,1030,36.5,37400,18797,597,433
98935,3575,30.9,43438,14753,1836,1739
98936,5826,31.9,57841,20220,2964,2862
98937,3879,46.2,46429,35688,1833,2046
98938,1945,23.7,49917,20658,1089,856
98939,163,18,25735,8206,87,76
98940,550,54.1,42964,50098,257,293
98941,901,43.1,48571,21534,479,422
98942,16869,36.2,59067,25458,8627,8242
98943,760,31.2,44750,21102,379,381
98944,22498,26.8,36703,14207,11227,11271
98946,574,38.5,53167,25492,264,310
98947,2615,30.8,41824,22282,1418,1197
98948,13596,26.1,35210,12484,6867,6729
98950,583,20.2,80000,16200,353,230
98951,13854,27.4,37853,13308,6979,6875
98952,2295,24.6,38611,13319,1075,1220
98953,6878,33.5,52368,19647,3417,3461
99001,6095,34.6,36875,13235,3969,2126
99003,4654,47.8,62948,29721,2449,2205
99004,18162,26.3,39400,20223,9177,8985
99005,8422,42.4,90000,36789,4170,4252
99006,10999,41.7,49576,23043,5443,5556
99008,684,42.9,66250,25805,292,392
99009,4731,38.6,44926,23060,2264,2467
99011,3092,21.9,42587,18835,1875,1217
99012,1087,37.7,43542,21227,583,504
99013,1836,38,42000,20083,989,847
99016,12912,38.8,61769,26074,6234,6678
99017,185,45.4,45833,26692,93,92
99018,337,27.4,50625,15869,155,182
99019,10227,38.1,85821,36245,5242,4985
99020,66,-666666666,-666666666,,0,66
99021,9180,44.1,61479,28501,4411,4769
99022,8974,42,54815,23781,4226,4748
99023,495,35.5,97167,39026,249,246
99025,4946,43.6,67222,29378,2341,2605
99026,8921,43.2,71699,28716,4611,4310
99027,6138,47.3,44360,25276,3053,3085
99029,1551,47.9,55500,25777,768,783
99030,967,47.9,56053,27777,507,460
99031,803,52.3,41042,23532,424,379
99032,720,50.6,42938,22526,328,392
99033,861,46.3,42938,20215,416,445
99034,208,52.8,24688,13109,121,87
99036,1184,47.3,89306,37970,597,587
99037,12387,40.6,64085,29053,6242,6145
99039,95,60.4,49219,31011,54,41
99040,585,38,28214,18353,332,253
99101,1474,40.6,41250,17646,784,690
99102,519,35.4,43977,23766,257,262
99103,481,47.5,38958,23738,241,240
99105,33,58.8,33125,25221,16,17
99109,5178,49.2,33589,20978,2510,2668
99110,1568,32.2,40614,18929,834,734
99111,4095,40.8,48838,27542,2136,1959
99113,624,47,66818,30163,306,318
99114,12132,46.8,40412,23375,6002,6130
99115,1119,45.2,44875,24350,554,565
99116,1988,31.3,50391,19973,1103,885
99117,537,42.9,32386,19584,263,274
99118,836,50.6,45938,21264,451,385
99119,1006,46.8,42917,24578,548,458
99121,164,42.5,46397,20715,95,69
99122,3695,44.3,51981,25582,1926,1769
99123,1159,57.3,56250,28625,551,608
99124,340,48.3,55694,27371,170,170
99125,511,51.6,45208,23846,272,239
99126,1100,57.9,54468,21589,524,576
99128,396,49.5,57222,30160,223,173
99129,810,47.8,27344,19450,457,353
99130,741,51.9,45724,25082,353,388
99131,166,56.9,41875,25508,92,74
99133,1645,51,40496,25808,835,810
99134,551,47.8,75446,30439,316,235
99135,267,45,62083,31998,152,115
99136,44,71.4,22250,22275,30,14
99137,278,54.5,39091,22372,151,127
99138,1258,38.4,27500,16615,637,621
99139,1384,46.7,50819,21062,644,740
99140,360,47,26667,18685,196,164
99141,5260,48.1,38662,20699,2508,2752
99143,552,51.6,37826,21607,300,252
99144,34,63.2,2499,41697,23,11
99146,60,29.4,36250,19177,22,38
99147,131,67.5,51563,37943,58,73
99148,2199,54.5,47612,29016,1083,1116
99149,182,54.6,31429,17870,78,104
99150,248,56.6,21250,17772,152,96
99151,155,51.4,31250,16787,74,81
99152,206,37.6,55000,30002,96,110
99153,385,55.8,36136,29421,218,167
99154,19,44.9,116250,41763,9,10
99155,1001,31.1,25435,12101,489,512
99156,8260,47.2,37129,20412,4346,3914
99157,905,40.2,28281,14765,456,449
99158,685,47.8,44917,22465,323,362
99159,1479,48.6,42059,27174,752,727
99160,125,57,19297,16100,70,55
99161,1371,40.5,50789,24768,601,770
99163,32148,22,27177,19413,16319,15829
99164,2,-666666666,-666666666,,2,0
99166,3652,45.2,40417,20622,1913,1739
99167,650,49.5,43558,20085,313,337
99169,2822,41.1,42794,21249,1411,1411
99170,1005,45.7,42865,22893,516,489
99171,963,46.6,42988,27630,462,501
99173,1588,42.6,41597,16571,830,758
99174,61,40.8,36250,27372,27,34
99176,191,38.9,52500,23009,77,114
99179,562,42.3,56016,24273,281,281
99180,982,57.7,40265,33263,491,491
99181,1836,46.2,32540,16372,939,897
99185,1096,55.5,40962,29756,523,573
99201,12761,36.2,24532,20517,6743,6018
99202,20707,28.4,32859,16398,9896,10811
99203,20361,43,65780,36398,10192,10169
99204,6958,35.6,26966,27094,3615,3343
99205,42064,34.4,45432,21848,20076,21988
99206,36010,37,49491,25306,18482,17528
99207,29868,31.6,32183,15522,14703,15165
99208,50372,37.8,53820,27534,23643,26729
99212,19459,40.7,52161,26232,10074,9385
99216,23571,38,45098,23136,11536,12035
99217,17720,35.4,45925,23375,8639,9081
99218,15334,30.5,45983,21468,6995,8339
99223,29918,41,63808,37106,14523,15395
99224,20500,38.7,56172,32267,10422,10078
99301,71473,28.5,56098,19567,36734,34739
99320,8738,39.2,62321,26030,4584,4154
99321,734,23.9,26866,14097,311,423
99322,229,48.8,49688,25694,124,105
99323,3516,40.4,69725,27997,1667,1849
99324,9143,31.6,41738,20903,4459,4684
99326,5689,30.8,55409,15286,3355,2334
99328,3830,48.1,41774,23132,1962,1868
99329,183,50.4,40833,23878,89,94
99330,680,49.1,42198,32130,376,304
99333,46,56.3,27083,23078,24,22
99335,390,29.4,38214,19562,199,191
99336,48749,30.7,41990,21704,24399,24350
99337,30233,39.1,70646,27839,15179,15054
99338,12244,38.5,99750,36921,5877,6367
99341,795,41.4,55500,21110,395,400
99343,3003,25.6,44073,18273,1583,1420
99344,16898,26.3,43588,16514,8559,8339
99345,202,32.4,46563,30636,123,79
99346,545,21.2,31676,14114,271,274
99347,2287,54.7,51637,27176,1158,1129
99348,1811,24,42115,14640,925,886
99349,8076,23,44859,12525,4237,3839
99350,13636,33.7,55508,20876,7061,6575
99352,27833,39.6,76195,38705,14037,13796
99353,13652,40.1,80539,32501,6715,6937
99354,22294,36.4,62689,31510,11146,11148
99356,254,38.7,45417,24251,143,111
99357,3294,28.1,35714,14366,1891,1403
99359,70,58.8,33929,36097,38,32
99360,1274,39.3,60278,31706,610,664
99361,1715,42.8,51169,26021,814,901
99362,41513,38,46605,24178,21709,19804
99363,20,-666666666,-666666666,,10,10
99371,311,41.9,70305,29455,158,153
99401,209,56.8,65714,49458,106,103
99402,1749,41,49205,22810,753,996
99403,19917,43.7,42813,24573,9627,10290
99501,16521,38.6,56136,37031,8543,7978
99502,24059,33.7,89291,39693,11801,12258
99503,14042,34.9,45217,28292,7458,6584
99504,40824,32.4,75988,31662,20028,20796
99505,6649,21.4,52143,20723,4049,2600
99506,7499,22,60753,19565,4072,3427
99507,39015,32.7,90160,39012,20738,18277
99508,36534,29.7,56856,27103,17947,18587
99510,289,50,-666666666,167259,251,38
99513,0,-666666666,-666666666,-666666666,0,0
99515,22821,34.8,88540,39256,10997,11824
99516,20781,42,142921,56355,10842,9939
99517,16442,34.1,71738,39548,8474,7968
99518,10786,31.7,76057,36024,5371,5415
99519,868,48.4,-666666666,111201,740,128
99540,291,57.7,72639,27144,144,147
99546,108,45.3,88750,34871,62,46
99547,60,50.3,60000,26397,43,17
99548,60,42.5,68125,23418,34,26
99549,69,36.5,54583,27970,38,31
99550,238,43.8,60833,25851,120,118
99551,606,25.8,50000,13859,310,296
99552,392,25.5,38333,11608,210,182
99553,951,43.5,38333,25260,758,193
99554,675,20.6,33056,10063,365,310
99555,208,27.8,51705,19200,116,92
99556,2742,43.9,49563,26981,1438,1304
99557,728,27.5,58750,18198,360,368
99558,99,28.2,21875,11540,51,48
99559,7769,28.2,71719,26286,4015,3754
99561,493,21.8,51563,10537,263,230
99563,1062,21.7,40096,9888,576,486
99564,101,31.1,95625,25960,59,42
99565,72,35.8,123750,49068,28,44
99566,194,53.9,48750,27007,101,93
99567,9544,37,94135,40719,4977,4567
99568,197,55.7,29722,35860,114,83
99569,84,30,21875,8596,37,47
99571,101,40.5,53500,32932,50,51
99572,227,60.5,60357,36362,85,142
99573,816,33.3,63676,25759,420,396
99574,2692,41.6,94375,37207,1501,1191
99575,120,18.8,35000,11520,50,70
99576,2400,31.8,67981,30583,1238,1162
99577,27158,33.2,97462,38057,13476,13682
99578,349,23,38438,11070,180,169
99579,55,46.4,80417,32207,40,15
99580,139,23.8,31250,19304,73,66
99581,858,23.3,55000,14419,470,388
99583,15,51.8,43750,22760,12,3
99585,344,24.1,36667,11503,184,160
99586,623,53.1,29318,24687,275,348
99587,2278,38.4,81949,45106,1297,981
99588,854,48.2,56719,25042,471,383
99589,331,24.1,18750,10140,198,133
99590,171,25.5,23125,10662,97,74
99591,62,61.7,44792,25418,27,35
99602,221,26.5,35833,17335,110,111
99603,9628,41.8,53797,30332,4786,4842
99604,1222,21,34464,9033,638,584
99605,119,26.7,41250,48601,85,34
99606,376,27.7,50625,20741,168,208
99607,231,20.7,37143,9705,118,113
99609,532,25.1,42778,9264,296,236
99610,2399,45.9,61625,28078,1305,1094
99611,15779,39,70320,31956,8385,7394
99612,831,41.1,62917,25958,582,249
99613,310,41,81250,41786,187,123
99614,644,25.3,35375,10332,349,295
99615,13009,31.5,69955,28844,7029,5980
99620,572,24,37333,11037,277,295
99621,702,23.2,43125,12628,388,314
99622,317,26.3,39167,11151,152,165
99624,74,38.6,45750,27791,44,30
99625,123,20.3,37500,12324,61,62
99626,297,24.9,28625,10721,142,155
99627,429,31.5,64750,25249,217,212
99628,588,29,34038,14286,315,273
99630,190,41,36250,19152,114,76
99631,464,43.2,89808,36927,309,155
99632,760,20.8,48036,10898,375,385
99633,600,36.8,79250,33606,297,303
99634,364,22.4,31875,9745,199,165
99636,563,22.9,42083,9923,312,251
99637,671,24,64306,15694,371,300
99638,39,49.3,24375,17967,27,12
99639,912,52.9,44091,26155,454,458
99640,192,29,24250,12048,85,107
99641,420,21.4,41750,11622,225,195
99643,229,39.5,41000,25593,140,89
99644,300,33.4,37857,20956,164,136
99645,26202,35.1,77242,31688,13430,12772
99647,26,53.5,44375,25262,11,15
99648,123,19.6,32188,12433,58,65
99649,58,51.1,32083,26636,37,21
99650,521,25,42708,11178,270,251
99651,62,39.3,40000,10894,41,21
99652,4347,37,62313,27398,2205,2142
99653,138,26.6,56250,21851,60,78
99654,53456,33,72743,29022,27784,25672
99655,596,28,34688,11152,296,300
99656,32,35.5,51250,49916,14,18
99657,360,21.3,40625,9914,193,167
99658,678,25.8,41786,17176,340,338
99659,385,19.8,33000,12609,203,182
99660,675,32.6,38750,20901,414,261
99661,1243,39.6,71250,27423,903,340
99662,491,18.2,31250,7999,273,218
99663,491,51.9,51696,31567,252,239
99664,5073,40.8,62257,30064,2997,2076
99665,74,47.8,25833,17370,29,45
99666,135,27.1,45625,13696,76,59
99667,50,57.5,45682,26244,24,26
99668,85,37.2,29583,18429,47,38
99669,14572,35.6,63482,31866,7473,7099
99670,57,51.9,66250,38625,30,27
99671,591,18.7,36667,8342,304,287
99672,3157,46.4,61424,33486,1532,1625
99674,1207,48,43333,25449,648,559
99676,1392,47.3,45662,27060,744,648
99677,62,24.8,35417,18053,21,41
99678,941,26,43333,11745,482,459
99679,418,23.3,25250,6600,209,209
99680,376,23,36250,9681,208,168
99681,277,27.8,26875,11034,141,136
99682,403,35.1,25938,43846,257,146
99683,591,43.6,51023,22998,301,290
99684,699,38.1,51250,22970,362,337
99685,4207,38.6,89853,32009,2738,1469
99686,4000,33.8,93313,35224,2126,1874
99688,2663,45.5,53707,27284,1478,1185
99689,569,42.9,72500,32640,314,255
99690,331,23.4,53750,12726,175,156
99691,66,46.7,29167,14723,44,22
99692,155,31.5,81875,41061,113,42
99693,244,42.5,42500,29583,117,127
99694,1457,39.8,56957,29080,745,712
99695,0,-666666666,-666666666,-666666666,0,0
99701,19067,31.7,50585,28062,9997,9070
99702,2584,22.8,71800,22668,1383,1201
99703,7348,21.4,50403,17179,4035,3313
99704,30,44.4,-666666666,53293,30,0
99705,24098,29.8,76156,30768,12383,11715
99706,0,-666666666,-666666666,-666666666,0,0
99709,31376,35.1,71287,37353,16929,14447
99712,11945,38.7,85085,41010,6312,5633
99714,1025,41.8,76250,33267,557,468
99720,137,32.5,26406,12287,79,58
99721,304,21.9,52500,18487,145,159
99722,127,27.4,27500,15769,78,49
99723,4303,29.8,90500,30302,2375,1928
99724,98,32.6,22500,13997,44,54
99726,38,53.7,32188,36695,18,20
99727,577,20.2,48281,11489,299,278
99729,195,46.5,53438,28576,116,79
99730,124,52.4,33750,24349,62,62
99732,0,-666666666,-666666666,-666666666,0,0
99733,103,24.8,17361,12747,44,59
99734,1250,44.1,-666666666,82411,1089,161
99736,97,30.8,47000,18576,50,47
99737,4964,33.5,71250,32842,2830,2134
99738,131,57.8,21250,15531,76,55
99739,358,25.6,37500,11663,212,146
99740,516,38.2,32292,23801,279,237
99741,566,34.5,60313,26551,309,257
99742,757,29.7,30000,13436,407,350
99743,1109,40,93750,38149,557,552
99744,188,39.5,74375,34294,87,101
99745,61,29.9,30750,13075,31,30
99746,336,25.3,29167,12243,173,163
99747,208,27.3,47188,19605,127,81
99748,196,35.4,25833,14190,132,64
99749,391,25.2,39375,14255,209,182
99750,448,21.8,59167,14185,252,196
99751,130,18.3,48750,11515,60,70
99752,3503,30.7,80729,31603,1919,1584
99753,279,19.9,28333,8987,150,129
99754,104,29.5,20313,13550,50,54
99755,422,28.8,44537,25281,177,245
99756,79,52.5,43125,23386,37,42
99757,19,54.5,41875,21463,12,7
99758,217,26.8,25417,12645,113,104
99759,274,25.3,73125,19172,160,114
99760,908,44.8,61150,30763,534,374
99761,442,24.7,58250,15737,246,196
99762,4008,33,70256,31502,2144,1864
99763,692,22.7,54375,13789,410,282
99764,271,39.5,51500,21187,125,146
99765,278,26.7,34375,13996,153,125
99766,718,26.9,71875,20923,381,337
99767,20,56.7,45000,27895,10,10
99768,209,31.2,24464,13253,117,92
99769,828,22.4,32344,7887,410,418
99770,693,22.8,35625,10052,336,357
99771,209,26.7,38750,15054,133,76
99772,623,21.6,36750,10651,327,296
99773,361,20.9,50625,10238,176,185
99774,66,9.7,18125,4917,38,28
99775,1146,21,73750,11270,621,525
99776,116,34,36250,13068,58,58
99777,261,47.1,45000,20250,145,116
99778,267,23.3,25500,13392,162,105
99780,1783,43.6,41944,21675,883,900
99781,168,32,11250,10936,99,69
99782,540,27.3,61875,18413,300,240
99783,118,27.7,37750,12270,62,56
99784,166,29.2,27250,17001,107,59
99785,407,21.3,34125,8389,216,191
99786,290,25,38750,13444,142,148
99788,65,21.5,38750,12628,37,28
99789,405,24.4,94375,25563,200,205
99790,43,50.6,50833,39944,29,14
99791,276,23,60000,18036,139,137
99801,29639,37.4,82993,37669,15287,14352
99820,457,45.2,32857,29981,260,197
99824,2242,36,62721,36351,1104,1138
99825,91,54.6,34167,17357,43,48
99826,538,47.8,52188,37727,289,249
99827,2656,44,52848,30750,1451,1205
99829,775,42.7,48750,23401,378,397
99830,487,42.5,38750,20314,270,217
99832,64,50.7,73750,30589,39,25
99833,3277,42.4,68646,36489,1687,1590
99835,8945,38.5,69405,32521,4552,4393
99836,42,27,56250,15114,26,16
99840,1080,44.3,71667,37139,571,509
99841,106,51.7,62813,33020,59,47
99901,13651,38.7,62519,31563,7121,6530
99903,30,63.7,-666666666,34290,19,11
99918,130,52.8,24844,25604,95,35
99919,528,43.1,49050,26385,306,222
99921,2104,38,54554,26736,1145,959
99922,364,40,37361,18515,177,187
99923,81,64.3,21944,17225,38,43
99925,668,46.4,38125,25094,360,308
99926,1630,31.4,50052,22850,871,759
99927,111,59.4,19000,21157,61,50
99929,2341,53.1,45649,28399,1191,1150
